key	text	tooltip
#Loc;1;text/db/campaign_battle_presets.loc		
campaign_battle_presets_onscreen_name_coastal_preset_01	Coastline	true
campaign_battle_presets_onscreen_name_coastal_preset_02	Waterfront	true
campaign_battle_presets_onscreen_name_att_western_city_rome	Roma	true
campaign_battle_presets_onscreen_name_cha_port_small_01	Genoa	true
campaign_battle_presets_onscreen_name_cha_land_01	Al-Andalus	true
campaign_battle_presets_onscreen_name_cha_land_03	Po Valley	true
campaign_battle_presets_onscreen_name_cha_land_02	Saxony	true
campaign_battle_presets_onscreen_name_att_nordic_port_a_minor	Alabu	true
campaign_battle_presets_onscreen_name_att_nordic_port_b_minor	Flevum	true
campaign_battle_presets_onscreen_name_bel_town_01	Astorga	true
campaign_battle_presets_onscreen_name_bel_town_02	Thagaste	true
campaign_battle_presets_onscreen_name_bel_port_01	Carthago Nova	true
campaign_battle_presets_onscreen_name_bel_port_02	Tingis	true
campaign_battle_presets_onscreen_name_att_nordic_city_a_minor	Virunum	true
campaign_battle_presets_onscreen_name_att_nordic_city_b_minor	Petrodava	true
campaign_battle_presets_onscreen_name_att_nordic_city_c_minor	Belz	true
campaign_battle_presets_onscreen_name_bel_city_02	Ravenna	true
campaign_battle_presets_onscreen_name_bel_city_03	Roma	true
campaign_battle_presets_onscreen_name_bel_city_01	Carthago	true
campaign_battle_presets_onscreen_name_cha_city_04	Paris	true
campaign_battle_presets_onscreen_name_cha_city_03	Winchester	true
campaign_battle_presets_onscreen_name_cha_city_02	Cordoba	true
campaign_battle_presets_onscreen_name_cha_city_01	Ravenna	true
campaign_battle_presets_onscreen_name_att_western_city_port_ravenna	Ravenna	true
campaign_battle_presets_onscreen_name_bel_land_01	African Coast	true
campaign_battle_presets_onscreen_name_bel_land_02	Italia	true
campaign_battle_presets_onscreen_name_bel_land_03	Hispania	true
campaign_battle_presets_onscreen_name_bel_land_04	Gaul	true
campaign_battle_presets_onscreen_name_cha_port_01	Ravenna	true
campaign_battle_presets_onscreen_name_cha_town_01	Wurzburg	true
campaign_battle_presets_onscreen_name_cha_town_02	Coimbra	true
campaign_battle_presets_onscreen_name_cha_town_03	Angouleme	true
campaign_battle_presets_onscreen_name_att_eastern_city_port_constantinople	Constantinople	true
campaign_battle_presets_onscreen_name_att_eastern_port_constantinople	Constantinople	true
campaign_battle_presets_onscreen_name_ambush_preset_02	Wetland	true
campaign_battle_presets_onscreen_name_ambush_preset_01	Ridge	true
campaign_battle_presets_onscreen_name_land_preset_04	Pyrenees 	true
campaign_battle_presets_onscreen_name_land_preset_05	Swamp	true
campaign_battle_presets_onscreen_name_land_preset_01	Plains	true
campaign_battle_presets_onscreen_name_land_preset_02	Cobblestone	true
campaign_battle_presets_onscreen_name_land_preset_03	Woodland	true
campaign_battle_presets_onscreen_name_naval_preset_01	Cap Bon	true
campaign_battle_presets_onscreen_name_naval_preset_03	Mediterranean	true
campaign_battle_presets_onscreen_name_naval_preset_02	Black Sea	true
campaign_battle_presets_onscreen_name_river_preset_01	The Tiber	true
campaign_battle_presets_onscreen_name_river_preset_02	The Nile	true
campaign_battle_presets_onscreen_name_att_western_port_ravenna	Ravenna	true
campaign_battle_presets_onscreen_name_bel_bridge_01	River Fork	true
campaign_battle_presets_onscreen_name_bel_naval_01	Corscia et Sardinia	true
campaign_battle_presets_onscreen_name_bel_naval_02	Oceanus Gallicus	true
campaign_battle_presets_onscreen_name_att_sassanid_port_a_minor	Meshan	true
campaign_battle_presets_onscreen_name_att_sassanid_port_b_minor	Eudaemon	true
campaign_battle_presets_onscreen_name_att_eastern_port_a_minor	Trapezus	true
campaign_battle_presets_onscreen_name_att_eastern_port_b_minor	Tyrus	true
campaign_battle_presets_onscreen_name_att_western_port_a_minor	Genua	true
campaign_battle_presets_onscreen_name_att_western_port_b_minor	Segontium	true
campaign_battle_presets_onscreen_name_att_western_port_a	Tarentum	true
campaign_battle_presets_onscreen_name_att_western_port_b	Taraco	true
campaign_battle_presets_onscreen_name_att_eastern_city_b	Caesarea Eusebia	true
campaign_battle_presets_onscreen_name_att_eastern_city_c	Ancyra	true
campaign_battle_presets_onscreen_name_att_eastern_city_a	Edessa	true
campaign_battle_presets_onscreen_name_bel_port_unf_02	Aleria	true
campaign_battle_presets_onscreen_name_bel_port_unf_01	Hippo Diarrhytus	true
campaign_battle_presets_onscreen_name_att_eastern_city_a_minor	Iconium	true
campaign_battle_presets_onscreen_name_att_eastern_city_b_minor	Aelia Capitolina	true
campaign_battle_presets_onscreen_name_att_eastern_city_c_minor	Domavia	true
campaign_battle_presets_onscreen_name_att_western_city_a_minor	Turonum	true
campaign_battle_presets_onscreen_name_att_western_city_b_minor	Siscia	true
campaign_battle_presets_onscreen_name_att_western_city_c_minor	Asturica	true
campaign_battle_presets_onscreen_name_att_sassanid_city_a_minor	Hira	true
campaign_battle_presets_onscreen_name_att_sassanid_city_b_minor	Harev	true
campaign_battle_presets_onscreen_name_att_sassanid_city_c_minor	Payttakaran	true
campaign_battle_presets_onscreen_name_att_nordic_city_a	Tuesis	true
campaign_battle_presets_onscreen_name_att_nordic_city_c	Casurgis	true
campaign_battle_presets_onscreen_name_att_nordic_city_b	Uburzis	true
campaign_battle_presets_onscreen_name_cha_river_01	Loire	true
campaign_battle_presets_onscreen_name_cha_naval_01	White Cliffs	true
campaign_battle_presets_onscreen_name_cha_naval_02	Mediterranean	true
campaign_battle_presets_onscreen_name_att_sassanid_city_a	Abarshahr	true
campaign_battle_presets_onscreen_name_att_sassanid_city_c	Zafar	true
campaign_battle_presets_onscreen_name_att_sassanid_city_b	Kath	true
campaign_battle_presets_onscreen_name_att_eastern_port_a	Antioch	true
campaign_battle_presets_onscreen_name_att_eastern_port_b	Ptolemais	true
campaign_battle_presets_onscreen_name_att_western_city_b	Vesontio	true
campaign_battle_presets_onscreen_name_att_western_city_c	Corduba	true
campaign_battle_presets_onscreen_name_att_western_city_a	Londinium	true
campaign_battle_presets_onscreen_name_cha_ambush_02	Alps	true
campaign_battle_presets_onscreen_name_cha_ambush_01	Roncesvalles	true
campaign_battle_presets_onscreen_name_bel_ambush_01	Mountain Pass	true
campaign_battle_presets_onscreen_name_att_sassanid_city_ctesiphon	Ctesiphon	true
campaign_battle_presets_onscreen_name_cha_coastal_01	Toe of Italy	true
campaign_battle_presets_onscreen_name_bel_coastal_01	Nikaia	true
campaign_battle_presets_onscreen_name_att_sassanid_port_b	Omana	true
campaign_battle_presets_onscreen_name_att_sassanid_port_a	Anacopia	true
campaign_battle_presets_onscreen_name_att_nordic_port_b	Gothiscandza	true
campaign_battle_presets_onscreen_name_att_nordic_port_a	Hrefnesholt	true
