key	text	tooltip
#Loc;1;text/db/provinces.loc		
provinces_onscreen_cha_prov_munster	Munster	true
provinces_onscreen_bel_prov_gallaecia	Gallaecia	true
provinces_onscreen_cha_prov_alemannia	Alemannia	true
provinces_onscreen_att_prov_sarmatia_asiatica	Khazaria	true
provinces_onscreen_att_prov_belgica	Lotharingia	true
provinces_onscreen_cha_prov_navarre	Navarre	true
provinces_onscreen_cha_prov_franconia	Franconia	true
provinces_onscreen_att_prov_gallaecia	Leon	true
provinces_onscreen_cha_prov_exarchate	Exarchate	true
provinces_onscreen_bel_prov_aquitaine	Aquitaine	true
provinces_onscreen_att_prov_cilicia	Cilicia	true
provinces_onscreen_att_prov_liguria	Lombardia	true
provinces_onscreen_cha_prov_obodrites	Obodrites	true
provinces_onscreen_bel_prov_lusitania	Lusitania	true
provinces_onscreen_att_prov_thracia	Thracia	true
provinces_onscreen_cha_prov_carinthia	Carinthia	true
provinces_onscreen_bel_prov_tuscia_et_umbria	Tuscia et Umbria	true
provinces_onscreen_att_prov_baetica	Andalusia	true
provinces_onscreen_att_prov_aethiopia	Aethiopia	true
provinces_onscreen_mk_prov_colonia_agrippina	Brabant	true
provinces_onscreen_att_prov_khwarasan	Khorasan	true
provinces_onscreen_att_prov_aquitania	Aquitania	true
provinces_onscreen_att_prov_lusitania	Lusitania	true
provinces_onscreen_att_prov_venetia	Romagna	true
provinces_onscreen_att_prov_maxima_sequanorum	Alamannia	true
provinces_onscreen_cha_prov_east_aquitaine	East Aquitaine	true
provinces_onscreen_cha_prov_croatia	Croatia	true
provinces_onscreen_cha_prov_jutland	Jutland	true
provinces_onscreen_att_prov_macedonia	Achaia	true
provinces_onscreen_att_prov_raetia_et_noricum	Bavaria	true
provinces_onscreen_bel_prov_mauretania_caesariensis	Mauretania Caesariensis	true
provinces_onscreen_bel_prov_zeugitana	Zeugitana	true
provinces_onscreen_att_prov_scythia	Itil	true
provinces_onscreen_cha_prov_sicilia	Sicilia	true
provinces_onscreen_cha_prov_benevento	Benevento	true
provinces_onscreen_cha_prov_bohemia	Bohemia	true
provinces_onscreen_cha_prov_moravia	Moravia	true
provinces_onscreen_cha_prov_west_aquitaine	West Aquitaine	true
provinces_onscreen_cha_prov_austrasia	Austrasia	true
provinces_onscreen_att_prov_osroene	Assyria	true
provinces_onscreen_cha_prov_bavaria	Bavaria	true
provinces_onscreen_bel_prov_cantabria	Cantabria	true
provinces_onscreen_bel_prov_austrasia	Austrasia	true
provinces_onscreen_bel_prov_liguria	Liguria	true
provinces_onscreen_bel_prov_sicilia	Sicilia	true
provinces_onscreen_att_prov_sarmatia_europaea	Sarmatia	true
provinces_onscreen_att_prov_scandza	Scandinavia	true
provinces_onscreen_cha_prov_gascony	Gascony	true
provinces_onscreen_bel_prov_baetica	Baetica	true
provinces_onscreen_att_prov_armenia	Armenia	true
provinces_onscreen_bel_prov_burgundy	Burgundy	true
provinces_onscreen_cha_prov_burgundy	Burgundy	true
provinces_onscreen_mk_prov_brigantium	Galicia	true
provinces_onscreen_mk_prov_augusta_treverorum	Lower Lorraine	true
provinces_onscreen_mk_prov_londinium	Sussex	true
provinces_onscreen_mk_prov_caralis	Sardinia	true
provinces_onscreen_mk_prov_yathrib	Hijaz	true
provinces_onscreen_mk_prov_savaria	Pannonia	true
provinces_onscreen_mk_prov_asturica	Leon	true
provinces_onscreen_mk_prov_mediolanum	Lombardy	true
provinces_onscreen_bel_prov_byzacena	Byzacena	true
provinces_onscreen_mk_prov_uburzis	Swabia	true
provinces_onscreen_mk_prov_trapezus	Pontus	true
provinces_onscreen_mk_prov_avaricum	Auvergne	true
provinces_onscreen_mk_prov_aelia_capitolina	Palestine	true
provinces_onscreen_mk_prov_carthago	Tunis	true
provinces_onscreen_mk_prov_lupfurdum	Neumark	true
provinces_onscreen_att_prov_frisia	Saxonia	true
provinces_onscreen_att_prov_aegyptus	Misr	true
provinces_onscreen_mk_prov_lugdunum	Lyonnais	true
provinces_onscreen_mk_prov_dimmidi	Biskra	true
provinces_onscreen_mk_prov_corduba	Cordoba	true
provinces_onscreen_mk_prov_ra	Lower Volga	true
provinces_onscreen_cha_prov_wessex	Wessex	true
provinces_onscreen_bel_prov_novempopulania	Novempopulania	true
provinces_onscreen_mk_prov_segusio	Savoy	true
provinces_onscreen_mk_prov_cyzicus	Mysia	true
provinces_onscreen_mk_prov_cydamus	Ghadames	true
provinces_onscreen_mk_prov_ravenna	Romagna	true
provinces_onscreen_cha_prov_toledo	Toledo	true
provinces_onscreen_att_prov_carthaginensis	Castella Nova	true
provinces_onscreen_att_prov_makran	Makran o Sistan	true
provinces_onscreen_cha_prov_ulster	Ulster	true
provinces_onscreen_mk_prov_sopianae	Alfold	true
provinces_onscreen_mk_prov_berenice	Red Sea	true
provinces_onscreen_mk_prov_moramar	Ryazanshina	true
provinces_onscreen_mk_prov_bolghar	Volga-Bulgaria	true
provinces_onscreen_mk_prov_gortyna	Crete	true
provinces_onscreen_mk_prov_constantia	Cyprus	true
provinces_onscreen_att_prov_africa	Ifriqiya	true
provinces_onscreen_mk_prov_bracara	Portucale	true
provinces_onscreen_mk_prov_nisibis	Ninawa	true
provinces_onscreen_mk_prov_turonum	Ile-de-France	true
provinces_onscreen_mk_prov_iuvavum	Austria	true
provinces_onscreen_bel_prov_neustria	Neustria	true
provinces_onscreen_cha_prov_saxony	Saxony	true
provinces_onscreen_att_prov_caucasia	Caucasia	true
provinces_onscreen_mk_prov_aquileia	Veneto	true
provinces_onscreen_mk_prov_rotomagus	Normandy	true
provinces_onscreen_mk_prov_caesarea_eusebia	Cappadocia	true
provinces_onscreen_mk_prov_abarshahr	Golestan	true
provinces_onscreen_mk_prov_octodurus	Switzerland	true
provinces_onscreen_mk_prov_segontium	Cymru	true
provinces_onscreen_att_prov_italia	Italia	true
provinces_onscreen_att_prov_bithynia	Bithynia	true
provinces_onscreen_mk_prov_fiorentia	Tuscany	true
provinces_onscreen_mk_prov_kariskos	Severia	true
provinces_onscreen_mk_prov_tarraco	Catalonia	true
provinces_onscreen_mk_prov_ascaucalis	Greater Poland	true
provinces_onscreen_mk_prov_vesontio	Burgundy	true
provinces_onscreen_mk_prov_ctesiphon	Al-Iraq	true
provinces_onscreen_mk_prov_hispalis	Andalusia	true
provinces_onscreen_mk_prov_casurgis	Bohemia	true
provinces_onscreen_mk_prov_corinthus	Achaia	true
provinces_onscreen_mk_prov_ephesus	Lydia	true
provinces_onscreen_mk_prov_eboracum	Northumbria	true
provinces_onscreen_att_prov_mediterraneus_orientalis	Insulae Orientalis	true
provinces_onscreen_att_prov_media_atropatene	Atharbaijan	true
provinces_onscreen_att_prov_germania	Franconia	true
provinces_onscreen_cha_prov_gharb_al_andalus	Gharb Al-Andalus	true
provinces_onscreen_att_prov_dardania	Balcania	true
provinces_onscreen_att_prov_hercynia	Bohemia et Hungaria	true
provinces_onscreen_cha_prov_swabia	Swabia	true
provinces_onscreen_mk_prov_harmosia	Hormuzgan	true
provinces_onscreen_mk_prov_palteskja	Lithuania	true
provinces_onscreen_mk_prov_ganzaga	Azarbaijan	true
provinces_onscreen_mk_prov_domavia	Raska	true
provinces_onscreen_mk_prov_serdica	Western Moesia	true
provinces_onscreen_mk_prov_antiochia	Antioch	true
provinces_onscreen_mk_prov_leopolis	Halychyna	true
provinces_onscreen_mk_prov_constantinopolis	Eastern Thracia	true
provinces_onscreen_mk_prov_syracusae	Sicily	true
provinces_onscreen_att_prov_germano-sarmatia	Balticum	true
provinces_onscreen_att_prov_pannonia	Pannonia	true
provinces_onscreen_cha_prov_brittany	Brittany	true
provinces_onscreen_bel_prov_brittany	Brittany	true
provinces_onscreen_cha_prov_pannonia	Pannonia	true
provinces_onscreen_mk_prov_tarentum	Apulia	true
provinces_onscreen_mk_prov_mtskheta	Kartli	true
provinces_onscreen_mk_prov_corinium	Wessex	true
provinces_onscreen_mk_prov_emerita_augusta	Estremadura	true
provinces_onscreen_mk_prov_tulifurdum	Westphalia	true
provinces_onscreen_bel_prov_lucania_et_brutii	Lucania et Brutii	true
provinces_onscreen_att_prov_persis	Fars	true
provinces_onscreen_cha_prov_france	France	true
provinces_onscreen_cha_prov_marca_inferior	Marca Inferior	true
provinces_onscreen_mk_prov_angulus	Holstein	true
provinces_onscreen_cha_prov_mercia	Mercia	true
provinces_onscreen_bel_prov_dalmatia	Dalmatia	true
provinces_onscreen_cha_prov_gallicia	Gallicia	true
provinces_onscreen_att_prov_dalmatia	Dalmatia	true
provinces_onscreen_cha_prov_valencia	Valencia	true
provinces_onscreen_cha_prov_calabria	Calabria	true
provinces_onscreen_mk_prov_issatis	Yazd	true
provinces_onscreen_mk_prov_toletum	Castilla la Nueva	true
provinces_onscreen_mk_prov_synnada	Phrygia	true
provinces_onscreen_mk_prov_dumatha	Shammar	true
provinces_onscreen_mk_prov_melitene	Malatya	true
provinces_onscreen_mk_prov_rhegium	Calabria	true
provinces_onscreen_mk_prov_petrodava	Moldavia	true
provinces_onscreen_mk_prov_pachoras	Nubia	true
provinces_onscreen_att_prov_transcarpathia	Ruthenia	true
provinces_onscreen_mk_prov_siahkuh	Mangyshlak	true
provinces_onscreen_mk_prov_olisipo	Alentejo	true
provinces_onscreen_mk_prov_ptolemais	Cyrenaica	true
provinces_onscreen_mk_prov_sirmium	Syrmia	true
provinces_onscreen_mk_prov_virunum	Styria	true
provinces_onscreen_mk_prov_nitrahwa	Hungary	true
provinces_onscreen_bel_prov_carthaginensis	Carthaginensis	true
provinces_onscreen_mk_prov_nicomedia	Bithynia	true
provinces_onscreen_mk_prov_caesarea	Al-Jaza'ir	true
provinces_onscreen_mk_prov_pompaelo	Navarre	true
provinces_onscreen_att_prov_asorstan	Iraq	true
provinces_onscreen_cha_prov_frisia	Frisia	true
provinces_onscreen_mk_prov_burdigala	Aquitaine	true
provinces_onscreen_mk_prov_tamousiga	Atlas	true
provinces_onscreen_mk_prov_segobriga	Valencia	true
provinces_onscreen_mk_prov_trimontium	Western Thracia	true
provinces_onscreen_att_prov_spahan	Iraq al-Ajam	true
provinces_onscreen_mk_prov_gelonus	Donets	true
provinces_onscreen_cha_prov_provence	Provence	true
provinces_onscreen_bel_prov_provence	Provence	true
provinces_onscreen_bel_prov_italia	Italia	true
provinces_onscreen_mk_prov_ecbatana	Hamadan	true
provinces_onscreen_mk_prov_aregelia	Saxony	true
provinces_onscreen_mk_prov_samandar	Khazaria	true
provinces_onscreen_mk_prov_macomades	Surt	true
provinces_onscreen_cha_prov_pictland	Pictland	true
provinces_onscreen_mk_prov_budorgis	Silesia	true
provinces_onscreen_mk_prov_viminacium	Nishava	true
provinces_onscreen_mk_prov_sabrata	Madayinin	true
provinces_onscreen_cha_prov_marca_hispanica	Marca Hispanica	true
provinces_onscreen_cha_prov_friuli	Friuli	true
provinces_onscreen_mk_prov_eudaemon	Yemen	true
provinces_onscreen_mk_prov_behdeshir	Kerman	true
provinces_onscreen_att_prov_phazania	Sahara	true
provinces_onscreen_mk_prov_anacopia	Alania	true
provinces_onscreen_mk_prov_neapolis	Campania	true
provinces_onscreen_cha_prov_angria	Angria	true
provinces_onscreen_cha_prov_lombardy	Lombardy	true
provinces_onscreen_mk_prov_iconium	Lycaonia	true
provinces_onscreen_mk_prov_dahistan	Karakum	true
provinces_onscreen_mk_prov_arheimar	Kievshchina	true
provinces_onscreen_mk_prov_alexandria	Nile Delta	true
provinces_onscreen_mk_prov_edessa	Aleppo	true
provinces_onscreen_att_prov_britannia_inferior	Mercia	true
provinces_onscreen_mk_prov_scupi	Duklja	true
provinces_onscreen_att_prov_cappadocia	Cappadocia	true
provinces_onscreen_mk_prov_rhodes	Rhodes	true
provinces_onscreen_mk_prov_apulum	Transylvania	true
provinces_onscreen_mk_prov_kath	Khwarazm	true
provinces_onscreen_mk_prov_caesaraugusta	Aragon	true
provinces_onscreen_mk_prov_augusta_vindelicorum	Bavaria	true
provinces_onscreen_mk_prov_oium	Neman	true
provinces_onscreen_bel_prov_apulia_et_calabria	Apulia et Calabria	true
provinces_onscreen_mk_prov_elusa	Gascony	true
provinces_onscreen_mk_prov_emesa	Syria	true
provinces_onscreen_mk_prov_nova_trajana_bostra	Damascus	true
provinces_onscreen_mk_prov_durocorterum	Flanders	true
provinces_onscreen_mk_prov_spahan	Isfahan	true
provinces_onscreen_att_prov_mediterraneus_occidentalis	Insulae Occidentalis	true
provinces_onscreen_mk_prov_hira	Al-Hasa	true
provinces_onscreen_mk_prov_myra	Pamphylia	true
provinces_onscreen_mk_prov_phra	Sistan	true
provinces_onscreen_mk_prov_pura	Balochistan	true
provinces_onscreen_mk_prov_dyrrhachium	Epirus	true
provinces_onscreen_mk_prov_merv	Razavi Khorasan	true
provinces_onscreen_cha_prov_septimania	Septimania	true
provinces_onscreen_mk_prov_flevum	Frisia	true
provinces_onscreen_mk_prov_ancyra	Ankara	true
provinces_onscreen_mk_prov_aksum	Axum	true
provinces_onscreen_mk_prov_genua	Liguria	true
provinces_onscreen_mk_prov_susa	Khuzestan	true
provinces_onscreen_mk_prov_tyrus	Lebanon	true
provinces_onscreen_mk_prov_tosp	Vaspurakan	true
provinces_onscreen_cha_prov_marca_media	Marca Media	true
provinces_onscreen_mk_prov_romula	Wallachia	true
provinces_onscreen_mk_prov_camulodunon	Essex	true
provinces_onscreen_mk_prov_chersonessus	Crimea	true
provinces_onscreen_mk_prov_payttakaran	Arran	true
provinces_onscreen_mk_prov_constantina	Qusantina	true
provinces_onscreen_mk_prov_pax_augusta	Algarve	true
provinces_onscreen_mk_prov_paraetonium	Matruh	true
provinces_onscreen_bel_prov_septimania	Septimania	true
provinces_onscreen_att_prov_mauretania	Maghreb	true
provinces_onscreen_mk_prov_tanais	Circassia	true
provinces_onscreen_mk_prov_rugion	Mecklenburg	true
provinces_onscreen_mk_prov_tingis	Rif	true
provinces_onscreen_mk_prov_salona	Dalmatia	true
provinces_onscreen_mk_prov_tuesis	Highlands	true
provinces_onscreen_mk_prov_argentoratum	Upper Lorraine	true
provinces_onscreen_cha_prov_eastphalia	Eastphalia	true
provinces_onscreen_mk_prov_siscia	Slavonia	true
provinces_onscreen_mk_prov_stakhr	Fars	true
provinces_onscreen_cha_prov_al_andalus	Al-Andalus	true
provinces_onscreen_mk_prov_verona	Verona	true
provinces_onscreen_mk_prov_vienna	Dauphin√©	true
provinces_onscreen_mk_prov_lindum	Mercia	true
provinces_onscreen_cha_prov_sardinia_and_corsica	Sardinia and Corsica	true
provinces_onscreen_mk_prov_hadrumentum	Al-Mahdiya	true
provinces_onscreen_mk_prov_hafn	Sjealand	true
provinces_onscreen_mk_prov_zafar	Hadramaut	true
provinces_onscreen_mk_prov_sarai	Yayik	true
provinces_onscreen_mk_prov_siraf	Bushehr	true
provinces_onscreen_mk_prov_amasea	Paphlagonia	true
provinces_onscreen_mk_prov_hrefnesholt	Vastergotland	true
provinces_onscreen_mk_prov_narbo	Occitania	true
provinces_onscreen_mk_prov_alabu	Jutland	true
provinces_onscreen_mk_prov_kotais	Lazica	true
provinces_onscreen_mk_prov_amida	Al-Jazira	true
provinces_onscreen_att_prov_hyperborea	Ruscia	true
provinces_onscreen_mk_prov_marcianopolis	Eastern Moesia	true
provinces_onscreen_mk_prov_aquae_sextiae	Provence	true
provinces_onscreen_mk_prov_harey	Herat	true
provinces_onscreen_bel_prov_praeualitana	Praeualitana	true
provinces_onscreen_att_prov_britannia_superior	Anglia	true
provinces_onscreen_mk_prov_tarsus	Cilicia	true
provinces_onscreen_mk_prov_ajax	Corsica	true
provinces_onscreen_mk_prov_rhaga	Tabarestan	true
provinces_onscreen_mk_prov_malaca	Granada	true
provinces_onscreen_mk_prov_duna	Livonia	true
provinces_onscreen_mk_prov_olbia	Yedisan	true
provinces_onscreen_mk_prov_sylis	Povolzhe	true
provinces_onscreen_bel_prov_celtiberia	Celtiberia	true
provinces_onscreen_cha_prov_leon	Leon	true
provinces_onscreen_mk_prov_meshan	Sawad	true
provinces_onscreen_mk_prov_aila	Sinai	true
provinces_onscreen_mk_prov_belz	Lesser Poland	true
provinces_onscreen_att_prov_caledonia_et_hbernia	Caledonia et Hibernia	true
provinces_onscreen_mk_prov_arbela	Erbil	true
provinces_onscreen_mk_prov_augila	Al-Wahat	true
provinces_onscreen_mk_prov_gothiscandza	Pomerania	true
provinces_onscreen_mk_prov_roma	Lazio	true
provinces_onscreen_att_prov_gothiscandza	Pomerania	true
provinces_onscreen_cha_prov_rome	Rome	true
provinces_onscreen_mk_prov_garama	Fezzan	true
provinces_onscreen_mk_prov_eildon	Lowlands	true
provinces_onscreen_mk_prov_thessalonica	Macedonia	true
provinces_onscreen_bel_prov_picenum_suburbicarium	Suburbicarium	true
provinces_onscreen_mk_prov_gabala	Shirvan	true
provinces_onscreen_mk_prov_eblana	Ireland	true
provinces_onscreen_mk_prov_oxyrhynchus	Misr	true
provinces_onscreen_mk_prov_palma	Baleares	true
provinces_onscreen_bel_prov_venetia_et_histria	Venetia et Histria	true
provinces_onscreen_mk_prov_carthago_nova	Murcia	true
provinces_onscreen_mk_prov_adulis	Medri Bahri	true
provinces_onscreen_mk_prov_omana	Oman	true
provinces_onscreen_mk_prov_duin	Armenia	true
provinces_onscreen_att_prov_asia	Asia	true
provinces_onscreen_cha_prov_wales	Wales	true
provinces_onscreen_att_prov_arabia_felix	Yemen	true
provinces_onscreen_att_prov_narbonensis	Provincia	true
provinces_onscreen_cha_prov_northumbria	Northumbria	true
provinces_onscreen_bel_prov_campania_et_samnium	Campania et Samnium	true
provinces_onscreen_bel_prov_mauretania_sitifensis	Mauretania Sitifensis	true
provinces_onscreen_bel_prov_africa_proconsularis	Africa Proconsularis	true
provinces_onscreen_att_prov_arabia_magna	Arabia	true
provinces_onscreen_bel_prov_flaminia_et_picenum	Flaminia et Picenum	true
provinces_onscreen_bel_prov_epirus_nova	Epirus Nova	true
provinces_onscreen_cha_prov_east_neustria	East Neustria	true
provinces_onscreen_cha_prov_west_neustria	West Neustria	true
provinces_onscreen_att_prov_syria	Syria	true
provinces_onscreen_att_prov_dacia	Carpathia	true
provinces_onscreen_bel_prov_tarraconensis	Tarraconensis	true
provinces_onscreen_att_prov_tarraconensis	Castella et Aragonia	true
provinces_onscreen_att_prov_magna_graecia	Calabria et Sicilia	true
provinces_onscreen_att_prov_palaestinea	Palaestinea	true
provinces_onscreen_att_prov_tripolitana	Tarabulus	true
provinces_onscreen_bel_prov_mauretania_tingitana	Mauretania Tingitana	true
provinces_onscreen_att_prov_lugdunensis	Francia	true
provinces_onscreen_mk_prov_leptis_magna	Tripoli	true
provinces_onscreen_bel_prov_sardinia_et_corsica	Sardinia et Corsica	true
provinces_onscreen_att_prov_transcaspia	Khwarezm	true
provinces_onscreen_att_prov_libya	Barqa	true
provinces_onscreen_cha_prov_wilzi	Wilzi	true
