key	text	tooltip
#Loc;1;text/db/aide_de_camp_speeches.loc		
aide_de_camp_speeches_text_adc_attila_enemy_tower_destroyed	Вежа ворога зруйнована!	true
aide_de_camp_speeches_text_adc_attila_captured_enemy_walls	Ми зламали стіни!	true
aide_de_camp_speeches_text_adc_attila_barricades_under_attack	Барикади під ударом!	true
aide_de_camp_speeches_text_adc_attila_enemy_settlement_badly_damaged	Їхнє поселення стало майже руїною!	true
aide_de_camp_speeches_text_adc_attila_own_settlement_badly_damaged	Наше місто сильно зруйновано ворогом.	true
aide_de_camp_speeches_text_adc_attila_enemy_gates_destroyed	Ворожі ворота знищено!	true
aide_de_camp_speeches_text_adc_attila_own_unit_rally	Наші вояки згуртувалися!	true
aide_de_camp_speeches_text_adc_attila_own_ship_lost	Ми втратили човен!	true
aide_de_camp_speeches_text_adc_attila_land_battle_won	Слава богам! Ваша перемога вже близько!	true
aide_de_camp_speeches_text_adc_attila_own_unit_lost	Цілий загін поліг!	true
aide_de_camp_speeches_text_adc_attila_outnumbering_enemy_unit	Ворог тремтить перед нашою чисельною перевагою!	true
aide_de_camp_speeches_text_adc_attila_own_settlement_ruined	Місто на межі руїни!	true
aide_de_camp_speeches_text_adc_attila_capturing_victory_point	Ми захоплюємо ключову позицію перемоги!	true
aide_de_camp_speeches_text_adc_attila_own_hidden_unit_spotted	Наші приховані загони виявлено!	true
aide_de_camp_speeches_text_adc_attila_own_ship_being_boarded	Один з наших човнів беруть на абордаж!	true
aide_de_camp_speeches_text_adc_attila_defending_walls	Ворог біля стін!	true
aide_de_camp_speeches_text_adc_attila_enemy_routing	Дивіться! Вони тікають вгледівши нашу могутність!	true
aide_de_camp_speeches_text_adc_attila_enemy_settlement_ruined	Їхнє місто було спустошено облогою!	true
aide_de_camp_speeches_text_adc_attila_winning_battle	Битва розвивається на нашу користь!	true
aide_de_camp_speeches_text_adc_attila_enemy_gates_captured	Ми захопили ворота!	true
aide_de_camp_speeches_text_adc_attila_losing_battle	Битва вже не на нашу користь!	true
aide_de_camp_speeches_text_adc_attila_enemy_general_injured	Ворожий полководець отримав жахливе поранення, але він буде жити!	true
aide_de_camp_speeches_text_adc_attila_own_general_attacked	Наш полководець під ударом!	true
aide_de_camp_speeches_text_adc_attila_enemy_general_killed	Ворожий полководець мертвий!	true
aide_de_camp_speeches_text_adc_attila_unit_berserk	Наш загін ошаленів!	true
aide_de_camp_speeches_text_adc_attila_enemy_spotted	Ворог наближається!	true
aide_de_camp_speeches_text_adc_attila_unit_morale_wavering	Воїни вагаються!	true
aide_de_camp_speeches_text_adc_attila_enemy_point_captured	Ми захопили ворожу ключову позицію перемоги!	true
aide_de_camp_speeches_text_adc_attila_naval_ammo_replenished	Човен поповнив боєприпаси!	true
aide_de_camp_speeches_text_adc_attila_own_fort_about_to_be_destroyed	Ворог ось-ось захопить форт!	true
aide_de_camp_speeches_text_adc_attila_own_settlement_on_fire	Наше поселення горить!	true
aide_de_camp_speeches_text_adc_attila_walls_breached	Стіни пробиті!	true
aide_de_camp_speeches_text_adc_attila_enemy_fort_about_to_be_captured	За кілька хвилин цей форт впаде до наших ніг!	true
aide_de_camp_speeches_text_adc_attila_allies_routing	Наш союзник утік! Ми одненькі!	true
aide_de_camp_speeches_text_adc_attila_own_tower_destroyed	Вежу зруйновано!	true
aide_de_camp_speeches_text_adc_attila_enemy_settlement_on_fire	Їх поселення горить!	true
aide_de_camp_speeches_text_adc_attila_own_point_captured	Ми втратили ключову позиції перемоги!	true
aide_de_camp_speeches_text_adc_attila_own_gates_destroyed	Наші ворота зруйновані вщент!	true
aide_de_camp_speeches_text_adc_attila_land_enemy_reinforcements	Ворог отримав підкріплення!	true
aide_de_camp_speeches_text_adc_attila_own_general_killed	Наш полководець загинув!	true
aide_de_camp_speeches_text_adc_attila_naval_out_of_ammo	Човен витратив боєприпаси!	true
aide_de_camp_speeches_text_adc_attila_land_tactical_withdrawal	Треба подумати про тактичний відхід!	true
aide_de_camp_speeches_text_adc_attila_own_reinforcements	Наше підкріплення прибуло!	true
aide_de_camp_speeches_text_adc_attila_land_battle_lost	Надія згасла!	true
aide_de_camp_speeches_text_adc_attila_own_ship_on_fire	Один із наших човнів горить!	true
aide_de_camp_speeches_text_adc_attila_enemy_hidden_unit_spotted	Ми виявили приховані загони ворога!	true
aide_de_camp_speeches_text_adc_attila_naval_battle_lost	Хвилі котяться на нас! Надія згасла!	true
aide_de_camp_speeches_text_adc_attila_naval_enemy_reinforcements	Погляньте на обрій! Підкріплення!	true
aide_de_camp_speeches_text_adc_attila_naval_battle_won	Океан нам всміхається! Перемога за нами!	true
aide_de_camp_speeches_text_adc_attila_land_out_of_ammo	Один із наших загонів використав усі боєприпаси!	true
aide_de_camp_speeches_text_adc_attila_own_allied_general_injured	Полководець нашого союзника отримав жахливе поранення, але він буде жити!	true
aide_de_camp_speeches_text_adc_attila_naval_tactical_withdrawal	Веслуй назад! Треба поки що відійти!	true
aide_de_camp_speeches_text_adc_attila_target_building_destroyed	Ворожі стіни руйнуються перед нашою могутністю!	true
aide_de_camp_speeches_text_adc_attila_own_gate_captured	Ворог захопив ворота!	true
aide_de_camp_speeches_text_adc_attila_own_allied_general_killed	Полководець нашого союзника загинув!	true
aide_de_camp_speeches_text_adc_attila_heavily_outnumbered	Вони значно переважають нас!	true
aide_de_camp_speeches_text_adc_attila_own_general_injured	Наш полководець отримав жахливе поранення, але він буде жити!	true
aide_de_camp_speeches_text_adc_attila_enemy_unit_rally	Ворог згуртував свої загони!	true
aide_de_camp_speeches_text_adc_attila_surprised_by_hidden_enemy	Це засідка!	true
aide_de_camp_speeches_text_adc_attila_unit_morale_broken	Люди розбиті та рятуються втечею!	true
aide_de_camp_speeches_text_adc_attila_own_ally_destroyed	Чорний день! Наш союзники розбиті!	true
aide_de_camp_speeches_text_adc_attila_enemy_barricades_destroyed	Ми зруйнували ворожу барикаду!	true
aide_de_camp_speeches_text_adc_attila_own_ally_attacked	Ворог атакує нашого союзника!	true
aide_de_camp_speeches_text_adc_attila_siege_equipment_destroyed	Ворог знищив нашу облогове знаряддя!	true
aide_de_camp_speeches_text_adc_attila_unit_morale_routing	Наші вояки тікають від ворога! Це ганебно!	true
aide_de_camp_speeches_text_adc_attila_own_barricades_destroyed	Ворог зруйнував барикаду!	true
