key	text	tooltip
#Loc;1;text/db/building_short_description_texts.loc		
building_short_description_texts_short_description_cha_bld_barracks_1	Колекція людей зі списами краще, ніж натовп без нічого.	true
building_short_description_texts_short_description_cha_bld_barracks_2	Старанно тренуйтеся, добре бийтеся. Деякі з Вас зможуть вижити.	true
building_short_description_texts_short_description_cha_bld_barracks_3	Деякі з Вас можуть померти - але я готовий піти на цю жертву.	true
building_short_description_texts_short_description_att_bld_religion_germanic_major_1	Боги люблять тих, хто досить сміливий шукати щедроти лісу.	true
building_short_description_texts_short_description_att_bld_religion_germanic_major_2	Тим, хто пролив свою кров за плем’я, є за що бути вдячними.	true
building_short_description_texts_short_description_att_bld_religion_germanic_major_3	Нехай кров життя тече вперед і живить цей вівтар.	true
building_short_description_texts_short_description_att_bld_religion_germanic_major_4	Шануйте Лютого, і все буде добре.	true
building_short_description_texts_short_description_att_bld_religion_germanic_major_5	Нехай дух Годана пронизує Вас і надихає Вашу перемогу!	true
building_short_description_texts_short_description_att_bld_nomad_artisan_carpenter_2	Основою вершників є лук, витесаний умілими руками з міцного дерева.	true
building_short_description_texts_short_description_att_bld_nomad_artisan_carpenter_3	Згинати гілки і обробляти дерево – це мистецтво теслі.	true
building_short_description_texts_short_description_att_bld_nomad_artisan_carpenter_4	Вигадливі вигадки, на благо народу і горе ворогу.	true
building_short_description_texts_short_description_cha_bld_church_school_1	Покращувати життя через знання - це справді християнський шлях.	true
building_short_description_texts_short_description_cha_bld_church_school_2	Зберігачі знань теж повинні їх передавати, можна подумати.	true
building_short_description_texts_short_description_bel_bld_camp_workshop_1	Те, що не можна зробити тут, не потрібно в кампанії	true
building_short_description_texts_short_description_att_bld_nomad_artisan_yurthmaker_3	Хтось може назвати їх грубими, але юрта - це спосіб життя кочовиків.	true
building_short_description_texts_short_description_att_bld_nomad_artisan_yurthmaker_2	Юрта, схильна до суворості кочового життя, вимагає ретельного догляду.	true
building_short_description_texts_short_description_att_bld_nomad_artisan_yurthmaker_4	Ця юрта для незвичайної людини…	true
building_short_description_texts_short_description_att_bld_eos_religion_east_church_minor_3	Спокій знаходиться лише на кінці 15 метрової мотузки та молитви.	true
building_short_description_texts_short_description_att_bld_eos_religion_east_church_minor_2	З цієї високої позиції велика людина пояснює мудрість Бога для тих, хто знаходиться внизу.	true
building_short_description_texts_short_description_att_bld_eos_religion_east_church_minor_1	Вражаюча відданість, бути відлюдником, але що станеться, коли у нас закінчиться хліб?	true
building_short_description_texts_short_description_att_bld_barbarian_industry_basketweaver_4	Багато рук роблять легку роботу.	true
building_short_description_texts_short_description_att_bld_barbarian_industry_basketweaver_2	Мудра людина кладе всі свої яйця в один кошик і уважно стежить за ним.	true
building_short_description_texts_short_description_att_bld_barbarian_industry_basketweaver_3	Майстерність ткача передається з покоління в покоління.	true
building_short_description_texts_short_description_att_bld_barbarian_farm_livestock_2	Мудрий вівчар день і ніч стереже свою отару.	true
building_short_description_texts_short_description_att_bld_barbarian_farm_livestock_3	Стадо дає не тільки їжу.	true
building_short_description_texts_short_description_att_bld_barbarian_farm_livestock_4	Розмір череди є показником багатства.	true
building_short_description_texts_short_description_cha_bld_treasury_1	Монети тримають владу над багатством. Вони і закон, і вірність, і впевненість.	true
building_short_description_texts_short_description_cha_bld_treasury_3	Державна скарбниця, з якої беруться кошти відповідно до потреб і ласки.	true
building_short_description_texts_short_description_cha_bld_treasury_2	Коли його обличчя всюди, не може бути сумніву, хто править.	true
building_short_description_texts_short_description_cha_bld_tengrism_2	Мудра людина надто любить зірки, щоб боятися ночі.	true
building_short_description_texts_short_description_cha_bld_tengrism_3	Шануйте великого Тенгрі, і його благословіння буде Вашим.	true
building_short_description_texts_short_description_cha_bld_tengrism_1	Блискавка б’є у найвищу гору.	true
building_short_description_texts_short_description_att_bld_religion_orthodox_major_church_2	Де люди збираються, щоб почути слово Боже.	true
building_short_description_texts_short_description_att_bld_religion_orthodox_major_church_3	Любіть своїх ворогів, моліться за тих, хто Вас переслідує.	true
building_short_description_texts_short_description_att_bld_religion_orthodox_major_church_4	Нехай всі голоси будуть піднесені в молитві.	true
building_short_description_texts_short_description_att_bld_all_military_upgrades_1	Полководці можуть вигравати війни, але квартирмейстери виграють битви.	true
building_short_description_texts_short_description_cha_bld_olive_1	Одне оливкове дерево добре, багато краще.	true
building_short_description_texts_short_description_cha_bld_olive_3	Плоди оливкового дерева створюють чудовий бізнес.	true
building_short_description_texts_short_description_cha_bld_olive_2	Скромна олива розкриває свою цінність, коли її розчавлять під каменем.	true
building_short_description_texts_short_description_att_bld_all_agriculture_generic_1	При правильному поводженні східні пустелі такі ж родючі, як західні луги.	true
building_short_description_texts_short_description_cha_bld_cloth_3	Володіти справді гарним килимом має багато переваг.	true
building_short_description_texts_short_description_cha_bld_cloth_2	Краще багато ткацьких верстатів, ніж один.	true
building_short_description_texts_short_description_cha_bld_cloth_1	У мистецтво ткання вплетені нитки життя.	true
building_short_description_texts_short_description_bel_bld_all_agriculture_generic_1	Я пам'ятаю, коли це були поля. О, це все ще поля...	true
building_short_description_texts_short_description_att_bld_religion_catholic_major_1	Ви пізнаєте правду, і правда зробить Вас вільними.	true
building_short_description_texts_short_description_cha_bld_court_1	Чим впливовіший пан, тим ширша посмішка.	true
building_short_description_texts_short_description_cha_bld_court_3	Серед цих святих залів ведеться справжній бізнес влади.	true
building_short_description_texts_short_description_cha_bld_court_2	Нехай вельможі зберуться послухати слова свого короля!	true
building_short_description_texts_short_description_att_bld_barbarian_farm_1	Якщо ми дбатимемо про землю, вона подбає про нас.	true
building_short_description_texts_short_description_att_bld_religion_germanic_minor_1	Усі величні люди шанують богів і люблять своїх жінок.	true
building_short_description_texts_short_description_att_bld_all_resources_orchards_1	Для багатьох фрукти – це м’ясо та напої.	true
building_short_description_texts_short_description_att_bld_barbarian_port_military_3	Морська держава потребує місця для своєї фльоти.	true
building_short_description_texts_short_description_att_bld_barbarian_port_military_2	Безпечна набережна, з якої можна починати напади.	true
building_short_description_texts_short_description_att_bld_barbarian_port_military_4	Тут стояли найвидатніші фльоти.	true
building_short_description_texts_short_description_cha_bld_manor_2	Завдяки великодушності володаря його васали можуть отримати власну владу та статус.	true
building_short_description_texts_short_description_cha_bld_manor_3	Амбіції стримуються через роздавання привілеїв.	true
building_short_description_texts_short_description_cha_bld_manor_1	Господар садиби диктує життя всім, хто живе на ній.	true
building_short_description_texts_short_description_att_bld_religion_grecoroman_major_4_hermes	Нехай Гермес буде твоїм голосом між богами та цим світом.	true
building_short_description_texts_short_description_att_bld_nomad_warriors_1	Воїну не потрібно нічого, крім зброї і даху над головою.	true
building_short_description_texts_short_description_att_bld_nomad_warriors_2	Боріться завзято і часто. Завжди знайдеться сильніший супротивник!	true
building_short_description_texts_short_description_bel_bld_camp_officers_1	Є ті, хто слідує, і ті, хто веде.	true
building_short_description_texts_short_description_att_bld_eos_religion_east_church_major_3	У глибині самої землі ми дякуємо і славимо.	true
building_short_description_texts_short_description_att_bld_eos_religion_east_church_major_2	Слава Богу, витесаному з каменю і увічненому в скелі.	true
building_short_description_texts_short_description_att_bld_eos_religion_east_church_major_1	Єдиному Богу байдуже, де Ви йому поклоняєтеся, доки Ви це робите.	true
building_short_description_texts_short_description_att_bld_eos_religion_east_church_major_4	Собор є свідченням божого зв’язку між Богом і Королем.	true
building_short_description_texts_short_description_att_bld_eastern_sassanid_sands_civic_caravans_4	Слова течуть, як прянощі. Ви знайдете обидва тут.	true
building_short_description_texts_short_description_att_bld_nomad_community_market_4	Місце, де можна відпочити та розважитися, перш ніж почнеться серйозна розмова про торгівлю.	true
building_short_description_texts_short_description_att_bld_nomad_community_market_2	Усе має ціну. Просто, можливо, не першу, яку Ви чуєте.	true
building_short_description_texts_short_description_att_bld_nomad_community_market_3	Тут зберігаються всі товари, які є і будуть, іноземні та місцеві.	true
building_short_description_texts_short_description_att_bld_eastern_sassanid_sands_civic_caravans_3	Коли стане важко, зупиніться. Безперечно!	true
building_short_description_texts_short_description_att_bld_eastern_sassanid_sands_civic_caravans_2	Побудьте трохи і послухайте.	true
building_short_description_texts_short_description_cha_bld_fields_2	З зерна виходить хліб, який годує народ. Все починається тут.	true
building_short_description_texts_short_description_cha_bld_fields_3	Земля — це влада, яка надається васалам в обмін на їхню вірність.	true
building_short_description_texts_short_description_cha_bld_fields_1	При правильному поводженні навіть пустеля може стати лугом.	true
building_short_description_texts_short_description_att_bld_religion_arian_major_church_5_legendary	Вгорі Бог, а внизу син. Це слово Господнє.	true
building_short_description_texts_short_description_att_slav_zadruga_1_short	Взаємна вигода від працьовитості та спільного існування – це "задруга".	true
building_short_description_texts_short_description_att_slav_zadruga_2_short	Вірність родині глибша, ніж будь-якому королю.	true
building_short_description_texts_short_description_att_slav_zadruga_3_short	Для блага сім’ї - всі повинні знати свою роль і бути готовими.	true
building_short_description_texts_short_description_att_slav_zadruga_4_short	Важка робота. Братерство. Громада.	true
building_short_description_texts_short_description_cha_bld_medina_3	Десь тут є чудовий магазин килимів, просто не можу точно згадати, де...	true
building_short_description_texts_short_description_cha_bld_medina_2	Заходьте в лабіринт на свій страх і ризик.	true
building_short_description_texts_short_description_cha_bld_medina_1	Старе місто - це лабіринт, гарний і заплутаний як витвір мистецтва.	true
building_short_description_texts_short_description_att_bld_all_agriculture_grain_3	Зерно живить розум, з якого виростають імперії.	true
building_short_description_texts_short_description_att_bld_all_agriculture_grain_2	З зерна виходить хліб, який годує народ. Все починається тут.	true
building_short_description_texts_short_description_att_bld_all_agriculture_grain_4	Достаток і багатство - одне і те ж.	true
building_short_description_texts_short_description_bel_bld_roman_civic_market_slave_4	Все і кожен має свою ціну.	true
building_short_description_texts_short_description_bel_bld_roman_civic_market_slave_2	Деякі народжуються вільними, але не всі помирають такими.	true
building_short_description_texts_short_description_bel_bld_roman_civic_market_slave_3	Ті, хто дозволяє себе поневолити, мало кращі за худобу.	true
building_short_description_texts_short_description_cha_bld_garrison_1	Боєздатні міщани, налаштовані на захист своїх домівок.	true
building_short_description_texts_short_description_cha_bld_garrison_2	Можливо, їх небагато, але ця залога воює із завзяттям.	true
building_short_description_texts_short_description_cha_bld_garrison_3	Значна захисна сила, ці люди будуть тримати оборону.	true
building_short_description_texts_short_description_att_bld_religion_other_1	Еко Еко Азарак... Еко Осіріс...	true
building_short_description_texts_short_description_bel_bld_camp_food_meat_2	Приміщення для зберігання м'яса. Тільки м'ясо. Весь час.	true
building_short_description_texts_short_description_bel_bld_camp_food_meat_3	Після консервації їжа повинна зберігатися в сухому місці.	true
building_short_description_texts_short_description_bel_bld_camp_food_meat_4	Закривавлений. Неелегантний. Сирий. Пташиний кат.	true
building_short_description_texts_short_description_cha_bld_hospice_1	Монахи дбають про те, щоб хворі йшли так спокійно, наскільки дозволяють їхні хвороби.	true
building_short_description_texts_short_description_cha_bld_hospice_2	Ті, хто найближче до Бога, іноді можуть зцілитися через нього.	true
building_short_description_texts_short_description_att_slav_wonder_military_2_short	Тепер, коли вовки біжать, можливо, Ви могли б щось зробити, щоб зупинити їхні укуси?	true
building_short_description_texts_short_description_att_slav_wonder_military_3_short	Тепер, коли вовки біжать, можливо, Ви могли б щось зробити, щоб зупинити їхні укуси?	true
building_short_description_texts_short_description_att_bld_religion_catholic_minor_1	Йоан відповів, кажучи до всіх, - "я справді хрещу Вас водою".	true
building_short_description_texts_short_description_att_bld_religion_catholic_minor_3	Усе можливе тому, хто вірує.	true
building_short_description_texts_short_description_att_bld_religion_catholic_minor_2	Віра означає бути впевненим у тому, на що ми сподіваємося, і бути певним у тому, чого ми не бачимо.	true
building_short_description_texts_short_description_att_bld_religion_catholic_minor_4	Красиве життя не буває просто так, воно будується щодня молитвою.	true
building_short_description_texts_short_description_cha_bld_siege_workshop_2	Машини смерті та руйнування, висічені зі простого дерева.	true
building_short_description_texts_short_description_cha_bld_siege_workshop_1	Великі машини війни, створені з міцних дубів.	true
building_short_description_texts_short_description_cha_bld_trader_2	Тут комерція процвітає на місцевому рівні від світанку до заходу.	true
building_short_description_texts_short_description_cha_bld_trader_3	Центр місцевої торгівлі, тут можна купити та продати різноманітні речі.	true
building_short_description_texts_short_description_cha_bld_trader_1	Торгівельний пост з'єднує тих, хто живе далеко один від одного, щоб усі могли процвітати.	true
building_short_description_texts_short_description_att_bld_roman_civic_market_slave_4	Я зроблю Вам чудову пропозицію - п'ять за ціною чотирьох?	true
building_short_description_texts_short_description_att_bld_roman_civic_market_slave_3	Ціна людського життя напрочуд розумна.	true
building_short_description_texts_short_description_att_bld_barbarian_civic_chieftain_5_legendary_celtic	В яких піснях оспівується героїзм і доблесть, з великою химерністю!	true
building_short_description_texts_short_description_cha_bld_library_1	Тільки культивуючи минуле, ми можемо впливати на майбутнє.	true
building_short_description_texts_short_description_cha_bld_madrasa_1	Школа для початкового навчання читання, письма та математики, щоб навіть найбідніші могли пізнати цей світ.	true
building_short_description_texts_short_description_cha_bld_library_3	Право, наука і медицина. За все наше майбутнє.	true
building_short_description_texts_short_description_cha_bld_madrasa_2	Цілеспрямована середня освіта для більш просунутих студентів ісламу.	true
building_short_description_texts_short_description_cha_bld_library_2	Кожне слово – це зброя.	true
building_short_description_texts_short_description_att_bld_eastmig_military_2	Де збираються сили місцевої оборони.	true
building_short_description_texts_short_description_att_bld_eastmig_military_1	Чоловіки завжди будуть боротися за свій спосіб життя.	true
building_short_description_texts_short_description_bel_bld_camp_food_grain_4	Достаток збіжжя — достаток багатства.	true
building_short_description_texts_short_description_bel_bld_camp_food_grain_2	З зерна виходить хліб, який годує народ.	true
building_short_description_texts_short_description_bel_bld_camp_food_grain_3	Зерно живить розум, з якого виростають імперії.	true
building_short_description_texts_short_description_att_bld_barbarian_port_1	Навіть найменший човен потребує безпечного місця для швартування.	true
building_short_description_texts_short_description_att_bld_nomad_nobility_noblemen_2	Офіційні справи відбуваються в цьому таборі.	true
building_short_description_texts_short_description_att_bld_religion_celtic_major_2	Образ, висічений у камені, має багато сил.	true
building_short_description_texts_short_description_att_bld_religion_celtic_major_3	Разом вони стоять до кінця часів.	true
building_short_description_texts_short_description_att_bld_religion_celtic_major_1	Я покладу камінь на твій камінь.	true
building_short_description_texts_short_description_att_bld_religion_celtic_major_4	Ті, хто шанує могутнього Камула, пізнають перемогу та скуштують слави.	true
building_short_description_texts_short_description_att_bld_religion_celtic_major_5	Нехай світла зірка Белена завжди веде Вас.	true
building_short_description_texts_short_description_att_bld_eastmig_industry_1	Багато рук роблять легку роботу, але ці руки роблять ВЕЛИКУ роботу.	true
building_short_description_texts_short_description_att_bld_all_ruins	Лушпиння колись процвітаючого поселення, його мешканці розбіглися за вітром.	true
building_short_description_texts_short_description_att_bld_barbarian_civic_market_2	Два для цього, Ви повинні бути божевільними! Варто не менше десяти!	true
building_short_description_texts_short_description_cha_bld_council_1	Говори, а ми будемо слухати. Більше нічого не можу обіцяти.	true
building_short_description_texts_short_description_att_bld_eos_military_infantry_5_judaism	Віра у святе додає людям приголомшливої ​​сили.	true
building_short_description_texts_short_description_cha_bld_council_2	Трибунал збирається, щоб заслухати докази та винести вирок.	true
building_short_description_texts_short_description_cha_bld_council_3	Великий простір для зібрань, звернень і прийняття рішень.	true
building_short_description_texts_short_description_att_slav_wonder_1_short	Вовк, шляхетний і могутній, заслуговує і на наш страх, і на нашу пошану.	true
building_short_description_texts_short_description_att_bld_barbarian_industry_forge_2	Хоча залізо міцніше, бронза прикрашає свого власника як ніщо інше.	true
building_short_description_texts_short_description_att_bld_barbarian_industry_forge_3	Сталь гарантує шану та повагу до своїх власників.	true
building_short_description_texts_short_description_att_bld_barbarian_industry_forge_4	Вогонь руйнує, але може і творити.	true
building_short_description_texts_short_description_att_bld_nomad_warriors_infantry_4	Ви ті, хто принесе нам перемогу! Збий дихання ворогів своєю люттю!	true
building_short_description_texts_short_description_cha_bld_fighter_2	Вам не весело? Ні? справді? Деяким людям просто не подобається...	true
building_short_description_texts_short_description_att_bld_nomad_warriors_infantry_3	Піші солдати можуть отримати менше слави, ніж вершники, але вони служать важливій меті.	true
building_short_description_texts_short_description_cha_bld_fighter_1	Всі гроші на свеба - він швидший...	true
building_short_description_texts_short_description_att_bld_nomad_nobility_1	Ця людина мудра не по роках, які вже досить значні.	true
building_short_description_texts_short_description_att_bld_all_resources_port_spice_3	Море – це ворота у широкий світ.	true
building_short_description_texts_short_description_att_bld_all_resources_port_spice_2	Пращури бережуть тих, хто ходить морями.	true
building_short_description_texts_short_description_att_bld_all_resources_port_spice_1	Усі ріки впадають у море.	true
building_short_description_texts_short_description_att_bld_all_resources_port_spice_4	Через цей процвітаючий порт протікають дива світу.	true
building_short_description_texts_short_description_att_bld_roman_west_city_minor_generic_2	Для більшості людей село – це цілий світ.	true
building_short_description_texts_short_description_att_bld_roman_west_city_minor_generic_3	Маленькі міста породжують амбітних чоловіків.	true
building_short_description_texts_short_description_att_bld_roman_west_city_minor_generic_1	Невеликі громади процвітають завдяки спільним зусиллям.	true
building_short_description_texts_short_description_att_bld_roman_west_city_minor_generic_4	За своїми стінами ці люди — сила Імперії.	true
building_short_description_texts_short_description_att_bld_roman_east_city_minor_generic_1	Невеликі громади процвітають завдяки спільним зусиллям.	true
building_short_description_texts_short_description_att_bld_roman_east_city_minor_generic_2	Для більшості людей село – це цілий світ.	true
building_short_description_texts_short_description_att_bld_roman_east_city_minor_generic_3	Маленькі міста породжують амбітних чоловіків.	true
building_short_description_texts_short_description_att_bld_roman_east_city_minor_generic_4	За своїми стінами ці люди — сила Імперії.	true
building_short_description_texts_short_description_bel_bld_roman_military_3	Тут Ви навчитеся битися. Щоб вижити і вбивати.	true
building_short_description_texts_short_description_bel_bld_roman_military_2	Вони кличуть Вас на війну - ти відкликнешся?	true
building_short_description_texts_short_description_bel_bld_roman_military_1	Зверніть увагу на вигук - Готуйтеся!	true
building_short_description_texts_short_description_bel_bld_roman_military_4	В ім'я Вашого короля Ви будете битися!	true
building_short_description_texts_short_description_att_bld_religion_tengri_minor_4	Шанувати своїх предків правильно і гідно.	true
building_short_description_texts_short_description_att_bld_religion_tengri_minor_1	Ліс розмовляє з тими, хто готовий слухати.	true
building_short_description_texts_short_description_att_bld_religion_tengri_minor_2	Вони шукають його тут, вони шукають його там, вони шукають того шамана всюди.	true
building_short_description_texts_short_description_att_bld_religion_tengri_minor_3	Тільки сміливі можуть танцювати в колі шамана.	true
building_short_description_texts_short_description_att_bld_nomad_artisan_wagonmaker_2	Вози перевозять велику кількість так далеко, наскільки може їх затягти мул.	true
building_short_description_texts_short_description_att_bld_nomad_artisan_wagonmaker_3	Більша за підводу, мажа везе вантаж і людей через безкрайні степи.	true
building_short_description_texts_short_description_att_bld_nomad_artisan_wagonmaker_4	Надійно сконструйовані, вони зрештою довезуть Вас туди, можливо і не з комфортом.	true
building_short_description_texts_short_description_bel_bld_camp_sanitation_1	Всі це роблять. Навіщо говорити про це пошепки?	true
building_short_description_texts_short_description_bel_bld_camp_sanitation_3	Від найнижчого вояка до найвищого полководця…	true
building_short_description_texts_short_description_bel_bld_camp_sanitation_2	Іноді нам усім потрібно трохи самотності.	true
building_short_description_texts_short_description_bel_bld_camp_sanitation_4	Кімната, де можна посидіти, викупатися та планувати день...	true
building_short_description_texts_short_description_att_bld_barbarian_civic_tavern_3	Пий до кінця і вихваляй богів.	true
building_short_description_texts_short_description_att_bld_barbarian_civic_tavern_4	Немає нічого в житті, що не могла б виправити велика кількість медовухи.	true
building_short_description_texts_short_description_att_bld_barbarian_farm_chickens_4	Спорт гріє чоловічу кров і вириває золото з їхніх рук.	true
building_short_description_texts_short_description_cha_bld_barbarian_city_1	Незначні цеглинки величі.	true
building_short_description_texts_short_description_cha_bld_barbarian_city_2	Респектабельний, зростаючий осередок працьовитих зусиль.	true
building_short_description_texts_short_description_cha_bld_barbarian_city_3	Світоч культури та процвітання.	true
building_short_description_texts_short_description_att_bld_barbarian_farm_chickens_2	Птах у руці вартий двох у кущах.	true
building_short_description_texts_short_description_att_bld_barbarian_farm_chickens_3	Кури дають багато, а просять мало.	true
building_short_description_texts_short_description_att_bld_eastern_sassanid_civic_court_palace_5_legendary	Справжня сила сходу, яка стала реальною на Ваших очах.	true
building_short_description_texts_short_description_att_bld_eastmig_community_sack_3	Здобич славетної перемоги, по праву затребувана.	true
building_short_description_texts_short_description_att_bld_eastmig_community_sack_2	Торгівля та обмін награбованим. Це право завойовників.	true
building_short_description_texts_short_description_att_bld_eastmig_community_sack_4	Подивіться на цей скарб і знайте, що Ви в компанії переможців.	true
building_short_description_texts_short_description_cha_bld_tavern_3	Безпека та прожиток лежать десь уздовж дороги.	true
building_short_description_texts_short_description_cha_bld_tavern_2	Пийте на повну і шануй небеса.	true
building_short_description_texts_short_description_cha_bld_tavern_1	Втомлений мандрівник може знайти прожиток і відпочинок, захищений від незгод дороги.	true
building_short_description_texts_short_description_att_bld_eos_military_infantry_5_semitic	Благословення Бога робить мечі вірнішими та сильнішими.	true
building_short_description_texts_short_description_bel_bld_all_agriculture_grain_3	Спробуй не заблукати, там кукурудза! Ні, насправді, це пшениця.	true
building_short_description_texts_short_description_bel_bld_all_agriculture_grain_2	Пшениця – основа хліба, а значить – основа життя.	true
building_short_description_texts_short_description_att_bld_religion_celtic_minor_1	Усі величні люди шанують богів і шукають спілкування з ними.	true
building_short_description_texts_short_description_bel_bld_all_agriculture_grain_4	Мільйони тонн пшениці, що веде королівство до величі.	true
building_short_description_texts_short_description_cha_bld_church_1	Вірні збираються, щоб почути слово Господнє.	true
building_short_description_texts_short_description_cha_bld_church_2	Ігумен є духовним батьком громади.	true
building_short_description_texts_short_description_cha_bld_church_3	Віра зміцніла, шпилі собору тягнуться до небес.	true
building_short_description_texts_short_description_att_bld_eastern_sassanid_civic_market_2	Найкращий товар, тільки для тебе, друже!	true
building_short_description_texts_short_description_cha_bld_estate_3	Світ у мікросвіті з усіма інтригами справжнього.	true
building_short_description_texts_short_description_cha_bld_estate_2	Подарунок від Еміра. Так, скільки око сягає - все моє.	true
building_short_description_texts_short_description_cha_bld_estate_1	Великі будинки потребують землі для оплати їх утримання.	true
building_short_description_texts_short_description_att_bld_celtic_farm_livestock_2	Ну, якщо ти їх не закриєш, вони втечуть, так?	true
building_short_description_texts_short_description_att_bld_celtic_farm_livestock_3	Сюди ходять корови. Поки вони не знадобляться.	true
building_short_description_texts_short_description_att_bld_celtic_farm_livestock_4	Коли настає літо, і холоди вщухають, плем'я переселяється.	true
building_short_description_texts_short_description_cha_bld_alcazar_3	Лише дурень, що схиляється до самогубства, спробував би напасти на королівську цитадель.	true
building_short_description_texts_short_description_cha_bld_alcazar_2	Фортеця, придатна для халіфа, і захищається так же.	true
building_short_description_texts_short_description_cha_bld_alcazar_1	Вони сюди не влізуть. Тим більше живими.	true
building_short_description_texts_short_description_bel_bld_camp_military_1	Коли Імперія покличе, ти відкликнешся?	true
building_short_description_texts_short_description_bel_bld_camp_military_2	Застосовувати потрібно лише найкраще. Ти найкращий?	true
building_short_description_texts_short_description_bel_bld_camp_military_3	Хто воював раніше - боріться далі!	true
building_short_description_texts_short_description_bel_bld_camp_military_4	Тут Ви навчитеся битися. Щоб вижити і вбивати.	true
building_short_description_texts_short_description_cha_bld_munya_2	Ідеальний простір для насолоди мистецтвом і літературою.	true
building_short_description_texts_short_description_cha_bld_munya_3	Розкішна резиденція для знатного аристократа - її сад сам по собі дивовижний.	true
building_short_description_texts_short_description_cha_bld_munya_1	Благородний будинок і сад, гармонійно спроектовані як єдине ціле.	true
building_short_description_texts_short_description_cha_bld_mosque_3	Сліпуча споруда, створена в радісному піднесені Бога.	true
building_short_description_texts_short_description_cha_bld_mosque_2	Усі повинні почути заклик до молитви.	true
building_short_description_texts_short_description_cha_bld_mosque_1	Місце поклоніння, де можна припасти під час молитви.	true
building_short_description_texts_short_description_cha_bld_paganism_4	Моя сила — міцна як стовп, непорушна як земля.	true
building_short_description_texts_short_description_cha_bld_paganism_2	Боги населяють землю і все живе.	true
building_short_description_texts_short_description_cha_bld_paganism_3	Місце для поклоніння. Поклонятися Вашим богам, моїм богам, богам.	true
building_short_description_texts_short_description_cha_bld_paganism_1	Усі величні люди шанують богів і люблять своїх жінок.	true
building_short_description_texts_short_description_cha_bld_spring_2	Вода підтримує життя, чому вона не повинна лікувати?	true
building_short_description_texts_short_description_cha_bld_spring_1	Весна є доказом любові Матері до своїх дітей.	true
building_short_description_texts_short_description_cha_bld_marble_1	Багато хто захоплюється мармуром, а потім його бажає.	true
building_short_description_texts_short_description_cha_bld_marble_2	Найбільші громадські роботи висічені з цього прекрасного каменю.	true
building_short_description_texts_short_description_cha_bld_marble_3	Мармур, який виробляється тут у величезних кількостях, щоб годувати жагу людини до краси.	true
building_short_description_texts_short_description_att_bld_nomad_community_1	Розкажіть про пригоди, вправляйтеся в стрілянні з лука або просто проведіть час із своїми побратимами.	true
building_short_description_texts_short_description_att_bld_religion_catholic_major_church_4	Ціна мудрості вище рубінів.	true
building_short_description_texts_short_description_att_bld_religion_catholic_major_church_2	Дух бадьорий, але тіло слабке...	true
building_short_description_texts_short_description_att_bld_religion_catholic_major_church_3	Будь тверезий, будь пильним, бо диявол шукає, кого б йому пожерти.	true
building_short_description_texts_short_description_att_bld_religion_grecoroman_major_4_sol	Непереможне сонце, сяючий благодійнику, дякуємо тобі за цей день…	true
building_short_description_texts_short_description_att_bld_religion_tengri_major_1	Блискавка б’є у найвищу гору.	true
building_short_description_texts_short_description_att_bld_religion_tengri_major_2	Шануйте вічне небо і все буде добре.	true
building_short_description_texts_short_description_att_bld_religion_tengri_major_3	Мудра людина надто любить зірки, щоб боятися ночі.	true
building_short_description_texts_short_description_att_bld_religion_tengri_major_4	Шануйте великого Тенгрі, і його благословіння буде Вашим.	true
building_short_description_texts_short_description_att_bld_religion_zoroastrian_major_fire_1	Вогонь, що дає тепло і несе світло.	true
building_short_description_texts_short_description_att_bld_religion_zoroastrian_major_fire_2	У полум'ї є чистота.	true
building_short_description_texts_short_description_att_bld_religion_zoroastrian_major_fire_3	Святий вогонь стримує ніч і безлад.	true
building_short_description_texts_short_description_att_bld_religion_zoroastrian_major_fire_4	Світило у темряві, що несе світло та порядок у світ.	true
building_short_description_texts_short_description_att_bld_religion_germanic_minor_burial_3	Славетні мертві ніколи не повинні бути забуті.	true
building_short_description_texts_short_description_att_bld_religion_germanic_minor_burial_2	Ці кам'яні вартові стоять на варті землі та її святих місць.	true
building_short_description_texts_short_description_att_bld_religion_germanic_minor_burial_4	Глибоко під землею вони сплять, поки боги не знадобляться в них.	true
building_short_description_texts_short_description_cha_bld_port_military_2	Човняр човен будує - його нація панує.	true
building_short_description_texts_short_description_cha_bld_port_military_1	Морська держава потребує місця для своєї фльоти.	true
building_short_description_texts_short_description_cha_bld_copper_2	Сульфіди добуваються з відкритих копалень, а потім плавлять.	true
building_short_description_texts_short_description_cha_bld_copper_3	Все, що мідь, буде золотом.	true
building_short_description_texts_short_description_cha_bld_copper_1	Червоний метал Кіпру також можна знайти в інших місцях.	true
building_short_description_texts_short_description_att_bld_religion_arian_major_monestary_4	Порядок  мешкає тут, щоб роздумувати над таємницями віри.	true
building_short_description_texts_short_description_att_bld_religion_arian_major_monestary_2	Місце, де можна відсторонитися та споглядати.	true
building_short_description_texts_short_description_att_bld_religion_arian_major_monestary_3	У монастирі живуть вчителі віри.	true
building_short_description_texts_short_description_att_bld_eos_religion_east_church_major_faction_4	Собор є свідченням божого зв’язку між Богом і Королем.	true
building_short_description_texts_short_description_att_bld_eos_religion_east_church_major_faction_1	Єдиному Богу байдуже, де Ви йому поклоняєтеся, доки Ви це робите.	true
building_short_description_texts_short_description_att_bld_eos_religion_east_church_major_faction_2	Слава Богу, витесаному з каменю і увічненому в скелі.	true
building_short_description_texts_short_description_att_bld_eos_religion_east_church_major_faction_3	У глибині самої землі ми дякуємо і славимо.	true
building_short_description_texts_short_description_att_bld_nomad_herders_1	Тваринництво, як і війна, визначає успіх кочовиків.	true
building_short_description_texts_short_description_att_slav_religion_major_1_short	Господь усіх богів, Перун пропонує захист і силу тим, хто йому поклоняється.	true
building_short_description_texts_short_description_att_slav_religion_major_2_short	Як і могутня сокира повертається до Перуна, так врешті решт все повернеться до нього.	true
building_short_description_texts_short_description_att_slav_religion_major_3_short	Речі Перуна отримують його божий захист.	true
building_short_description_texts_short_description_att_slav_religion_major_4_short	Перун керує стихіями і, таким чином, людиною щогодини.	true
building_short_description_texts_short_description_att_slav_religion_minor_1_short	Хвала Мокоші за рясний урожай, рясні поля і здорову сім'ю.	true
building_short_description_texts_short_description_att_slav_religion_minor_2_short	З похвалою та працею приходять щедроти землі, як це забезпечує Мокош.	true
building_short_description_texts_short_description_att_slav_religion_minor_3_short	Ткацьким верстатом долі, Мокош керує всіма нашими долями.	true
building_short_description_texts_short_description_att_slav_religion_minor_4_short	Будьте в безпеці, знаючи, що Ваша доля в руках Мокоші.	true
building_short_description_texts_short_description_att_bld_eastmig_weapon_upgrade_1	Незалежно від того, зроблені, знайдені чи вкрадені, наші кошти зберігаються тут.	true
building_short_description_texts_short_description_att_bld_eastmig_weapon_upgrade_3	Для людей, які рідко залишаються нерухомими, здатність легко переміщувати боєприпаси є ключовим вмінням.	true
building_short_description_texts_short_description_att_bld_eastmig_weapon_upgrade_2	Щоб витримати шторм бою, армія повинна бути добре укомплектована, підготовлена ​​й озброєна. До зубів.	true
building_short_description_texts_short_description_att_bld_eastern_sassanid_civic_caravans_2	Побудьте трохи і послухайте.	true
building_short_description_texts_short_description_att_bld_eastern_sassanid_civic_caravans_3	Коли стане важко, зупиніться. Безперечно!	true
building_short_description_texts_short_description_att_bld_eastern_sassanid_civic_caravans_4	Слова течуть, як прянощі. Ви знайдете обидва тут.	true
building_short_description_texts_short_description_att_bld_nomad_nobility_noblemen_warlord_3	Те, що тут обговорюється, впливає на життя тисячі людей.	true
building_short_description_texts_short_description_att_bld_nomad_nobility_noblemen_warlord_4	Воєвода заслужив свої нагороди кров’ю тисячі інших.	true
building_short_description_texts_short_description_att_bld_eastern_sassanid_civic_court_entertain_3	Надзвичайно гарний день для поло, Шапур!	true
building_short_description_texts_short_description_att_bld_eastern_sassanid_civic_court_entertain_4	Поло без благородної вишуканості. І коні. І палички.	true
building_short_description_texts_short_description_bel_bld_all_industry_major_gold_3	Чудові ювелірні вироби, прикрашені з ретельною майстерністю.	true
building_short_description_texts_short_description_bel_bld_all_industry_major_gold_2	Сміття однієї людини є скарбом для іншої, але це буквально скарб.	true
building_short_description_texts_short_description_bel_bld_all_industry_major_gold_4	Майстер-золотар створює гроші. Король їх витрачає.	true
building_short_description_texts_short_description_att_bld_roman_east_city_major_1	Незначні цеглинки величі.	true
building_short_description_texts_short_description_att_bld_barbarian_civic_market_slaves_4	Ті, хто дозволяє себе поневолити, мало кращі за худобу.	true
building_short_description_texts_short_description_att_bld_roman_east_city_major_3	Світоч культури та процвітання.	true
building_short_description_texts_short_description_att_bld_roman_east_city_major_2	Респектабельний, зростаючий осередок працьовитих зусиль.	true
building_short_description_texts_short_description_att_bld_roman_east_city_major_4	Масштаб і велич, що визначає цивілізацію.	true
building_short_description_texts_short_description_att_bld_barbarian_civic_market_slaves_3	Деякі люди народжуються вільними, але не всі помирають такими.	true
building_short_description_texts_short_description_att_bld_roman_west_city_major_3	Світоч культури та процвітання.	true
building_short_description_texts_short_description_att_bld_roman_west_city_major_2	Респектабельний, зростаючий осередок працьовитих зусиль.	true
building_short_description_texts_short_description_att_bld_roman_west_city_major_1	Незначні цеглинки величі.	true
building_short_description_texts_short_description_att_bld_roman_west_city_major_4	Масштаб і велич, що визначає цивілізацію.	true
building_short_description_texts_short_description_att_bld_roman_water_aqueducts_3	Високі канали води, що розтинають місто.	true
building_short_description_texts_short_description_att_bld_roman_water_aqueducts_2	Магазини життєдайної, чистої води для народу.	true
building_short_description_texts_short_description_att_bld_roman_water_aqueducts_4	Вода, вода, всюди. Деяка з них напрочуд смачна.	true
building_short_description_texts_short_description_att_bld_roman_east_civic_major_1	Б'ється серце Імперії - центр контролю.	true
building_short_description_texts_short_description_att_slav_bld_city_major_1	Жупа об'єднує племена, надаючи їм цілеспрямованість і мету.	true
building_short_description_texts_short_description_att_bld_barbarian_farm_curing_2	Найкращі страви, консервовані сіллю та димом.	true
building_short_description_texts_short_description_att_bld_barbarian_farm_curing_3	Щоб підготуватися до прийдешніх холодів, потрібні достатні запаси.	true
building_short_description_texts_short_description_att_bld_barbarian_farm_curing_1	Посолений, приправлений цукром і готовий протистояти руйнуванню часу.	true
building_short_description_texts_short_description_att_bld_religion_orthodox_major_church_5_legendary	Слово Боже таке, як воно написано, незмінне і йому поклоняються.	true
building_short_description_texts_short_description_bel_bld_all_industry_major_coin_3	Гроші говорять. Безупинно.	true
building_short_description_texts_short_description_bel_bld_all_industry_major_coin_2	Тепер монети - це багатство, а не Ваші корови та поля.	true
building_short_description_texts_short_description_bel_bld_all_industry_major_coin_4	Легко бути іконою, коли твоє обличчя на монеті.	true
building_short_description_texts_short_description_att_bld_all_resources_orchards_vineyard_4	Вино відкриває правду в будь-якій ситуації.	true
building_short_description_texts_short_description_bel_bld_roman_civic_entertain_4	Будеш сміятися, плакати - це змінить твоє життя!	true
building_short_description_texts_short_description_att_bld_all_resources_orchards_vineyard_2	Виноградні лози, скільки сягає око, і прибуток з ними.	true
building_short_description_texts_short_description_bel_bld_roman_civic_entertain_3	Друзі, римляни, земляки! Замовкніть і слухайте.	true
building_short_description_texts_short_description_att_bld_all_resources_orchards_vineyard_3	Як і людину, пресування розкриває справжню природу винограду...	true
building_short_description_texts_short_description_bel_bld_roman_civic_entertain_2	Як я не звик до публічних виступів…	true
building_short_description_texts_short_description_att_bld_roman_civic_market_food_3	Це просто. Ти мені гроші, я тобі цю грушу. Легко!	true
building_short_description_texts_short_description_att_bld_roman_civic_market_food_4	Харчі - кров імперії.	true
building_short_description_texts_short_description_att_bld_eastmig_industry_morale_2	Коли фінік висохне, він має багато застосувань. Всі вони смачні.	true
building_short_description_texts_short_description_att_bld_eastmig_industry_morale_3	Людина спробує зробити алкоголь абсолютно з будь-чого. З чого завгодно.	true
building_short_description_texts_short_description_att_bld_eastmig_industry_morale_4	Фінікове вино. Ідеальне вино для побачення. Або шлюб за попередньою домовленістю.	true
building_short_description_texts_short_description_att_bld_religion_germanic_minor_grove_lb_4	Віддайте хвалу природі. Відірвати голову від тіла.	true
building_short_description_texts_short_description_att_bld_eos_religion_east_church_minor_faction_1	Вражаюча відданість, бути відлюдником, але що станеться, коли у нас закінчиться хліб?	true
building_short_description_texts_short_description_att_bld_barbarian_civic_market_general_3	Все і кожен має свою ціну.	true
building_short_description_texts_short_description_att_bld_barbarian_industry_bonecarver_2	Для майстра завжди є достатній запас кістки.	true
building_short_description_texts_short_description_att_bld_eos_religion_east_church_minor_faction_2	З цієї високої позиції велика людина пояснює мудрість Бога для тих, хто знаходиться внизу.	true
building_short_description_texts_short_description_att_bld_barbarian_industry_bonecarver_3	Делікатні та складні візерунки можна легко вирізати на кістках.	true
building_short_description_texts_short_description_att_bld_eos_religion_east_church_minor_faction_3	Спокій знаходиться лише на кінці 15 метрової мотузки та молитви.	true
building_short_description_texts_short_description_att_bld_barbarian_industry_bonecarver_4	Численні трофеї майстерного мисливця демонструють його велич для всіх.	true
building_short_description_texts_short_description_att_bld_barbarian_civic_market_general_4	Місце, де можна відпочити та розважитися, перш ніж почнеться серйозна розмова про торгівлю.	true
building_short_description_texts_short_description_att_bld_nomad_community_cooking_2	Поділіться теплом і створіть казку серед полум’я.	true
building_short_description_texts_short_description_att_bld_nomad_community_cooking_3	Щоб добре битися, людина повинна добре харчуватися.	true
building_short_description_texts_short_description_att_bld_nomad_community_cooking_4	Мочки вух ягуарів - дістаньте їх, поки вони гарячі, вони чудові!	true
building_short_description_texts_short_description_att_bld_all_resources_gold_mine_4	Чи має значення людське життя порівняно з красою золота?	true
building_short_description_texts_short_description_att_bld_all_resources_gold_mine_2	Спокуса золота змушує забути навіть наймудрішу людину.	true
building_short_description_texts_short_description_att_bld_all_resources_gold_mine_3	Великі родовища золота, що розтікаються озерами і пробиваються річками крізь скелі…	true
building_short_description_texts_short_description_att_bld_all_military_upgrades_weapons_3	Правильне лезо не просто забере життя, воно врятує Ваше.	true
building_short_description_texts_short_description_att_bld_all_military_upgrades_weapons_2	Сучасний світ народжений кузнею.	true
building_short_description_texts_short_description_att_bld_all_military_upgrades_weapons_4	Мої вороги затремтять перед могутністю моєї зброї!	true
building_short_description_texts_short_description_att_bld_nomad_artisan_1	Майстерність і вміння ремісників передавалися з покоління в покоління.	true
building_short_description_texts_short_description_att_bld_celtic_raiding_4	Звідси людина може планувати набіги на своїх суперників і святкувати свої перемоги.	true
building_short_description_texts_short_description_att_bld_celtic_raiding_1	Ми атакуємо на світанку. Корови не знають, що їх спіткало!	true
building_short_description_texts_short_description_att_bld_celtic_raiding_3	Раз у Вас є корови, то треба їх кудись подіти!	true
building_short_description_texts_short_description_att_bld_celtic_raiding_2	Розбійники хочуть грошей. Худоба - це гроші.	true
building_short_description_texts_short_description_att_slav_bld_city_minor_1	Зрештою, кожне плем’я має зупинитися, кожне плем’я має встояти.	true
building_short_description_texts_short_description_att_bld_eastmig_military_cavalry_3	Пустеля – негостинне місце для коней, де виживають лише найвитриваліші.	true
building_short_description_texts_short_description_att_bld_eastern_sassanid_water_storage_2	Використовувати силу вітру для вентиляції — це справді добре.	true
building_short_description_texts_short_description_att_bld_eastern_sassanid_water_storage_3	Ця підземна камера охолоджується потоком вітру та води.	true
building_short_description_texts_short_description_att_bld_eastern_sassanid_water_storage_4	У пекучу спеку пустелі завжди вітається крижана вода.	true
building_short_description_texts_short_description_att_bld_barbarian_civic_major_1	Кожному потрібне місце для зборів, щоб відчути себе частиною громади.	true
building_short_description_texts_short_description_att_bld_all_resources_iron_blacksmith_4	Тут метал можна заливати, формувати та перетворювати у будь-яку вибрану форму.	true
building_short_description_texts_short_description_att_bld_all_resources_iron_blacksmith_3	Коли він дивиться на полум'я, коваль бачить, що треба зробити.	true
building_short_description_texts_short_description_att_bld_all_resources_iron_blacksmith_2	Поганий робітник звинувачує свої інструменти, добрий купує нові.	true
building_short_description_texts_short_description_att_bld_nomad_nobility_shaman_2	Люди шукають у своїх шаманів мудрості, керівництва та зцілення.	true
building_short_description_texts_short_description_att_bld_nomad_nobility_shaman_3	Шаман каже… стояти на одній нозі! Ха-ха, ні. вибач Ви смертельно хворі.	true
building_short_description_texts_short_description_att_bld_nomad_nobility_shaman_4	Те, про що цей шаман не може спілкуватися, не варте обговорювання.	true
building_short_description_texts_short_description_att_bld_roman_west_military_skirmisher_2	Сулиця, плюмбата, лук. Ці люди впораються з кожним і навіть більше.	true
building_short_description_texts_short_description_att_bld_roman_west_military_skirmisher_3	Розташовані зовсім поруч, стрільці прикривають свою піхоту далеко від місця битви.	true
building_short_description_texts_short_description_att_bld_roman_west_military_skirmisher_4	Влучність, вправність, спритність. Стрілець повинен відточити кожне з цих вмінь.	true
building_short_description_texts_short_description_att_bld_barbarian_water_minor_4	Коли людина може контролювати шлях води, вона ближча до свого Творця.	true
building_short_description_texts_short_description_att_bld_barbarian_water_minor_1	Ми повинні дякувати богам за те, що тече з глибини землі.	true
building_short_description_texts_short_description_att_bld_barbarian_water_minor_3	Пересохла земля не дає врожаю.	true
building_short_description_texts_short_description_att_bld_barbarian_water_minor_2	Вода – це благословіння богів. Розумно берегти її.	true
building_short_description_texts_short_description_att_bld_eastern_sassanid_military_minor_4	Кожен має зробити свій внесок у захист міста.	true
building_short_description_texts_short_description_att_bld_eastern_sassanid_military_minor_1	Де збираються піддані, щоб тренуватися та стати солдатами.	true
building_short_description_texts_short_description_att_bld_eastern_sassanid_military_minor_3	Зберігання Ваших військ в одному місці забезпечує їхню дисципліну.	true
building_short_description_texts_short_description_att_bld_eastern_sassanid_military_minor_2	Організація збору війська для походу вимагає ретельного планування та вибору місця.	true
building_short_description_texts_short_description_att_bld_roman_civic_entertain_2	О Вакхе, благослови цей театр, щоб він міг розважати маси.	true
building_short_description_texts_short_description_att_bld_roman_civic_market_wine_4	Хто ти такий, щоб протистояти цьому, га?	true
building_short_description_texts_short_description_bel_bld_roman_civic_market_wine_4	Істина у вині.	true
building_short_description_texts_short_description_bel_bld_roman_civic_market_wine_2	Передайте вина, будь ласка? Розумієш, це ще не все безвихідь.	true
building_short_description_texts_short_description_bel_bld_roman_civic_market_wine_3	Ніщо не здається таким поганим через призму солодкого вина.	true
building_short_description_texts_short_description_att_bld_roman_civic_market_wine_3	Вино є розділовим знаком у життєвому вироку, який інакше не впинається.	true
building_short_description_texts_short_description_att_bld_nomad_warriors_cavalry_3	Спис — це знаряддя, яке робить кавалерійську атаку нищівною.	true
building_short_description_texts_short_description_cha_bld_court_council_1	Де людина може прямо зустрітися зі своїми обвинувачами, і справедливість буде досягнута.	true
building_short_description_texts_short_description_att_bld_nomad_warriors_cavalry_4	Тисніть їх,і, коли побачите їхній страх, прорвіть їхній захист!	true
building_short_description_texts_short_description_cha_bld_court_council_3	Рада збирається, щоб вирішити питання права через призму доктрини.	true
building_short_description_texts_short_description_cha_bld_court_council_2	Безумовно, демонстрація державної влади, але тут можна знайти і правду.	true
building_short_description_texts_short_description_att_bld_eos_mint	Монети тримають владу над багатством. Вони і закон, і вірність, і впевненість.	true
building_short_description_texts_short_description_att_bld_religion_germanic_minor_grove_4	Мудрість криється глибоко в лісі.	true
building_short_description_texts_short_description_att_bld_religion_germanic_minor_grove_3	Навіть у розпал зими боги пильнують свій народ.	true
building_short_description_texts_short_description_att_bld_religion_germanic_minor_grove_2	Боги населяють землю і все живе.	true
building_short_description_texts_short_description_att_bld_barbarian_water_major_1	Розумна людина готується до поганого врожаю і довгої зими.	true
building_short_description_texts_short_description_att_bld_religion_catholic_major_church_5_legendary	Святий Престол у всьому має абсолютну владу.	true
building_short_description_texts_short_description_att_bld_barbarian_water_major_3	Їжа, збережена подалі від заздрісних очей, може ще прослужити зиму.	true
building_short_description_texts_short_description_att_bld_barbarian_water_major_2	У суворі зими краще повний живіт і щирі гості.	true
building_short_description_texts_short_description_cha_bld_market_town_mus_2	Кожен амбітний торговець має з чогось почати.	true
building_short_description_texts_short_description_att_bld_barbarian_water_major_4	Залишене в коптильні м’ясо зберігається довше і стає смачнішим.	true
building_short_description_texts_short_description_cha_bld_market_town_mus_3	Де життя присвячене комерції та створенню багатства в ній.	true
building_short_description_texts_short_description_cha_bld_market_town_mus_1	Осередок місцевої торгівлі, де обмінюються товарами, щоб полегшити суворе життя.	true
building_short_description_texts_short_description_att_bld_nomad_nobility_noblemen_administrator_4	Куди ми поїдемо далі? Куди далі завітає смерть?	true
building_short_description_texts_short_description_att_bld_nomad_nobility_noblemen_administrator_3	Що добре для племені, те добре для всіх. Ці люди вирішують, що є «добре».	true
building_short_description_texts_short_description_att_bld_nomad_warriors_archers_3	Лук - це не продовження руки, це продовження душі.	true
building_short_description_texts_short_description_att_bld_nomad_warriors_archers_4	Поцілити із лука стоячи. Поцілити із лука верхи. Необхідно освоїти кожен аспект лука.	true
building_short_description_texts_short_description_att_bld_all_livestock_generic_1	На сході ретельно шукають гарне пасовище.	true
building_short_description_texts_short_description_twr2_rome_rome_Slums_short	Тут починається падіння кожної імперії.	true
building_short_description_texts_short_description_att_bld_all_industry_minor_weavery_4	Володіти справді гарним килимом має багато переваг.	true
building_short_description_texts_short_description_att_bld_all_industry_minor_weavery_3	Краще багато ткацьких верстатів, ніж один.	true
building_short_description_texts_short_description_att_bld_all_industry_minor_weavery_2	У мистецтво ткання вплетені нитки життя.	true
building_short_description_texts_short_description_att_bld_roman_east_civic_treasury_4	Під пильним оком Сакелларій кошти розподіляються відповідно до потреб.	true
building_short_description_texts_short_description_att_bld_roman_east_civic_treasury_2	Щось показуєте?	true
building_short_description_texts_short_description_att_bld_roman_east_civic_treasury_3	Легко бути іконою, коли твоє обличчя на монеті.	true
building_short_description_texts_short_description_att_bld_eastern_sassanid_water_minor_4	Надлишок води може принести радість, а також життя.	true
building_short_description_texts_short_description_att_bld_eastern_sassanid_water_minor_1	Дорогоцінна вода для всієї громади.	true
building_short_description_texts_short_description_att_bld_eastern_sassanid_water_minor_3	Підземні канали безпечно переносять воду на великі відстані.	true
building_short_description_texts_short_description_att_bld_eastern_sassanid_water_minor_2	Коли воду можна спрямувати, пустеля не є перешкодою для життя.	true
building_short_description_texts_short_description_att_bld_roman_water_major_1	...А я думав, що вони неприємно пахнуть зовні!	true
building_short_description_texts_short_description_att_bld_all_military_upgrades_armor_4	Обладунки, придатні для царя, і для захисників королів.	true
building_short_description_texts_short_description_att_bld_all_military_upgrades_armor_3	Одягніть людину в обладунки, дайте йому в руку меч, і він зможе захистити Імперію.	true
building_short_description_texts_short_description_att_bld_all_military_upgrades_armor_2	Шкіряний кіраса хоч на мить призупинить спис.	true
building_short_description_texts_short_description_bel_bld_all_industry_major_generic_1	Індустріальний хребет великої нації.	true
building_short_description_texts_short_description_att_bld_religion_arian_minor_4	Проголошуйте свою відданість, не від’їжджаючи далеко.	true
building_short_description_texts_short_description_att_bld_religion_arian_minor_3	Тут спочивають ті, хто помер за Господа і Його сина.	true
building_short_description_texts_short_description_att_bld_religion_arian_minor_2	Маленьке місце для молитви вірних.	true
building_short_description_texts_short_description_att_bld_religion_arian_minor_1	Викупайся у водах Божих і народись.	true
building_short_description_texts_short_description_att_bld_eos_religion_semitic_minor_faction_1	Невеликий пам’ятник у правильному стилі справляє враження обеліска.	true
building_short_description_texts_short_description_att_bld_eos_religion_semitic_minor_faction_3	Каміння стоїть як свідчення того, що було раніше.	true
building_short_description_texts_short_description_att_bld_eos_religion_semitic_minor_faction_2	Зірки можуть зійтися, і, трохи подумавши, ми все ж можемо вгадати долю людини…	true
building_short_description_texts_short_description_att_bld_eastern_sassanid_civic_market_cattle_4	Телята, воли, корови. Всі Ваші потреби у великій рогатій худобі!	true
building_short_description_texts_short_description_att_bld_eastern_sassanid_civic_market_cattle_3	Ви завжди отримаєте високу ціну за худобу, незалежно від походження.	true
building_short_description_texts_short_description_bel_bld_camp_workshop_weapon_3	Гарячі речі, надходять!	true
building_short_description_texts_short_description_bel_bld_camp_workshop_weapon_2	Тепло та молот роблять це місце вологим, але вартим уваги для солдата.	true
building_short_description_texts_short_description_bel_bld_camp_workshop_weapon_4	Те, що зроблене майстром-ковалем, залишиться на все життя.	true
building_short_description_texts_short_description_att_bld_eastern_sassanid_civic_major_1	Керування містом – завдання не з простих.	true
building_short_description_texts_short_description_cha_bld_port_fishing_2	Щедрість океанів може бути дуже прибутковою.	true
building_short_description_texts_short_description_cha_bld_port_fishing_1	Риби, як і люди, схильні ловити залишену їм наживку.	true
building_short_description_texts_short_description_att_bld_barbarian_civic_market_free_4	Плавильний котел культур, зміцнює плем'я своєю.	true
building_short_description_texts_short_description_att_bld_barbarian_civic_market_free_3	Служи, і ти дізнаєтеся, що таке рівність.	true
building_short_description_texts_short_description_att_bld_barbarian_farm_agriculture_4	Іноді земля потребує невеликої допомоги.	true
building_short_description_texts_short_description_att_bld_barbarian_farm_agriculture_3	Огорожа тримає злодіїв і хижаків подалі, створюючи чудові врожаї.	true
building_short_description_texts_short_description_att_bld_barbarian_farm_agriculture_2	Немає нічого благороднішого, ніж працювати на землі.	true
building_short_description_texts_short_description_att_bld_eastern_sassanid_civic_localpalace_3	Обов'язок дворянина - нагадувати людям про їхнє місце в його світі.	true
building_short_description_texts_short_description_att_bld_eastern_sassanid_civic_localpalace_2	Врядування має відбуватися на очах, там, щоб його побоювалися.	true
building_short_description_texts_short_description_att_bld_eastern_sassanid_civic_market_food_4	Місце купівлі та продажу, де кожен отримує прибуток.	true
building_short_description_texts_short_description_att_bld_eastern_sassanid_civic_market_food_3	М'ясо! Свіже м'ясо! СМАКОВИТЕ м'яско!	true
building_short_description_texts_short_description_att_bld_eastern_sassanid_civic_localpalace_4	Людям треба нагадати, чому їхні лідери кращі.	true
building_short_description_texts_short_description_att_bld_eos_religion_judaism_major_faction_4	І станете для мене царством священників і народом святим.	true
building_short_description_texts_short_description_att_bld_eos_religion_judaism_major_faction_2	Завдяки ретельному вивченню таємниці будуть розкриті.	true
building_short_description_texts_short_description_att_bld_eos_religion_judaism_major_faction_3	Те, що було сказано, записано назавжди.	true
building_short_description_texts_short_description_att_bld_eos_religion_judaism_major_faction_1	Вчення Бога, передане нам через Мойсея.	true
building_short_description_texts_short_description_att_bld_religion_celtic_minor_water_3	Боги живуть всередині, чекаючи почути молитви людей.	true
building_short_description_texts_short_description_att_bld_religion_celtic_minor_water_2	Чиста і незаплямована вода є джерелом життя.	true
building_short_description_texts_short_description_att_bld_religion_celtic_minor_water_4	Коли земля буде полита кров’ю, наші молитви будуть почуті.	true
building_short_description_texts_short_description_att_bld_roman_west_civic_monument_3	Викарбуй свою перемогу, щоб світ вічно бачив її.	true
building_short_description_texts_short_description_att_bld_roman_west_civic_monument_2	Нехай люди бачать Ваші тріумфи - витесані з піску та каменю.	true
building_short_description_texts_short_description_att_bld_roman_west_civic_monument_4	Немає більшого доказу слави, ніж цей заповіт - проголошений богам.	true
building_short_description_texts_short_description_att_bld_eastern_sassanid_civic_court_school_4	Місце навчання та культури, де багаті стають могутніми.	true
building_short_description_texts_short_description_att_bld_eastern_sassanid_civic_court_school_3	Знання – це сила.	true
building_short_description_texts_short_description_bel_bld_camp_workshop_armour_4	Кращих обладунків в самому Константинополі не знайдеш!	true
building_short_description_texts_short_description_bel_bld_camp_workshop_armour_2	Ні, я також не знаю, чому намет не горить.	true
building_short_description_texts_short_description_bel_bld_camp_workshop_armour_3	Коли битва наближається, зброяр робить себе чутним.	true
building_short_description_texts_short_description_att_bld_eastern_sassanid_water_baths_4	Боротьба знаті гнітюча. Розслабтеся і дозвольте своїм турботам змитися.	true
building_short_description_texts_short_description_att_bld_eastern_sassanid_water_baths_3	Нехай тепло і вода очищають Вас.	true
building_short_description_texts_short_description_att_bld_eastern_sassanid_water_baths_2	Відпочиньте від справ, говоріть вільно та будьте чистими.	true
building_short_description_texts_short_description_att_bld_eastern_sassanid_water_major_1	У східних пустелях вода - це життя.	true
building_short_description_texts_short_description_att_bld_roman_water_minor_3	У кожній кімнаті гарячіше, ніж у попередній.	true
building_short_description_texts_short_description_att_bld_roman_water_minor_2	Кімната, де можна посидіти, викупатися та планувати день...	true
building_short_description_texts_short_description_att_bld_roman_water_minor_1	Просте місце, щоб помитися і, можливо, поговорити.	true
building_short_description_texts_short_description_att_bld_roman_water_minor_4	Величне свідчення імперії, в гігантській парильні.	true
building_short_description_texts_short_description_att_bld_roman_west_civic_garrison_3	Значна захисна сила, ці люди будуть тримати оборону.	true
building_short_description_texts_short_description_att_bld_roman_west_civic_garrison_2	Можливо, їх небагато, але ця залога воює із завзяттям.	true
building_short_description_texts_short_description_att_bld_roman_west_civic_garrison_1	Боєздатні міщани, налаштовані на захист своїх домівок.	true
building_short_description_texts_short_description_att_bld_roman_west_civic_garrison_4	Ці люди стояли, бо ці стіни і захищали їх протягом тривалого часу.	true
building_short_description_texts_short_description_att_bld_barbarian_civic_greathall_2	Влада - цікава штука. Невидима, але її потрібно побачити, щоб повірити.	true
building_short_description_texts_short_description_att_bld_all_industry_major_pottery_4	Добре обпалена цегла та черепиця прискорюють виконання великих робіт.	true
building_short_description_texts_short_description_att_bld_all_industry_major_pottery_2	Проста глина робить можливою велич.	true
building_short_description_texts_short_description_att_bld_all_industry_major_pottery_3	Для сушіння цегли та черепиці на сонці потрібен простір	true
building_short_description_texts_short_description_att_bld_eastern_sassanid_civic_court_2	Клянусь Богом і людьми, має бути справедливість.	true
building_short_description_texts_short_description_att_bld_religion_arian_major_1	Скрізь повинна бути маленька кімната розради, для поклоніння.	true
building_short_description_texts_short_description_att_bld_eastern_sassanid_civic_court_palace_3	Якщо багатство людини не демонструється, як інші дізнаються про її велич?	true
building_short_description_texts_short_description_att_bld_all_livestock_sheep_4	Овечі загони утримують на відстані хижаків, як людей, так і звірів.	true
building_short_description_texts_short_description_att_bld_all_livestock_sheep_2	Джерело м’яса та тепла в морозні пустельні ночі.	true
building_short_description_texts_short_description_att_bld_all_livestock_sheep_3	Випущені на вільний випас, вівці дають смачне м’ясо і блискучу вовну.	true
building_short_description_texts_short_description_att_bld_eastern_sassanid_civic_court_palace_4	Палац, придатний для самого Царя Царів.	true
building_short_description_texts_short_description_att_bld_barbarian_civic_chieftain_4	Мудрий воєвода завжди тримає своїх найсильніших людей при собі.	true
building_short_description_texts_short_description_att_bld_barbarian_civic_chieftain_3	Чоловікам важливо збиратися і ділитися радощами життя.	true
building_short_description_texts_short_description_att_bld_eos_religion_semitic_major_faction_1	Моліться козерогу, щоб були рясні дощі і великий урожай.	true
building_short_description_texts_short_description_att_bld_eos_religion_semitic_major_faction_3	Володар Козерогів проведе Вас шляхом крізь темряву.	true
building_short_description_texts_short_description_att_bld_eos_religion_semitic_major_faction_2	Зі списом у руці та громом за ним, Бог Ранкової Зірки вестиме нас до перемоги.	true
building_short_description_texts_short_description_att_bld_eos_religion_semitic_major_faction_4	Нехай Діти Альмаки зберуться тут і віддадуть хвалу.	true
building_short_description_texts_short_description_att_bld_eastern_sassanid_civic_minor_1	Зі свого великого палацу губернатор диктує бажання короля.	true
building_short_description_texts_short_description_att_bld_all_resources_gems_alamanni_4	Знавець легко відрізнить рубін від аквамарину, лазурит від морганіту.	true
building_short_description_texts_short_description_att_bld_roman_civic_major_1	Якщо Вам є що сказати, це те місце, щоб сказати це.	true
building_short_description_texts_short_description_att_bld_all_resources_gems_alamanni_1	Рубіни, сапфіри, діаманти - розкриті скарби землі.	true
building_short_description_texts_short_description_att_bld_all_resources_gems_alamanni_2	Процес отримання необробленого коштовного каміння і надання їм блиску — це майстерне ремесло.	true
building_short_description_texts_short_description_att_bld_all_resources_gems_alamanni_3	Меч, інкрустований коштовностями, може бути для когось яскравим, але досить добре демонструє силу.	true
building_short_description_texts_short_description_att_bld_all_resources_marble_quarry_4	Мармур, який виробляється тут у величезних кількостях, щоб годувати жагу людини до краси.	true
building_short_description_texts_short_description_att_bld_roman_civic_market_cattle_3	П'ять корів, це остаточно. Не будьте нахабними щодо цього.	true
building_short_description_texts_short_description_att_bld_roman_civic_market_cattle_4	Згромадження цінних корів - уява для биків.	true
building_short_description_texts_short_description_att_bld_all_resources_marble_quarry_2	Мармур викликає захоплення, а потім і бажання багатьох.	true
building_short_description_texts_short_description_att_bld_all_resources_marble_quarry_3	Великі храми та витвори мистецтва висічені з цього прекрасного каменю.	true
building_short_description_texts_short_description_bel_bld_camp_officers_prison_2	Тримай це в секреті. Зберігайте це в безпеці	true
building_short_description_texts_short_description_bel_bld_camp_officers_prison_3	Залишайтеся на деякий час, на радість імператора.	true
building_short_description_texts_short_description_bel_bld_camp_officers_prison_4	Ваша доля більше не належить Вам. Її вирішать інші.	true
building_short_description_texts_short_description_att_bld_eastern_sassanid_military_cavalry_4	Пуштигбан вимагає не тільки вмінь - ти повинен віддати своє життя!	true
building_short_description_texts_short_description_att_bld_eastern_sassanid_military_cavalry_1	Воїни можуть битися верхи, але не всі вершники є воїнами.	true
building_short_description_texts_short_description_att_bld_eastern_sassanid_military_cavalry_3	Лук, спис, меч: чоловік повинен володіти всіма елементами кавалерійського бою.	true
building_short_description_texts_short_description_att_bld_eastern_sassanid_military_cavalry_2	Дворянство поповнює лави, але й воно має навчитися воювати.	true
building_short_description_texts_short_description_att_bld_eos_religion_judaism_minor_faction_2	Чистота і святість. Змийте неприємності життя.	true
building_short_description_texts_short_description_att_bld_eos_religion_judaism_minor_faction_3	Навіть Мойсей міг би подумати, що це багато води.	true
building_short_description_texts_short_description_att_bld_eos_religion_judaism_minor_faction_1	Простота в природній воді і чистота в її очисній силі.	true
building_short_description_texts_short_description_att_bld_eastern_sassanid_civic_market_spice_4	Хто контролює пряності, той контролює світ...	true
building_short_description_texts_short_description_att_bld_eastern_sassanid_civic_market_spice_3	Шовковим шляхом, від екзотичних країв до Вас.	true
building_short_description_texts_short_description_att_bld_eastmig_military_inf_3	Для боротьби потрібна мужність. Щоб добре битися, потрібна дисципліна.	true
building_short_description_texts_short_description_bel_bld_roman_water_major_4	Розумна людина готується до поганого врожаю і довгої зими.	true
building_short_description_texts_short_description_bel_bld_roman_water_major_3	Достаток збіжжя — достаток багатства.	true
building_short_description_texts_short_description_bel_bld_roman_water_major_2	Їжу потрібно кудись подіти перед вечерею, напевно?	true
building_short_description_texts_short_description_bel_bld_roman_water_major_1	Їжа, збережена подалі від заздрісних очей, може ще прослужити зиму.	true
building_short_description_texts_short_description_cha_bld_trader_mus_3	Центр місцевої торгівлі, тут можна купити та продати різноманітні речі.	true
building_short_description_texts_short_description_cha_bld_trader_mus_2	Тут комерція процвітає на місцевому рівні від світанку до заходу.	true
building_short_description_texts_short_description_cha_bld_trader_mus_1	Торгівельний пост з'єднує тих, хто живе далеко один від одного, щоб усі могли процвітати.	true
building_short_description_texts_short_description_att_bld_religion_orthodox_major_monestary_2	Спокійне споглядання наближає людину до Бога.	true
building_short_description_texts_short_description_att_bld_religion_orthodox_major_monestary_3	Жити за Його образом і подобою – це благословенне життя.	true
building_short_description_texts_short_description_att_bld_religion_orthodox_major_monestary_4	Ті, хто ділиться словом з іншими, наближаються до Нього.	true
building_short_description_texts_short_description_att_bld_roman_west_civic_governor_2	Людина яка керує, також повинна відпочивати від тих, ким вона керує.	true
building_short_description_texts_short_description_att_bld_roman_west_civic_governor_3	Кімната для губернатора, щоб прогулюватися по садах і міркувати про простолюдинів.	true
building_short_description_texts_short_description_att_bld_roman_west_civic_governor_4	Зі свого грандіозного будинку губернатор дивиться на людей не більше ніж на мурах.	true
building_short_description_texts_short_description_att_bld_all_resources_iron_armory_2	Будь-хто може склепати зброю, але створити її під силу тільки майстру.	true
building_short_description_texts_short_description_att_bld_all_resources_iron_armory_3	Кування зброї потребує гострого зору і міцної руки.	true
building_short_description_texts_short_description_att_bld_all_resources_iron_armory_4	Спорядити армію для війни – це нелегке завдання.	true
building_short_description_texts_short_description_att_bld_roman_east_civic_governor_2	Вражаюча будівля, щоб заткнути тих, хто сумнівається. Це місто тут, щоб стоти вічно.	true
building_short_description_texts_short_description_att_bld_roman_east_civic_governor_3	Розлога купа, що підходить для руки імператора.	true
building_short_description_texts_short_description_att_bld_roman_east_civic_governor_4	На всяк випадок не зрозуміло, хто саме тут головний…?	true
building_short_description_texts_short_description_att_bld_religion_celtic_minor_burial_3	Про шанованих загиблих ніколи не можна забувати.	true
building_short_description_texts_short_description_att_bld_religion_celtic_minor_burial_2	Вартові стоять на варті священної землі.	true
building_short_description_texts_short_description_att_bld_religion_celtic_minor_burial_4	Вони сплять під землею, поки вони не знадобляться богам.	true
building_short_description_texts_short_description_att_bld_eastern_sassanid_civic_market_slave_4	Світ носять на спинах, проданий тому, хто запропонує найвищу ціну.	true
building_short_description_texts_short_description_att_bld_all_industry_minor_generic_1	Працьовиті люди - щасливі люди.	true
building_short_description_texts_short_description_att_bld_eastern_sassanid_civic_market_slave_3	Панночко, погляньте, які гарненькі телята!	true
building_short_description_texts_short_description_att_bld_barbarian_civic_chieftain_5_legendary	Зайдіть усередину. Не чіпай медовий ріг. Або той череп...	true
building_short_description_texts_short_description_att_bld_roman_civic_entertain_drama_4	Весь світ — сцена! Ця сцена, зокрема.	true
building_short_description_texts_short_description_att_bld_roman_civic_entertain_arena_3	Вам не весело!?	true
building_short_description_texts_short_description_att_bld_roman_civic_entertain_arena_4	Давай, давай! Побачте сліпуче видовище перед своїми очима!	true
building_short_description_texts_short_description_att_bld_roman_civic_entertain_drama_3	Виступи, які можуть змінити Вас. "Можна" - головне слово...	true
building_short_description_texts_short_description_att_bld_barbarian_civic_storyteller_3	Розповіді про хоробрість і доблесть завжди привертають чоловіків до вогнища.	true
building_short_description_texts_short_description_att_bld_barbarian_civic_storyteller_5	У кожного племені повинен бути цар, але перед ким він відповідає?	true
building_short_description_texts_short_description_att_bld_barbarian_civic_storyteller_4	Прислухайтеся до його слів, бо він мудрий понад розуміння смертних людей.	true
building_short_description_texts_short_description_bel_bld_roman_civic_library_2	Право, наука і медицина. За все наше майбутнє.	true
building_short_description_texts_short_description_bel_bld_roman_water_minor_3	Різниця між цистерною і резервуаром зазвичай полягає в даху.	true
building_short_description_texts_short_description_bel_bld_roman_civic_library_3	Навчання, придатне для короля.	true
building_short_description_texts_short_description_bel_bld_roman_water_minor_2	Насправді все досить просто - вода потрапляє в резервуар і залишається там, поки вона не знадобиться.	true
building_short_description_texts_short_description_att_bld_roman_civic_library_3	Найкраща зброя у світі для тих, хто вміє нею користуватися.	true
building_short_description_texts_short_description_bel_bld_roman_water_minor_1	Дорогоцінна вода для всієї громади.	true
building_short_description_texts_short_description_att_bld_roman_civic_library_2	Писарі, відокремлені та рішучі, документують історію.	true
building_short_description_texts_short_description_att_bld_roman_civic_library_4	Вільні лише освічені.	true
building_short_description_texts_short_description_bel_bld_roman_civic_library_4	Не можна померти з незавершеною книгою.	true
building_short_description_texts_short_description_bel_bld_roman_water_minor_4	Коли людина може контролювати шлях води, вона ближча до свого Творця.	true
building_short_description_texts_short_description_att_bld_all_industry_minor_tannery_4	Товста шкіра послужить Вам гарну службу - але краще товста кіраса.	true
building_short_description_texts_short_description_att_bld_all_industry_minor_tannery_2	Вичинена шкіра є цінною.	true
building_short_description_texts_short_description_att_bld_all_industry_minor_tannery_3	Тут ми робимо шкіру міцною. Ви не бажаєте знати, як.	true
building_short_description_texts_short_description_att_bld_all_industry_major_generic_1	Працьовите, б'ється серце будь-якого міста.	true
building_short_description_texts_short_description_att_bld_all_resources_gold_jeweler_4	Справжній майстер бачить красу в найпростіших речах.	true
building_short_description_texts_short_description_att_bld_all_resources_gold_jeweler_2	Найкрасивіше, зроблене рукою коваля.	true
building_short_description_texts_short_description_att_bld_all_resources_gold_jeweler_3	Рідке золото можна використовувати для виготовлення багатьох вишуканих предметів.	true
building_short_description_texts_short_description_bel_bld_roman_civic_major_1	Якщо Вам є що сказати, це те місце, щоб сказати це.	true
building_short_description_texts_short_description_att_bld_barbarian_industry_claypit_2	Земля дає засоби для створення прекрасних предметів.	true
building_short_description_texts_short_description_att_bld_barbarian_industry_claypit_3	Уміння з’єднувати та фіксувати великі камені справді цінно.	true
building_short_description_texts_short_description_att_bld_barbarian_industry_claypit_4	Чоловіки, які вміють працювати з таким дивним матеріалом, викликають повагу.	true
building_short_description_texts_short_description_att_bld_religion_catholic_major_monestary_3	Де твій скарб, чи буде й твоє серце?	true
building_short_description_texts_short_description_att_bld_religion_catholic_major_monestary_2	І справа праведності буде миром.	true
building_short_description_texts_short_description_att_bld_religion_catholic_major_monestary_4	Господь дає, Господь і забирає - благословенне ім'я Його.	true
building_short_description_texts_short_description_att_bld_roman_west_military_cavalry_4	Кавалерист повинен бути готовий миттєво виїхати.	true
building_short_description_texts_short_description_att_bld_roman_west_military_cavalry_2	Кінь понесе Вас у бій, але боротися повинні Ви самі.	true
building_short_description_texts_short_description_att_bld_roman_west_military_cavalry_3	Де можна знайти і коня, і вершника?	true
building_short_description_texts_short_description_%placeholder%	%placeholder%	true
building_short_description_texts_short_description_cha_bld_barracks_mus_1	Колекція людей зі списами краще, ніж натовп без нічого.	true
building_short_description_texts_short_description_cha_bld_barracks_mus_3	Деякі з Вас можуть померти - але я готовий піти на цю жертву.	true
building_short_description_texts_short_description_cha_bld_barracks_mus_2	Старанно тренуйтеся, добре бийтеся. Деякі з Вас зможуть вижити.	true
building_short_description_texts_short_description_att_bld_nomad_artisan_forge_4	Вирушайте в бій належним чином одягненим і бийтеся у битві  не гірше.	true
building_short_description_texts_short_description_att_bld_roman_west_military_1	Прокидатися о четвертій. Тренуйтеся, поки не впадете. Потім зробіть це ще раз.	true
building_short_description_texts_short_description_att_bld_nomad_artisan_forge_2	З металу можна зробити військову зброю, застібки, осі коліс і навіть ложки.	true
building_short_description_texts_short_description_att_bld_nomad_artisan_forge_3	Загартована сталь і загартовані духи роблять кочовика лютим.	true
building_short_description_texts_short_description_att_bld_all_resources_furs_2	Підкрався в лісі, занадто близько, щоб сховатися.	true
building_short_description_texts_short_description_att_bld_all_resources_furs_3	Скільки!? Ти намагаєшся обдурити мене?	true
building_short_description_texts_short_description_att_bld_all_resources_furs_1	У дотику землі. І на полюванні.	true
building_short_description_texts_short_description_att_bld_all_resources_furs_4	Місце для обміну та купівлі. Ціни незмінні, але й не кусючі.	true
building_short_description_texts_short_description_cha_bld_city_3	Світоч культури та процвітання.	true
building_short_description_texts_short_description_cha_bld_city_2	Респектабельний, зростаючий осередок працьовитих зусиль.	true
building_short_description_texts_short_description_cha_bld_city_1	Незначні цеглинки величі.	true
building_short_description_texts_short_description_att_bld_all_resources_gold_1	Золото, не завжди блищить, а те, що блищить не завжди золото.	true
building_short_description_texts_short_description_att_bld_all_resources_gems_2	Щоб вирізати та формувати скарби землі, потрібна велика майстерність.	true
building_short_description_texts_short_description_att_bld_all_resources_gems_3	Блискучі самоцвіти привертають захоплені погляди до ларька торговця.	true
building_short_description_texts_short_description_att_bld_all_resources_gems_1	Діаманти - найкращі друзі кожного. Правильно я кажу?	true
building_short_description_texts_short_description_att_bld_all_resources_gems_4	Я можу отримати все, що забажаєте, тільки назвіть ціну. Без запитань…	true
building_short_description_texts_short_description_att_bld_roman_west_military_infantry_2	Тут солдати їдять, п'ють, сплять, дихають.	true
building_short_description_texts_short_description_att_bld_roman_west_military_infantry_3	Сильна піхота будується на організації і порядку.	true
building_short_description_texts_short_description_att_bld_roman_west_military_infantry_4	Щоранку встає могутня армія, знаючи, що її може зустріти смерть.	true
building_short_description_texts_short_description_att_bld_all_resources_orchards_fruit_2	Оливки, інжир, яблука. Незначний урожай.	true
building_short_description_texts_short_description_att_bld_all_resources_orchards_fruit_3	500 яблук на день і обійдемося без лихваря.	true
building_short_description_texts_short_description_att_bld_all_resources_orchards_fruit_4	Мудрі зберігають запаси сухофруктів в коморах, на будь-який випадок.	true
building_short_description_texts_short_description_cha_bld_market_town_3	Де життя присвячене комерції та створенню багатства в ній.	true
building_short_description_texts_short_description_cha_bld_market_town_2	Кожен амбітний торговець має з чогось почати.	true
building_short_description_texts_short_description_cha_bld_market_town_1	Осередок місцевої торгівлі, де обмінюються товарами, щоб полегшити суворе життя.	true
building_short_description_texts_short_description_att_bld_religion_manichaeist_major_1	Відкрийте своє серце і дозвольте світлу засяяти.	true
building_short_description_texts_short_description_att_bld_all_resources_dyes_4	Щоб зробити пурпур, як у Тірії, потрібно багато равликів.	true
building_short_description_texts_short_description_att_bld_all_resources_dyes_2	Ви можете мати будь-який колір, який Вам подобається, якщо він пурпуровий.	true
building_short_description_texts_short_description_att_bld_all_resources_dyes_3	Чоловіки будуть добре платити, щоб виглядати багатшими за своїх однолітків.	true
building_short_description_texts_short_description_att_bld_all_resources_dyes_1	Якщо я більше ніколи не побачу жодного равлика, це буде занадто рано.	true
building_short_description_texts_short_description_cha_bld_blacksmith_1	Те, що зроблене майстром-ковалем, залишиться на все життя.	true
building_short_description_texts_short_description_cha_bld_blacksmith_2	Сучасний світ народжений кузнею.	true
building_short_description_texts_short_description_bel_bld_camp_food_1	Їжу потрібно кудись подіти перед вечерею, напевно?	true
building_short_description_texts_short_description_att_bld_nomad_herders_goats_4	Ви ніколи не пропустите кіз. Просто йдіть на блеяння.	true
building_short_description_texts_short_description_cha_bld_mead_hall_1	Пий до кінця і вихваляй богів.	true
building_short_description_texts_short_description_cha_bld_mead_hall_2	Воїну не потрібно нічого, крім зброї і даху над головою.	true
building_short_description_texts_short_description_cha_bld_mead_hall_3	В яких піснях оспівується героїзм і доблесть.	true
building_short_description_texts_short_description_att_bld_nomad_herders_goats_2	Кози прості й скромні, але вони забезпечують життя.	true
building_short_description_texts_short_description_att_bld_nomad_herders_goats_3	Розумієте, у кіз є власний розум, тож Ви повинні зловити їх у пастку!	true
building_short_description_texts_short_description_cha_bld_gold_1	Спокуса золота змушує забути навіть наймудрішу людину.	true
building_short_description_texts_short_description_cha_bld_gold_3	Щоб відкрити найпрекрасніший із дарів землі, треба копнути глибше.	true
building_short_description_texts_short_description_cha_bld_gold_2	Великі родовища золота, що розтікаються озерами і пробиваються річками крізь скелі…	true
building_short_description_texts_short_description_att_bld_roman_water_sewers_2	Усе це сміття має кудись діватися.	true
building_short_description_texts_short_description_att_bld_roman_water_sewers_3	Стічні канали, об’єднані разом і відведені.	true
building_short_description_texts_short_description_att_bld_eos_religion_judaism_minor_1	Простота в природній воді і чистота в її очисній силі.	true
building_short_description_texts_short_description_att_bld_roman_civic_market_2	Будь ласка, будь ласка, підійди ближче… У мене всякі речі…	true
building_short_description_texts_short_description_att_bld_roman_water_sewers_4	Всі це роблять. Я маю на увазі мережі…. ясно які.	true
building_short_description_texts_short_description_att_bld_eos_religion_judaism_minor_3	Навіть Мойсей міг би подумати, що це багато води.	true
building_short_description_texts_short_description_att_bld_eos_religion_judaism_minor_2	Чистота і святість. Змийте неприємності життя.	true
building_short_description_texts_short_description_bel_bld_camp_camp_1	Армія повинна відпочити після довгого походу в невідомі землі.	true
building_short_description_texts_short_description_bel_bld_camp_camp_3	Стяги повинні захищатися ціною життя.	true
building_short_description_texts_short_description_bel_bld_camp_camp_2	Пустеля, рівнина чи болото, табір має бути створений відповідно до докладних специфікацій.	true
building_short_description_texts_short_description_cha_bld_scriptorium_2	Коли знання – це сила, важливо зберегти їх для використання в майбутньому.	true
building_short_description_texts_short_description_bel_bld_camp_camp_4	Армія потребує надійного укриття. Як довго? Добре...	true
building_short_description_texts_short_description_cha_bld_scriptorium_3	Знання Святого Письма та мистецтво використано як найкраще.	true
building_short_description_texts_short_description_cha_bld_scriptorium_1	Коли мало хто вміє читати і писати, завжди є робота для тих, хто вміє.	true
building_short_description_texts_short_description_att_bld_religion_zoroastrian_major_burial_4	Поховані глибоко, мертві не можуть забруднити живих.	true
building_short_description_texts_short_description_att_bld_religion_zoroastrian_major_burial_1	Покладіть їхні тіла перед відкритим небом, щоб вони могли знайти спокій.	true
building_short_description_texts_short_description_att_bld_religion_zoroastrian_major_burial_2	Живі не повинні допускати, щоб мертві були серед них.	true
building_short_description_texts_short_description_att_bld_religion_zoroastrian_major_burial_3	Місце кісток, де кладуть мертвих.	true
building_short_description_texts_short_description_att_bld_all_resources_marble_mason_2	Колона символізує силу і славу.	true
building_short_description_texts_short_description_att_bld_all_resources_marble_mason_3	Статуя? Постійне втілення волі.	true
building_short_description_texts_short_description_att_bld_all_resources_marble_mason_4	Все, що Ви бажаєте, зроблено: з граніту, мармуру або вапняку.	true
building_short_description_texts_short_description_att_bld_eastern_sassanid_city_minor_generic_1	Врядування має відбуватися на очах, там, щоб його побоювалися.	true
building_short_description_texts_short_description_att_bld_eastern_sassanid_city_minor_generic_3	Людям треба нагадати, чому їхні лідери кращі.	true
building_short_description_texts_short_description_att_bld_eastern_sassanid_city_minor_generic_2	Обов'язок дворянина - нагадувати людям про їхнє місце в його світі.	true
building_short_description_texts_short_description_att_bld_eastern_sassanid_city_minor_generic_4	Зі свого великого палацу губернатор диктує бажання короля.	true
building_short_description_texts_short_description_att_bld_all_resources_marble_1	Щоб розколоти великі шматки каменю, потрібні сила та вміння.	true
building_short_description_texts_short_description_att_bld_all_livestock_horses_4	Дуже потрібна порода, нісейська – принц серед коней.	true
building_short_description_texts_short_description_att_bld_all_livestock_horses_3	Найкращі коні вимагають особливого догляду та уваги.	true
building_short_description_texts_short_description_att_bld_all_livestock_horses_2	Сильні сини народжуються від сильних батьків.	true
building_short_description_texts_short_description_att_bld_eos_religion_semitic_major_4	Нехай Діти Альмаки зберуться тут і віддадуть хвалу.	true
building_short_description_texts_short_description_att_bld_eos_religion_semitic_major_2	Зі списом у руці та громом за ним, Бог Ранкової Зірки вестиме нас до перемоги.	true
building_short_description_texts_short_description_att_bld_eos_religion_semitic_major_3	Володар Козерогів проведе Вас шляхом крізь темряву.	true
building_short_description_texts_short_description_att_bld_eos_religion_semitic_major_1	Моліться козерогу, щоб були рясні дощі і великий урожай.	true
building_short_description_texts_short_description_att_bld_eos_pleasure_4	Тисяча насолод за одну годину, або гроші повертаються!	true
building_short_description_texts_short_description_att_bld_eos_pleasure_1	Кожному потрібен друг у важкі часи.	true
building_short_description_texts_short_description_att_bld_eos_pleasure_2	Ляжте, розслабтеся і нехай забудуться життєві турботи.	true
building_short_description_texts_short_description_att_bld_eos_pleasure_3	Гріх - це не більше, ніж слово.	true
building_short_description_texts_short_description_cha_bld_craftsmen_1	Нитки та прядиво - створюють тканину як для одягу, так і для житла.	true
building_short_description_texts_short_description_cha_bld_craftsmen_2	Одягти людей так само важливо, як і озброїти їх.	true
building_short_description_texts_short_description_att_bld_eos_military_infantry_5_zoroastrian	Праведна людина буде боротися з жахливою люттю.	true
building_short_description_texts_short_description_cha_bld_craftsmen_3	Всім потрібен одяг. Мудра людина завжди знайде отримати з цього користь.	true
building_short_description_texts_short_description_att_bld_all_agriculture_vegetables_4	Я вважаю, що морква набагато чарівніша, ніж герань...	true
building_short_description_texts_short_description_att_bld_all_agriculture_vegetables_2	Це родюча земля, і ми будемо процвітати.	true
building_short_description_texts_short_description_att_bld_all_agriculture_vegetables_3	Підживлені водою з гір посіви будуть процвітати.	true
building_short_description_texts_short_description_att_bld_roman_west_senate_5_legendary	Нехай тут буде порядок, поки навколо нас вирує хаос.	true
building_short_description_texts_short_description_att_bld_religion_manichaeist_minor_1	Нехай Апостол Світла засяє на Вас своїм світлом.	true
building_short_description_texts_short_description_att_bld_religion_manichaeist_minor_2	Всі люди повинні вибирати між світлом і темрявою.	true
building_short_description_texts_short_description_att_bld_religion_manichaeist_minor_3	Ми повинні дякувати за зігріваюче світло сонця.	true
building_short_description_texts_short_description_att_bld_religion_manichaeist_minor_4	Не всі, хто ходить у темряві, заблукали.	true
building_short_description_texts_short_description_cha_bld_wine_market_3	Ніщо не здається таким поганим через призму солодкого вина.	true
building_short_description_texts_short_description_cha_bld_wine_market_2	Передайте вина, будь ласка? Розумієш, це ще не все безвихідь.	true
building_short_description_texts_short_description_cha_bld_wine_market_1	Вино є розділовим знаком у життєвому вироку, який інакше не впинається.	true
building_short_description_texts_short_description_att_bld_all_resources_lead_2	Побічний продукт срібла, але дорогоцінний сам по собі.	true
building_short_description_texts_short_description_att_bld_all_resources_lead_3	Залізо захистить Вас від мечів, а свинець захистить Вас від спраги.	true
building_short_description_texts_short_description_att_bld_all_resources_lead_1	Ми нагріваємо камінь, наносимо холодний оцет і БУМ! І свинцю хоч їж.	true
building_short_description_texts_short_description_att_bld_all_resources_lead_4	Жоден дах і водостік у нашому славному місті не протікає.	true
building_short_description_texts_short_description_att_bld_eastmig_city_3	Люди пустелі, які живуть своїм життям під поглядом сонця.	true
building_short_description_texts_short_description_att_bld_eastmig_city_2	У нас тисячі таких схованок, і лише деякі з нас знають їх усі.	true
building_short_description_texts_short_description_att_bld_eastmig_city_1	Те, що може здатися убогим, є домом для тисячі тисяч.	true
building_short_description_texts_short_description_att_bld_eastmig_city_4	Сідло — це фортеця.	true
building_short_description_texts_short_description_cha_bld_iron_1	Залізо гарантує шану та повагу його власникам.	true
building_short_description_texts_short_description_cha_bld_iron_2	Залізна руда, після очищення, робить щось більш цінним і нескінченно більш небезпечним.	true
building_short_description_texts_short_description_cha_bld_iron_3	Ось! Настала епоха сталі, за якою обов’язково прийде руїна.	true
building_short_description_texts_short_description_cha_bld_goldsmith_1	Працьовите, б'ється серце будь-якого міста.	true
building_short_description_texts_short_description_cha_bld_goldsmith_3	Майстер-золотар створює гроші. Король їх витрачає.	true
building_short_description_texts_short_description_cha_bld_goldsmith_2	Найкрасивіше, зроблене рукою коваля.	true
building_short_description_texts_short_description_cha_bld_food_market_2	Нам усім потрібно їсти. Ця людина виграє від цього простого факту.	true
building_short_description_texts_short_description_cha_bld_food_market_3	Все і кожен має свою ціну.	true
building_short_description_texts_short_description_cha_bld_food_market_1	Місце купівлі та продажу, де кожен отримує прибуток.	true
building_short_description_texts_short_description_att_bld_all_military_upgrades_wood_2	Обробляти деревину на корисні предмети – цінне вміння.	true
building_short_description_texts_short_description_att_bld_all_military_upgrades_wood_3	Усі величні будівлі та потужність, яку вони демонструють, починаються тут.	true
building_short_description_texts_short_description_att_bld_all_military_upgrades_wood_4	Машини смерті та руйнування, висічені зі простого дерева.	true
building_short_description_texts_short_description_att_bld_all_industry_major_pewter_4	Виробництво вдень і вночі - справжнє олов'яне місто.	true
building_short_description_texts_short_description_att_bld_all_industry_major_pewter_3	Виделки мають своє призначення, але тарілка коштує свого, е-е, олова.	true
building_short_description_texts_short_description_att_bld_all_industry_major_pewter_2	Якщо він містить олово, з нього можна зробити олово.	true
building_short_description_texts_short_description_att_bld_eastmig_community_commerce_4	Квартирмейстер бачить, що люди ситі й озброєні.	true
building_short_description_texts_short_description_att_bld_eastmig_community_commerce_3	Господи, знайте, що Ваші улани завдали вирішального удару на нашу користь...	true
building_short_description_texts_short_description_att_bld_eastmig_community_commerce_2	Нехай наша історія буде записана, щоб інші дивувалися.	true
building_short_description_texts_short_description_att_bld_all_livestock_cows_4	Корова — тварина універсальна, прибуткова.	true
building_short_description_texts_short_description_att_bld_all_livestock_cows_2	Випас великої рогатої худоби набагато кращий, ніж пасти котів.	true
building_short_description_texts_short_description_att_bld_all_livestock_cows_3	Худоба блукає полями із заздрісною недбалістю.	true
building_short_description_texts_short_description_att_bld_barbarian_port_trade_3	Тут купують і продають достаток і процвітання.	true
building_short_description_texts_short_description_att_bld_barbarian_port_trade_2	Без торгівлі люди не можуть процвітати.	true
building_short_description_texts_short_description_att_bld_barbarian_port_trade_4	Тут кидають якір човни з усього світу, щоб торгувати своїми товарами.	true
building_short_description_texts_short_description_att_bld_religion_manichaeist_major_monestary_3	Багато вогнів, що сяють разом, найяскравіші з усіх.	true
building_short_description_texts_short_description_att_bld_religion_manichaeist_major_monestary_2	Сама у темряві людина йтиме за світлом.	true
building_short_description_texts_short_description_att_bld_religion_manichaeist_major_monestary_4	Книги – світло світу.	true
building_short_description_texts_short_description_att_bld_religion_zoroastrian_minor_3	Творити добро – це не обов’язок, а радість, бо це примножує наше здоров’я та щастя.	true
building_short_description_texts_short_description_att_bld_religion_zoroastrian_minor_2	Добрі слова, добрі думки, добрі справи.	true
building_short_description_texts_short_description_att_bld_religion_zoroastrian_minor_1	Мудра людина шукає чистоти в усьому, що вона робить.	true
building_short_description_texts_short_description_att_bld_religion_zoroastrian_minor_4	Не плекайте в собі жадібність, бо демон жадоби оманить Вас.	true
building_short_description_texts_short_description_att_bld_eos_religion_judaism_major_1	Вчення Бога, передане нам через Мойсея.	true
building_short_description_texts_short_description_att_bld_eos_religion_judaism_major_3	Те, що було сказано, записано назавжди.	true
building_short_description_texts_short_description_att_bld_eos_religion_judaism_major_2	Завдяки ретельному вивченню таємниці будуть розкриті.	true
building_short_description_texts_short_description_att_bld_eos_religion_judaism_major_4	І станете для мене царством священників і народом святим.	true
building_short_description_texts_short_description_att_bld_roman_east_senate_5_legendary	Нехай тут буде порядок, поки навколо нас вирує хаос.	true
building_short_description_texts_short_description_cha_bld_horse_show_1	Кінь може бути бажаним дзеркалом найкращого в людській природі.	true
building_short_description_texts_short_description_cha_bld_horse_show_2	За допомогою якого передається влада і сила панівної родини.	true
building_short_description_texts_short_description_cha_bld_long_hall_3	Влада - цікава штука. Невидима, але її потрібно побачити, щоб повірити.	true
building_short_description_texts_short_description_cha_bld_long_hall_2	Обов'язок шляхтича подвійний: перед королем і перед народом - щоб він знав своє місце.	true
building_short_description_texts_short_description_cha_bld_long_hall_1	Воїни збираються тут, щоб відсвяткувати або втопити події дня.	true
building_short_description_texts_short_description_att_bld_barbmigs_community_1	Перепочинок, лише на кілька годин, від поневірянь кампанії.	true
building_short_description_texts_short_description_cha_bld_mill_3	Природний рух припливів і відпливів, задіяний для годування народу.	true
building_short_description_texts_short_description_cha_bld_mine_3	Для доступу до багатих родовищ руди викопують глибокі тунелі та копальні.	true
building_short_description_texts_short_description_cha_bld_mill_2	Новітні технології можна перенести туди, де вони будуть найбільш ефективними.	true
building_short_description_texts_short_description_cha_bld_mine_2	До багатих родовищ руди можна дістатися через глибокі тунелі та копальні.	true
building_short_description_texts_short_description_cha_bld_mill_1	Самі сили природи подрібнюють кукурудзу.	true
building_short_description_texts_short_description_cha_bld_mine_1	Поверхневий видобуток менш небезпечний, але й менш прибутковий.	true
building_short_description_texts_short_description_cha_bld_port_trade_2	Тут кидають якір  човни з усього світу, щоб торгувати своїми товарами.	true
building_short_description_texts_short_description_cha_bld_port_trade_1	Тут купують і продають достаток і процвітання.	true
building_short_description_texts_short_description_att_bld_all_industry_major_mosaic_2	Гарне мистецтво вимагає чудових матеріалів.	true
building_short_description_texts_short_description_att_bld_all_industry_major_mosaic_3	Не зовнішній вигляд речей, а їх внутрішнє значення...	true
building_short_description_texts_short_description_att_bld_all_industry_major_mosaic_4	Одна людина створює мистецтво, багато художників створюють прибуток.	true
building_short_description_texts_short_description_att_bld_all_resources_iron_1	Тепер настає панування заліза, а разом з ним і загибель людини.	true
building_short_description_texts_short_description_att_bld_eos_religion_semitic_minor_2	Зірки можуть зійтися, і, трохи подумавши, ми все ж можемо вгадати долю людини…	true
building_short_description_texts_short_description_att_bld_eos_religion_semitic_minor_3	Каміння стоїть як свідчення того, що було раніше.	true
building_short_description_texts_short_description_att_bld_eos_religion_semitic_minor_1	Невеликий пам’ятник у правильному стилі справляє враження обеліска.	true
building_short_description_texts_short_description_cha_bld_lead_3	Незважаючи на те, що скло витончене та гарне, воно має багато практичних застосувань.	true
building_short_description_texts_short_description_cha_bld_lead_2	Для видобутку свинцю з руди потрібна висока температура.	true
building_short_description_texts_short_description_cha_bld_lead_1	Оскільки потреба цивілізації в свинці зростає, промисловий видобуток є єдиним рішенням.	true
building_short_description_texts_short_description_att_bld_nomad_artisan_weaver_2	Нитки та прядиво - створюють тканину як для одягу, так і для житла.	true
building_short_description_texts_short_description_att_bld_nomad_artisan_weaver_3	…Бо ніколи не знаєш, коли може знадобитися вміння плести.	true
building_short_description_texts_short_description_att_bld_nomad_artisan_weaver_4	Одягти людей так само важливо, як і озброїти їх.	true
building_short_description_texts_short_description_cha_bld_salt_3	Сіль, цінний консервант, можна обміняти майже на все.	true
building_short_description_texts_short_description_cha_bld_salt_2	Заготівля солі у великих масштабах є прибутковою справою.	true
building_short_description_texts_short_description_cha_bld_salt_1	Мало солі корисно, багато вигідно.	true
building_short_description_texts_short_description_att_bld_religion_grecoroman_major_2	Місце для поклоніння. Поклонятися Вашим богам, моїм богам, богам.	true
building_short_description_texts_short_description_att_bld_religion_grecoroman_major_3	Для всіх Ваших потреб у поклонінні.	true
building_short_description_texts_short_description_att_bld_religion_grecoroman_major_1	Це місце благословенне богами. Це священне місце.	true
building_short_description_texts_short_description_cha_bld_bimaristan_2	Немає жодної хвороби, яку створив Аллах, і від якої Він не має ліків.	true
building_short_description_texts_short_description_cha_bld_bimaristan_1	Тут перевіряють нові «ліки», тож хворі можуть зцілитися.	true
building_short_description_texts_short_description_att_bld_all_resources_wood_1	Тут природним чином можна знайти тепло та захист від стихії.	true
building_short_description_texts_short_description_att_bld_all_resources_wood_2	Скільки деревини міг нарубати дроворуб?	true
building_short_description_texts_short_description_att_bld_all_resources_wood_3	З якого будуються і підживлюються імперії.	true
building_short_description_texts_short_description_att_bld_all_resources_wood_4	Від великих військових човнів до скромних будинків деревина має багато застосувань.	true
building_short_description_texts_short_description_att_bld_eastern_sassanid_civic_court_gardens_3	Справжній рай тут, на землі.	true
building_short_description_texts_short_description_att_bld_eastern_sassanid_civic_court_gardens_4	Небесний притулок для володаря всього, що він досліджує.	true
building_short_description_texts_short_description_cha_bld_monastery_3	Це місце окремо від світу, його монахи повністю присвячують себе роздумам та молитві.	true
building_short_description_texts_short_description_cha_bld_monastery_2	Своїм прикладом монахи собору забезпечують духовне багатство своєї пастви.	true
building_short_description_texts_short_description_cha_bld_monastery_1	Щоб розмовляти з Богом, Вам не потрібен високий собор.	true
building_short_description_texts_short_description_att_bld_eastmig_military_infantry_5	Слава належить лише переможцям.	true
building_short_description_texts_short_description_att_bld_eastmig_military_infantry_4	Поразка ворогів сама по собі здобич.	true
building_short_description_texts_short_description_att_bld_eastern_sassanid_military_infantry_2	Деякі з Вас можуть померти - але я готовий піти на цю жертву.	true
building_short_description_texts_short_description_att_bld_eastern_sassanid_military_infantry_3	Старанно тренуйтеся, добре бийтеся. Деякі з Вас зможуть вижити.	true
building_short_description_texts_short_description_att_bld_eastern_sassanid_military_infantry_1	Колекція людей зі списами краще, ніж натовп без нічого.	true
building_short_description_texts_short_description_att_bld_eastern_sassanid_military_infantry_4	Ревно боротися в ім’я короля — це більше, ніж очікування - це обов'язок.	true
building_short_description_texts_short_description_att_bld_nomad_city_2	Навіть невблаганна орда повинна зупинитися на деякий час і оговтатися.	true
building_short_description_texts_short_description_att_bld_nomad_city_3	Чим більша орда, тим більшим має бути місце для свят.	true
building_short_description_texts_short_description_att_bld_nomad_city_0	Зупиніться, посидьте, побудьте трохи і відпочиньте.	true
building_short_description_texts_short_description_att_bld_nomad_city_1	Відпочинок серед друзів. Їх тисячі.	true
building_short_description_texts_short_description_att_bld_eos_military_infantry_5_east_church	Релігійний запал і майстерність володіння зброєю створюють небезпечних ворогів.	true
building_short_description_texts_short_description_att_bld_religion_manichaeist_major_church_2	Ми дякуємо Верховному Просвітителю за його жертви.	true
building_short_description_texts_short_description_att_bld_religion_manichaeist_major_church_3	Жити в темряві - це взагалі не життя.	true
building_short_description_texts_short_description_att_bld_religion_manichaeist_major_church_4	Храм світла, збудований на знак пошани апостола світла.	true
building_short_description_texts_short_description_cha_bld_wood_1	Скільки деревини міг нарубати дроворуб?	true
building_short_description_texts_short_description_cha_bld_wood_3	Від великих військових човнів до скромних будинків деревина має багато застосувань.	true
building_short_description_texts_short_description_cha_bld_wood_2	З якого будуються і підживлюються імперії.	true
building_short_description_texts_short_description_cha_bld_wine_3	Людина, яка п’є вино, на один день стає королем, а наступного — дуже дурним.	true
building_short_description_texts_short_description_cha_bld_wine_2	Цілі вози, навантажені вином. Уявіть собі…	true
building_short_description_texts_short_description_cha_bld_wine_1	Вино коштує дорого, якщо спочатку не випити все...	true
building_short_description_texts_short_description_bel_bld_all_agriculture_livestock_3	Загорода сильніша за стадо.	true
building_short_description_texts_short_description_bel_bld_all_agriculture_livestock_2	Корова - це їжа, і молоко. Корова - це прожиток.	true
building_short_description_texts_short_description_bel_bld_all_agriculture_livestock_4	Корова, ніколи не дізнається про свою нещасну долю в користі для людства.	true
building_short_description_texts_short_description_cha_bld_hall_elders_2	Прислухайтеся до його слів, бо він мудрий понад розуміння смертних людей.	true
building_short_description_texts_short_description_cha_bld_hall_elders_1	Розповіді про хоробрість і доблесть завжди привертають чоловіків до вогнища.	true
building_short_description_texts_short_description_att_bld_eastmig_industry_unit_cost_3	Щоб зберегти прохолоду під сонцем пустелі та зігрітися протягом наступних морозних ночей.	true
building_short_description_texts_short_description_att_bld_eastmig_industry_unit_cost_2	Важлива тканина в боротьбі з невблаганною спекою пустелі.	true
building_short_description_texts_short_description_att_bld_eastmig_industry_unit_cost_4	Пісок, і потоп, корисно не допускати до свого житла.	true
building_short_description_texts_short_description_att_bld_all_resources_silk_4	Якщо Ви не можете отримати його тут, це не варто мати.	true
building_short_description_texts_short_description_att_bld_all_resources_silk_2	Кров життя націй тече Шовковим шляхом.	true
building_short_description_texts_short_description_att_bld_all_resources_silk_3	Тут можна купити вишукані товари з усього світу.	true
building_short_description_texts_short_description_att_bld_all_resources_silk_1	Дорога довга, з багатьма звивистими поворотами. Але веде до Риму.	true
building_short_description_texts_short_description_att_bld_all_resources_salt_4	Сіль, цінний консервант, можна обміняти майже на все.	true
building_short_description_texts_short_description_att_bld_all_resources_salt_2	Мало солі корисно, багато вигідно.	true
building_short_description_texts_short_description_att_bld_all_resources_salt_3	Заготівля солі у великих масштабах є прибутковою справою.	true
building_short_description_texts_short_description_att_bld_all_resources_salt_1	Сіль, яку цінують у всьому світі, є цінним ресурсом.	true
building_short_description_texts_short_description_att_bld_barbarian_industry_carpenter_4	Великі машини війни, створені з міцних дубів.	true
building_short_description_texts_short_description_att_bld_eos_marib_dam	Монументальне свідчення винахідливості наших пращурів. З деякими невеликими недоліками…	true
building_short_description_texts_short_description_att_bld_barbarian_industry_carpenter_2	Дерева живуть для тих, хто знає їхні таємниці.	true
building_short_description_texts_short_description_att_bld_barbarian_industry_carpenter_3	Майстерність теслі перекривати дахи над головами.	true
building_short_description_texts_short_description_att_bld_barbarian_port_fish_2	Людина ловила рибу в річках і океанах поколіннями.	true
building_short_description_texts_short_description_att_bld_barbarian_port_fish_3	Риби, як і люди, схильні ловити залишену їм наживку.	true
building_short_description_texts_short_description_att_bld_barbarian_port_fish_4	Щедрість океанів може бути дуже прибутковою.	true
building_short_description_texts_short_description_att_bld_eastmig_leadership_nobles_2	Якщо ми об’єднані, жодна людина не може встояти проти нашої волі.	true
building_short_description_texts_short_description_att_bld_eastmig_leadership_nobles_3	Завзяття і запал творять дива, але нічого не відбувається без плану.	true
building_short_description_texts_short_description_att_bld_eastmig_leadership_nobles_4	Війна має бути спланована, підготовлена ​​та керована, якщо вона хоче бути успішною.	true
building_short_description_texts_short_description_att_bld_nomad_community_wine_2	Вино коштує дорого, якщо спочатку не випити все...	true
building_short_description_texts_short_description_att_bld_nomad_community_wine_3	Цілі вози, навантажені вином. Уявіть собі…	true
building_short_description_texts_short_description_att_bld_nomad_community_wine_4	У багатьох відношеннях одноплемінник з вином є найвпливовішою людиною з усіх.	true
building_short_description_texts_short_description_att_bld_religion_grecoroman_minor_4	Вищі боги спостерігають за світом людини.	true
building_short_description_texts_short_description_att_bld_religion_grecoroman_minor_2	Зображений у камені божий образ проявляє благочестя.	true
building_short_description_texts_short_description_att_bld_religion_grecoroman_minor_3	Славна перемога богів, що височіє до неба.	true
building_short_description_texts_short_description_att_bld_religion_grecoroman_minor_1	Подивіться на статую і побачите, як боги стали реальністю.	true
building_short_description_texts_short_description_att_bld_religion_arian_major_church_3	Споруда для духу, наповнена душами. Нашими душами.	true
building_short_description_texts_short_description_att_bld_religion_arian_major_church_2	Центр релігії, дім для віруючих.	true
building_short_description_texts_short_description_att_bld_religion_arian_major_church_4	Яскрава данина найвищої слави Богу.	true
building_short_description_texts_short_description_bel_bld_camp_workshop_siege_4	Вишукані луки та складні твори смерті — це його мистецтво.	true
building_short_description_texts_short_description_bel_bld_camp_workshop_siege_3	Той лук із ЦИМИ стрілами? О боже...	true
building_short_description_texts_short_description_bel_bld_camp_workshop_siege_2	Навіть далеко від дому ця людина вміє обробляти дерево.	true
building_short_description_texts_short_description_att_bld_all_livestock_camels_3	Витривалі тварини пустелі, вирощені для суворих умов пустелі.	true
building_short_description_texts_short_description_att_bld_all_livestock_camels_2	Обережно, вони плюються. Сказав же тобі…	true
building_short_description_texts_short_description_att_bld_all_livestock_camels_4	Небагато тварин так ідеально підходять для життя в пустелі, як верблюд.	true
building_short_description_texts_short_description_att_bld_religion_grecoroman_major_4_cult	Слава Імператору, божому і непереможному!	true
building_short_description_texts_short_description_cha_bld_cloth_market_2	Одягти людей так само важливо, як і озброїти їх.	true
building_short_description_texts_short_description_cha_bld_cloth_market_3	Одяг потрібен кожному. Мудра людина знає як цим скористатися.	true
building_short_description_texts_short_description_cha_bld_cloth_market_1	Нитки та прядиво - створюють тканину як для одягу, так і для житла.	true
building_short_description_texts_short_description_att_bld_barbarian_industry_1	Художнє око і корисно, і прибутково.	true
building_short_description_texts_short_description_att_bld_eastmig_community_1	Всесвітні війни мають десь починатися.	true
building_short_description_texts_short_description_att_bld_eastmig_leadership_1	Звідси лідер дивиться та командує.	true
building_short_description_texts_short_description_bel_bld_camp_officers_tents_4	Тут зосереджена абсолютна військова влада.	true
building_short_description_texts_short_description_bel_bld_camp_officers_tents_3	Звідси його битви плануються, керуються та виконуються.	true
building_short_description_texts_short_description_bel_bld_camp_officers_tents_2	Ватажок повинен завжди знати правильний напрямок дій.	true
building_short_description_texts_short_description_att_bld_religion_grecoroman_major_4_serapis	Хваліть Серапіса, і Ви не потребуватимете ні в чому - ні в цьому житті, ні за його межами.	true
building_short_description_texts_short_description_att_bld_all_industry_minor_quarry_3	Великі будівлі висічені з великого каміння.	true
building_short_description_texts_short_description_att_bld_all_industry_minor_quarry_2	Створений землею, посічений людиною.	true
building_short_description_texts_short_description_att_bld_all_industry_minor_quarry_4	Коли працівники живуть там де працюють, їх продуктивність підвищується.	true
building_short_description_texts_short_description_att_bld_all_resources_olives_1	У тіні оливкових дерев можна багато чого передумати.	true
building_short_description_texts_short_description_att_bld_all_resources_olives_2	Одне оливкове дерево добре, багато краще.	true
building_short_description_texts_short_description_att_bld_all_resources_olives_3	Скромна олива розкриває свою цінність, коли її розчавлять під каменем.	true
building_short_description_texts_short_description_att_bld_all_resources_olives_4	Плоди оливкового дерева створюють чудовий бізнес.	true
building_short_description_texts_short_description_cha_bld_race_track_2	За допомогою якого передається влада і сила панівної родини.	true
building_short_description_texts_short_description_cha_bld_race_track_1	Кінь може бути бажаним дзеркалом найкращого в людській природі.	true
building_short_description_texts_short_description_att_bld_eastmig_leadership_elders_3	Ми вижили так довго і так добре, тому що ми витримали разом.	true
building_short_description_texts_short_description_att_bld_eastmig_leadership_elders_2	Керівні руки, голоси розуму, що пропонують впевненість і логіку.	true
building_short_description_texts_short_description_att_bld_eastmig_leadership_elders_4	Нерозумний той, хто нехтує порадою старших.	true
building_short_description_texts_short_description_att_slav_wonder_civic_2_short	Нехай вогонь Сварога зміцнює Вашу душу цілеспрямованістю.	true
building_short_description_texts_short_description_att_slav_wonder_civic_3_short	Нехай вогонь Сварога зміцнює Вашу душу цілеспрямованістю.	true
building_short_description_texts_short_description_att_bld_nomad_herders_cattle_4	Чи можу я Вас зацікавити молоком?	true
building_short_description_texts_short_description_att_bld_nomad_herders_cattle_3	У цієї корови безтурботна краса, Вам  так не здається?	true
building_short_description_texts_short_description_att_bld_nomad_herders_cattle_2	Правильно доглянута корова забезпечить сім’ю на довгі роки.	true
building_short_description_texts_short_description_bel_bld_camp_market_2	Добре укомплектований табір – це своє господарство.	true
building_short_description_texts_short_description_bel_bld_camp_market_3	Найкращий товар, тільки для тебе, друже!	true
building_short_description_texts_short_description_bel_bld_camp_market_1	Прийди, побачиш! Найкращі товари в таборі!	true
building_short_description_texts_short_description_bel_bld_camp_market_4	Якщо Ви не можете купити його на 5-й вулиці, він Вам не потрібен.	true
building_short_description_texts_short_description_att_bld_religion_grecoroman_major_4_isis	Вселенська мати чує твоє поклоніння.	true
building_short_description_texts_short_description_att_bld_all_livestock_pigs_2	Догляд за тваринами допомагає зробити їх смачними.	true
building_short_description_texts_short_description_att_bld_all_livestock_pigs_3	Свині насправді дуже чисті тварини.	true
building_short_description_texts_short_description_att_bld_all_livestock_pigs_4	Будьте обережні з чоловіком, який тримає свиноферму...	true
building_short_description_texts_short_description_att_bld_barbarian_civic_market_amber_3	«Бачите, як муха завмерла всередині? Її вбив сам Ахілл..."	true
building_short_description_texts_short_description_att_bld_barbarian_civic_market_amber_4	Коли камінець коштує більше, ніж життя людини, Ви знаєте, що Ви на правильному шляху.	true
building_short_description_texts_short_description_att_bld_barbarian_civic_market_amber_5	Якщо Вам потрібні речі, швидше за все, Ви їх знайдете тут.	true
