key	text	tooltip
#Loc;1;text/db/campaign_localised_strings.loc		
campaign_localised_strings_string_unit_exchange_commanders_invalid	Війська не можуть обмінюватися командувачами.	true
campaign_localised_strings_string_public_order_rebellion_next_turn	За поточного стану справ наступного ходу буде повстання!	true
campaign_localised_strings_string_cha_faction_wales	Вельс	true
campaign_localised_strings_string_military_force_morale_bonus_value_politics	Політика	true
campaign_localised_strings_string_force_not_in_correct_stance_not_enough_ap	Це військо зараз не в позиції осілості та не має достатньо очок дій для оселення.	true
campaign_localised_strings_string_military_force_growth_tax	Податок	true
campaign_localised_strings_string_politics_character_cannot_become_governor_wounded	Цього персонажа не можна призначити губернатором, якщо він поранений.	true
campaign_localised_strings_string_events_attrition_summary_location	Провінція:	true
campaign_localised_strings_string_MPC_cannot_construct_not_your_turn	[[col:red]]Ви не можете будувати будівлі під час ходу інших держав.[[/col]]	true
campaign_localised_strings_string_politics_character_regent	Регент	true
campaign_localised_strings_string_end_turn_warning_public_order_low	У цій провінції небезпечно низький громадський порядок:	true
campaign_localised_strings_string_province_fertility_factor_buildings	Держави або будівлі	true
campaign_localised_strings_string_military_history_battles_victory_decisive	Вирішальна перемога проти:	true
campaign_localised_strings_string_politics_assign_governor	Клацніть ЛКМ, щоб призначити персонажа на цю посаду.	true
campaign_localised_strings_string_cha_mission_pope_attacked_1	Повернути Папу до Риму. (Персонаж в якого в оточенні знаходиться Папа має повернутися до регіону Рим.)	true
campaign_localised_strings_string_recruit_assassin_tooltip	Завербувати вбивцю||Навчені мистецтву вбивства, наймані вбивці можуть усунути ворожих полководців та агентів. Їхні вміння також можна застосувати для навчання загонів і переслідування ворожих військ.	true
campaign_localised_strings_string_details_panel_skills_cannot_select	Цей персонаж не може навчитися цьому вмінню:	true
campaign_localised_strings_string_raise_navy_capped	Неможливо  зібрати фльоту.||У Вас недостатньо імперіума.	true
campaign_localised_strings_string_raise_legacy_capped	Неможливо відновити спадщину.||У Вас недостатній імперіум.	true
campaign_localised_strings_string_end_turn_warning_not_researching	Зараз Ви не досліджуєте жодних технологій.	true
campaign_localised_strings_string_military_force_growth_technologies	Технології	true
campaign_localised_strings_string_development_points_tooltip_hordes_insufficent_development_points_number_expedition	Вам потрібен %n надлишок населення.||Експедиція з часом зростатиме, але поєднання рейдів і заселення разом із будівництвом відповідних будівель допоможе збільшити темп зростання.	true
campaign_localised_strings_string_province_fertility_factor_climate	Клімат	true
campaign_localised_strings_string_development_points_tooltip_hordes_growth	По мірі зростання орди її населення можна використовувати, щоб посилити її або створити нові орди.	true
campaign_localised_strings_string_imperium_01_description	Ваша сила має мале значення для світу... поки що!	true
campaign_localised_strings_string_military_force_morale_bonus_value_foreign_territory	Ворожа територія	true
campaign_localised_strings_string_imperium_02_description	Ви зарекомендували себе як гідна сила.	true
campaign_localised_strings_string_character_type_wife	Дружина	true
campaign_localised_strings_string_imperium_03_description	Чутки про Ваші досягнення розлетілися світом.	true
campaign_localised_strings_string_imperium_04_description	Ваші досягнення величезні.	true
campaign_localised_strings_string_imperium_05_description	Вашої влади водночас бояться й жадають.	true
campaign_localised_strings_string_imperium_06_description	Світ тремтить перед тобою.	true
campaign_localised_strings_string_imperium_07_description	Твоя сила найвища.	true
campaign_localised_strings_string_public_order_food_tooltip	Їжа	true
campaign_localised_strings_string_military_history_battles	Всі битви:	true
campaign_localised_strings_string_building_restriction_bel_bld_all_resources_olives_4	Щоб розблокувати цю будівлю, Ви повинні контролювати всі 4 регіони, що містять оливки, і побудувати будівлю з вирощування оливок в кожному з них.	true
campaign_localised_strings_string_politics_power_support_popular_description	Панування – це мірило Вашого впливу на Вашу державу - Ваша влада над народом. Воно визначається загальним впливом членів Вашої сім’ї порівняно з тими, хто не є членами сім’ї.\\n\\nУ поєднанні з контролем воно визначає загальну владу Вашої родини.	true
campaign_localised_strings_string_politics_cannot_assign_age	Цей персонаж не досяг повноліття і ще не може стати губернатором.	true
campaign_localised_strings_string_military_force_morale_unit_transfer	Передача загонів	true
campaign_localised_strings_string_recruitment_hire_from_horde	Завербувати із орди	true
campaign_localised_strings_string_public_order_taxes_tooltip	Високі податки не радують людей. Низькі податки роблять їх щасливими.	true
campaign_localised_strings_string_public_order_other_tooltip	Ваша реакція на дилеми та події впливає на те, як люди бачать Ваше лідерство.	true
campaign_localised_strings_string_province_contested	Спірна провінція.	true
campaign_localised_strings_string_politics_ministerial_position_required_rank	Необхідний ранг:	true
campaign_localised_strings_string_details_panel_skills_cannot_no_skill_points	У них немає очок вмінь.	true
campaign_localised_strings_string_unit_upgrade_multiple_units	Клацніть ЛКМ, щоб покращити всі вибрані загони.	true
campaign_localised_strings_string_raise_force_reinstate_cannot_no_legacies	[[col:red]]У Вас немає військової спадщини для відновлення.[[/col]]	true
campaign_localised_strings_string_politics_power_support_political_current	Поточний контроль:	true
campaign_localised_strings_string_att_eos_religious_mission_build_att_rel_semitic_paganism	Перетворіть або побудуйте 4 семітські язичницькі релігійні споруди, не будуючи жодних інших релігійних споруд.	true
campaign_localised_strings_string_public_order_other	Інше	true
campaign_localised_strings_string_public_order_taxes	Податки	true
campaign_localised_strings_string_politics_action_impossible_target_retainer_rank_too_high	[[col:red]]Персонажі можуть мати справу лише з васалами нижчого рангу, ніж вони самі.[[/col]]	true
campaign_localised_strings_string_cha_faction_saxon_kingdom	Королівство Саксонія	true
campaign_localised_strings_string_unit_details_rank	Ранг:	true
campaign_localised_strings_string_military_history_battles_defeat_decisive	Важка поразка від:	true
campaign_localised_strings_string_raise_force_navy_no_surplus	Неможливо  зібрати фльоту.||У Вас недостатньо надлишку населення.	true
campaign_localised_strings_string_zeal_desc	Захист від дій агента на зниження завзяття.	true
campaign_localised_strings_string_military_force_morale_faction_leader_died	Буйність	true
campaign_localised_strings_string_raise_army_besieged	Неможливо зібрати військо.||Це поселення в облозі.	true
campaign_localised_strings_string_public_order_food	Їжа	true
campaign_localised_strings_string_politics_action_impossible_target_underage	[[col:red]]Персонажі, які ще не досягли повноліття, не можуть брати участь у політичних діях.[[/col]]	true
campaign_localised_strings_string_cannot_migrate_no_armies	Ваші люди не можуть переселятися без армії.	true
campaign_localised_strings_string_politics_character_status_scheming	Плете інтригу	true
campaign_localised_strings_string_politics_character_status_deceased	Покійн.	true
campaign_localised_strings_string_events_attrition_summary_men_lost	Втрачено людей:	true
campaign_localised_strings_string_military_force_growth_core	Будівлі та їжа	true
campaign_localised_strings_string_public_order_deteriorating	Громадський порядок погіршується.	true
campaign_localised_strings_string_unit_upgrade_single_unit	Клацніть ЛКМ, щоб покращити вибраний загін за допомогою:	true
campaign_localised_strings_string_character_mentor_of	Цей персонаж є наставником:	true
campaign_localised_strings_string_politics_action_impossible_target_candidate	[[col:red]]Ви не можете вживати політичних заходів проти кандидатів.[[/col]]	true
campaign_localised_strings_string_building_restriction_bel_bld_all_resources_marble_4	Щоб розблокувати цю будівлю, Ви повинні контролювати всі 4 регіони, що містять мармур, і побудувати будівлю видобутку мармуру в кожному з них.	true
campaign_localised_strings_string_details_panel_ancillary_wife_empty	У цього героя немає дружини. Ваші персонажі можуть отримувати пропозиції одружитися від інших партій, або Ви можете організувати шлюби для персонажів з інших партій, беручи участь у політиці держав.	true
campaign_localised_strings_string_politics_character_status_wounded	Поранений	true
campaign_localised_strings_string_public_order_breakdown_rebellion	Заколотники вийшли	true
campaign_localised_strings_string_military_history_battles_victory_phyrric	Піррова перемога над:	true
campaign_localised_strings_string_military_force_morale_lost_battle	Поразка у битві	true
campaign_localised_strings_string_politics_event_assassination_wife_success	Його дружину успішно вбили!	true
campaign_localised_strings_string_religion_factor_province	Місцеві звичаї	true
campaign_localised_strings_string_end_turn_warning_siege_no_equipment	Ви берете в облогу поселення без обсадних машин:	true
campaign_localised_strings_string_other_nobles_candidates_description	Кандидати — це персонажі, які ще не є активними членами держави.||За відсутності інших доступних персонажів кандидати можуть бути покликані взяти на себе командування військами або стати губернаторами.\\n\\n[[col:yellow]]Їхній вплив не впливає на політику держави, і їх вірність зміниться лише після того, як вони стануть активними.[[/col]]	true
campaign_localised_strings_string_details_panel_skills_select	Цей персонаж може отримати додаткове вміння.\\nНатисніть на вміння лівою кнопкою миші, щоб вивчити його.	true
campaign_localised_strings_string_politics_character_not_politician	[[col:red]]Лише державні діячі можуть стати губернаторами.[[/col]]	true
campaign_localised_strings_string_info_panel_effect_summary_general	Вплив командувача	true
campaign_localised_strings_string_recruitment_unavailable_incorrect_stance	Не можна вербувати в цій позиції.	true
campaign_localised_strings_string_public_order_breakdown_rebellion_tooltip	Повстання	true
campaign_localised_strings_string_politics_action_possible	[[col:green]]Цю політичну дію буде вирішено на початку наступного ходу.[[/col]]	true
campaign_localised_strings_string_politics_event_assassination_wife	Замах на дружину!	true
campaign_localised_strings_string_unit_upgrade_description	Покращує зброю або броню загону.	true
campaign_localised_strings_string_end_turn_warning_legacy_skill_to_be_picked	Це військо має неприсвоєні звичаї:	true
campaign_localised_strings_string_growth_characters	Персонажі	true
campaign_localised_strings_string_raise_army_capped	Неможливо зібрати військо.||У Вас недостатньо імперіума.	true
campaign_localised_strings_string_politics_character_joined_your_family_from	Цей персонаж приєднався до Вашої родини з такої держави:	true
campaign_localised_strings_string_cha_mission_avars_1	Спустошити 5 поселень.	true
campaign_localised_strings_string_details_panel_character_age	Вік:	true
campaign_localised_strings_string_politics_action_impossible	Ця політична дія не може бути проведена:	true
campaign_localised_strings_string_recruitment_hire_mercenary	Найняти найманців	true
campaign_localised_strings_string_unit_upgrade_retrain_multiple_units	Клацніть ЛКМ, щоб перенавчати всі вибрані загони.	true
campaign_localised_strings_string_unit_upgrade_retrain_description	Замінює загін на більш вдосконалений.	true
campaign_localised_strings_string_cannot_migrate_under_siege	Ваші люди не можуть переселитися, поки одне з Ваших поселень перебуває в облозі або заблоковано.	true
campaign_localised_strings_string_abandoned_region_rebel_faction_name	Безлюдно	true
campaign_localised_strings_string_sea_region_control_status_replenishment_rate_mod_garrisoned	(+%d%% у портах)	true
campaign_localised_strings_string_military_history_defeats	Поразка:	true
campaign_localised_strings_string_unit_upgrade_retrain_single_unit	Клацніть ЛКМ, щоб перенавчити вибраний загін:	true
campaign_localised_strings_string_cha_faction_avar_khaganate	Аварський каганат	true
campaign_localised_strings_string_sanitation_tooltip_header	Санітарія і забруднення	true
campaign_localised_strings_string_force_not_on_land	Орди повинні бути на суходолі, щоб будувати. Зійдіть на берег, щоб наказати будувати.	true
campaign_localised_strings_string_public_order_units	Загони	true
campaign_localised_strings_string_military_force_morale_idle	Відпочинок	true
campaign_localised_strings_string_sea_region_control_status_replenishment_rate_mod	+%d%% поповнення фльоти	true
campaign_localised_strings_string_battle_ambush_you_success	Ворогові не вдалося помітити Вашу засідку. Атакуйте зараз, і елемент несподіванки дасть Вам перевагу!	true
campaign_localised_strings_string_raise_force_army_no_surplus	Неможливо зібрати військо.||У Вас недостатньо надлишку населення.	true
campaign_localised_strings_string_politics_has_not_attained_office	Цей персонаж раніше не займав достатньо високої посади, щоб отримати цю посаду.	true
campaign_localised_strings_string_military_force_morale_bonus_value_military_force	Військова сила	true
campaign_localised_strings_string_politics_event_assassination_wife_wounded	Його дружина була лише поранена.	true
campaign_localised_strings_string_details_panel_skills_unlocked_rank	Буде розблоковано в ранзі:	true
campaign_localised_strings_string_military_force_morale_casualties	Постраждали	true
campaign_localised_strings_string_military_history_commanders	Командувачі:	true
campaign_localised_strings_string_events_attrition_summary_force_navy	Фльота:	true
campaign_localised_strings_string_military_force_growth_characters	Персонажі	true
campaign_localised_strings_string_public_order_celebration_next_turn	За поточного стану справ наступного ходу буде святкування!	true
campaign_localised_strings_string_religion_factor_buildings	Регіональний розвиток	true
campaign_localised_strings_string_military_history_victories	Перемоги:	true
campaign_localised_strings_string_raise_navy_no_port	Неможливо  зібрати фльоту.||Це поселення не має порту.	true
campaign_localised_strings_string_politics_cursus_next_level	Наступний рівень	true
campaign_localised_strings_string_tooltip_loyalty_description	Вірність символізує відданість персонажа державі. Якщо вірність досягне нуля, персонаж втече, тим самим спровокувавши громадянську війну.	true
campaign_localised_strings_string_politics_event_blackmail_success	Його репутація була заплямована чутками.	true
campaign_localised_strings_string_cha_faction_english_kingdom	Королівство Англія	true
campaign_localised_strings_string_public_order_technologys	Технології	true
campaign_localised_strings_string_recruitment_levy_from_client_state	Новобранці із держави-данника	true
campaign_localised_strings_string_migrate_button_selected_expedition	Усі поселення у Вашому королівстві залишені. [Натисніть ЛКМ, щоб скасувати.]	true
campaign_localised_strings_string_building_restriction_bel_bld_all_resources_lead_4	Щоб розблокувати цю будівлю, Ви повинні контролювати всі 3 регіони, що містять свинець, і побудувати будівлю видобутку свинцю в кожному з них.	true
campaign_localised_strings_string_raise_army_no_funds	Неможливо зібрати військо.||У Вас недостатньо коштів.	true
campaign_localised_strings_string_cannot_migrate_already_migrating_expedition	Ви вже в процесі переселення.	true
campaign_localised_strings_string_raise_navy_no_funds	Неможливо  зібрати фльоту.||У Вас недостатньо коштів.	true
campaign_localised_strings_string_politics_event_blackmail	Спроба шантажу!	true
campaign_localised_strings_string_politics_event_choice_invalid_insufficient_gravitas	Цей персонаж не має достатнього впливу, щоб вжити таких дій.	true
campaign_localised_strings_string_public_order_technologys_tooltip	Освічене, просунуте населення – щасливе.	true
campaign_localised_strings_string_development_points_tooltip_hordes	Надлишок населення||Орді потрібні люди, якщо вона хоче стати більшою та сильнішою. Надлишок населення дозволяє це, а також дозволяє створювати нові орди. Розташування табору та набіги життєво важливі для зростання орди.	true
campaign_localised_strings_string_military_force_morale_bonus_value_fortify_stance	Укріплення	true
campaign_localised_strings_string_cha_faction_ireland	Ірландці	true
campaign_localised_strings_string_politics_action_impossible_actor_not_male	[[col:red]]Цю дію можуть виконувати лише члени родини чоловічої статі.[[/col]]	true
campaign_localised_strings_string_public_order_stabilising	Громадський порядок стабілізується.	true
campaign_localised_strings_string_migrate_button_active_expedition	Переселення спричиняє залишенню всіх поселень у Вашому королівстві та перетворює Ваші армії на орди.	true
campaign_localised_strings_string_edicts_incoming_description	[[col:green]]Цей едикт набуде чинності на початку наступного ходу.[[/col]]	true
campaign_localised_strings_string_building_restriction_bel_bld_all_resources_iron_4	Щоб розблокувати цю будівлю, Ви повинні контролювати всі 5 регіонів, що містять залізо, і побудувати будівлю видобутку заліза в кожному з них.	true
campaign_localised_strings_string_politics_character_not_your_faction	Ви не можете діяти проти персонажів не з Вашої родини.	true
campaign_localised_strings_string_force_not_in_correct_stance	Орди повинні стояти табором, щоб здійснити будівництво. Видання цього наказу призведе до того, що орда стане табором.	true
campaign_localised_strings_string_raise_army	Зберіть військо.||Створіть нове військо та призначте полководця, щоб вести її в бій.	true
campaign_localised_strings_string_politics_action_impossible_actor_married	[[col:red]]Цей персонаж уже одружений.[[/col]]	true
campaign_localised_strings_string_confirm_cancel_migration	Ви впевнені, що бажаєте скасувати переселення?	true
campaign_localised_strings_string_politics_action_make_heir_heading	[[col:yellow]]Оголосити спадкоємця[[/col]]	true
campaign_localised_strings_string_public_order_celebration	За поточного стану справ святкування відбудеться за %n хід(ів).	true
campaign_localised_strings_string_public_order_devastation_tooltip	Руйнування породжує смерть і, що ще небезпечніше, нещастя.	true
campaign_localised_strings_string_public_order_plague	Хвороба	true
campaign_localised_strings_string_building_restriction_bel_bld_all_resources_gems_4	Щоб розблокувати цю будівлю, Ви повинні контролювати всі 3 регіони, що містять коштовне каміння, і побудувати будівлю обробки коштовного каміння в кожному з них.	true
campaign_localised_strings_string_building_restriction_bel_bld_all_resources_gold_4	Щоб розблокувати цю будівлю, Ви повинні контролювати обидва регіони, що містять золото, і побудувати будівлю видобутку золота в кожному з них.	true
campaign_localised_strings_string_unit_upgrade_header	Вдосконалення	true
campaign_localised_strings_string_politics_action_impossible_actor_already_a_retainer	[[col:red]]Цей персонаж уже є наймитом.[[/col]]	true
campaign_localised_strings_string_politics_event_assassination_wife_killed	Їм не вдалося вбити його, але натомість вдалося вбити його дружину!	true
campaign_localised_strings_string_public_order_culture_differences	Релігійні відмінності	true
campaign_localised_strings_string_building_restriction_bel_bld_all_resources_furs_4	Щоб розблокувати цю будівлю, Ви повинні контролювати всі 4 регіони, що містять хутро, і побудувати будівлю заготівлі хутра в кожному з них.	true
campaign_localised_strings_string_unit_upgrade_cannot	Вдосконалення неможливе:	true
campaign_localised_strings_string_imperium_01_title	Незначний	true
campaign_localised_strings_string_imperium_02_title	Помітний	true
campaign_localised_strings_string_imperium_03_title	Вражаючий	true
campaign_localised_strings_string_imperium_04_title	Надихаючий	true
campaign_localised_strings_string_imperium_05_title	Загрозливий	true
campaign_localised_strings_string_imperium_06_title	Жахливий	true
campaign_localised_strings_string_imperium_07_title	Верховний	true
campaign_localised_strings_string_politics_event_promotion_success	Отримана нова посада.	true
campaign_localised_strings_string_growth_food	Їжа	true
campaign_localised_strings_string_building_restriction_att_bld_eos_military_infantry_5_east_church	Собор Макатас буде розблоковано, коли будуть виконані такі умови:\\n[[col:yellow]]• Віруючі Вашої держава принаймні на 75% складатимуться зі східних християн.[[/col]]	true
campaign_localised_strings_string_army_morale_tooltip	Єдність||Якщо буде дуже низькою, то Ваші вояки дезертують та оголосять себе сепаратистами і почнуть громадянську війну!	true
campaign_localised_strings_string_cha_faction_italian_kingdom	Королівство Італія	true
campaign_localised_strings_string_end_turn_warning_bankrupt	Ви на межі банкрутства.	true
campaign_localised_strings_string_gdp_other	Інше	true
campaign_localised_strings_string_unit_upgrade_cannot_reason_damaged_multiple	Один або кілька загонів не повноцінні.	true
campaign_localised_strings_string_politics_event_promotion	Просування на посаді!	true
campaign_localised_strings_string_gdp_entertainment	Культура	true
campaign_localised_strings_string_building_restriction_att_bld_eastmig_military_infantry_4	Парад Перемоги буде розблоковано, коли будуть виконані наступні умови:\\n[[col:yellow]]• Виконайте місію «Зустріч з Мавією – Залякування»[[/col]]	true
campaign_localised_strings_string_building_restriction_att_bld_eastmig_military_infantry_5	Імперський збір буде розблоковано, коли будуть виконані такі умови:\\n[[col:yellow]]• Виконайте місію «Зустріч з Мавією - звільнення»[[/col]]	true
campaign_localised_strings_string_sanitation_tooltip_description_good	\\nМісцева санітарія переважає забруднення. Це поселення не має ризику спалаху хвороби.\\n	true
campaign_localised_strings_string_battle_ambush_you_intercept	Ваша армія була помічена ворогом, перш ніж вона встигла влаштувати засідку. У Вас є можливість перехопити їх і вступити в бій!	true
campaign_localised_strings_string_cha_faction_saxon_kingdom_objective	Володійте провінціями Ангрія, Вільці, Остфалія, Ободрітія і Саксонія.	true
campaign_localised_strings_string_public_order_devastation	Руйнування	true
campaign_localised_strings_string_end_turn_warning_military_force_morale_low	Це військо має небезпечно низьку єдність:	true
campaign_localised_strings_string_recruitment_unavailable_blockading	Не можна вербувати під час блокування.	true
campaign_localised_strings_string_gdp_fertility_agriculture	Сільське господарство [Родючість]	true
campaign_localised_strings_string_public_order_plague_tooltip	Чума	true
campaign_localised_strings_string_public_order_culture_differences_tooltip	Плавильний котел культур може зв’язувати людей разом або створювати тертя.	true
campaign_localised_strings_string_cha_faction_viking_kingdom	Королівство вікінгів	true
campaign_localised_strings_string_edicts_description	Видайте провінційні едикти, щоб допомогти контролювати місцевий громадський порядок, використовувати виробництво тощо.\\n\\nРозширення та розвиток збільшить імперію Вашої держави, що дозволить Вам призначати додаткових губернаторів і видавати нові едикти.	true
campaign_localised_strings_string_growth_technologies	Технології	true
campaign_localised_strings_string_military_force_morale_bonus_value_foreign_waters	Ворожі води	true
campaign_localised_strings_string_public_order_region	Регій	true
campaign_localised_strings_string_public_order_family_power_tooltip	Політичне становище Вашої родини впливає на те, як люди ставляться до Вас.	true
campaign_localised_strings_string_raise_legacy_no_candidate	Неможливо відновити спадщину.||Немає відповідних кандидатів.	true
campaign_localised_strings_string_sanitation_tooltip_description_bad	\\nМісцеве забруднення переважає санітарію. Якщо не вплинути, це поселення стане під загрозою спалаху хвороб.\\n	true
campaign_localised_strings_string_edicts_outgoing_description	[[col:red]]Цей едикт втратить чинність на початку наступного ходу.[[/col]]	true
campaign_localised_strings_string_military_force_morale_bonus_value_horde_in_fighting	Суперництво	true
campaign_localised_strings_string_cannot_migrate_already_migrating	Ви вже в процесі переселення.	true
campaign_localised_strings_string_character_type_son	Син	true
campaign_localised_strings_string_edicts_disabled_province_incomplete	[[col:red]]Ви не можете видавати едикти в провінціях, які не мають губернатора.[[/col]]	true
campaign_localised_strings_string_public_order_stable	Громадський порядок стабільний.	true
campaign_localised_strings_string_sanitation_tooltip_total_sanitation	Загальна санітарія:	true
campaign_localised_strings_string_growth_buildings	Споруди	true
campaign_localised_strings_string_events_attrition_summary_location_region	Регіон:	true
campaign_localised_strings_string_public_order_revolt	За поточного стану справ раби повстануть за %n ходів.	true
campaign_localised_strings_string_military_force_morale_bonus_value_offices	Посади	true
campaign_localised_strings_string_military_force_morale_bankruptcy	Банкрутство	true
campaign_localised_strings_string_gdp_poor_fertility_bonus	Мізерний бонус за родючість	true
campaign_localised_strings_string_unit_upgrade_cannot_reason_incorrect_stance	Армія займає не правильну позицію.	true
campaign_localised_strings_string_gdp_farming	Сільське господарство	true
campaign_localised_strings_string_politics_ministerial_position_expected_effects_no_selection	Виберіть персонажа, щоб призначити на посаду.\\n\\nЦя посада надає такі ефекти:	true
campaign_localised_strings_string_battle_ambush_they_success	Вашій армії не вдалося помітити ворожу засідку. Вони розпочали раптову атаку, безперечно це їм дає перевагу!	true
campaign_localised_strings_string_military_force_morale_bonus_value_garrison_stance	Як залога	true
campaign_localised_strings_string_att_eos_religious_mission_build_att_rel_church_east	Перебудуйте або побудуйте 4 східнохристиянські релігійні споруди, не будуючи жодних інших релігійних споруд.	true
campaign_localised_strings_string_att_eos_tanukhid_mission_1	Знищити 5 регіонів, контрольованих римлянами.	true
campaign_localised_strings_string_att_eos_tanukhid_mission_3	Оселіть свій народ.	true
campaign_localised_strings_string_att_eos_tanukhid_mission_2	Звільніть 3 держави.	true
campaign_localised_strings_string_bel_expedition_western_rome	Римське королівство	true
campaign_localised_strings_string_politics_ministerial_position_required_age	Необхідний вік:	true
campaign_localised_strings_string_character_retainer_of_full	Цей персонаж є наймитом:	true
campaign_localised_strings_string_sanitation_tooltip_current_squalor	Нинішнє забруднення:	true
campaign_localised_strings_string_building_restriction_att_bld_eos_military_infantry_5_zoroastrian	Палац Амеша Спента (Безсмертних Святих) буде розблоковано, коли будуть виконані наступні умови:\\n[[col:yellow]]• Ваша держава складатиметься принаймні на 75% із зороастрійців.[[/col]]	true
campaign_localised_strings_string_next_office	Наступна посада:	true
campaign_localised_strings_string_politics_ministerial_position_term	Термін перебування на посаді:	true
campaign_localised_strings_string_unit_upgrade_retrain_cannot_reason_none_multiple	У цій провінції немає подальшого навчання для цих загонів.	true
campaign_localised_strings_string_province_fertility_factor_events	Події	true
campaign_localised_strings_string_public_order_family_power	Політична ситуація	true
campaign_localised_strings_string_military_history_foundation_founder	Засновник:	true
campaign_localised_strings_string_public_order_uncertainty_tooltip	Невизначеність	true
campaign_localised_strings_string_politics_action_impossible_cannot_secure_loyalty	Ви не можете забезпечити вірність цього персонажа.	true
campaign_localised_strings_string_building_restriction_bel_bld_all_resources_wood_4	Щоб розблокувати цю будівлю, Ви повинні контролювати всі 3 регіони, що містять деревину, і побудувати будівлю заготівлі деревини в кожному з них.	true
campaign_localised_strings_string_politics_event_type	Інтрига:	true
campaign_localised_strings_string_military_force_morale_bonus_value_faction	Держава	true
campaign_localised_strings_string_gdp_mining	!NOT USED!	true
campaign_localised_strings_string_unit_upgrade_cannot_reason_damaged_single	Загін неповноцінний.	true
campaign_localised_strings_string_military_force_morale_bonus_value_buildings	Споруди	true
campaign_localised_strings_string_province_fertility_factor_season	Пора року	true
campaign_localised_strings_string_province_fertility_factor_razing	Руйнування	true
campaign_localised_strings_string_public_order_events_tooltip	Останні події сформували громадську думку.	true
campaign_localised_strings_string_military_force_morale_bonus_value_civil_war	Громадянська війна	true
campaign_localised_strings_string_unit_upgrade_retrain_cannot	Перенавчання неможливе:	true
campaign_localised_strings_string_unit_upgrade_cannot_reason_none_multiple	У цій провінції немає покращеного обладнання для цих загонів.	true
campaign_localised_strings_string_public_order_slaves	Переселенці	true
campaign_localised_strings_string_politics_character_already_governor	Цей персонаж уже губернатор.	true
campaign_localised_strings_string_unit_upgrade_retrain_header	Перепідготовити	true
campaign_localised_strings_string_events_attrition_summary_force_army	Військо:	true
campaign_localised_strings_string_raise_navy	Зберіть фльоту.||Створіть нову фльоту і призначте адмірала, який поведе її в бій.	true
campaign_localised_strings_string_building_restriction_bel_bld_all_resources_salt_4	Щоб розблокувати цю будівлю, Ви повинні контролювати всі 3 регіони, що містять сіль, і побудувати будівлю видобутку солі в кожному з них.	true
campaign_localised_strings_string_public_order_events	Події	true
campaign_localised_strings_string_politics_action_impossible_actor_not_female	[[col:red]]Тільки члени родини жіночої статі можуть виходити заміж персонажів поза родиною.[[/col]]	true
campaign_localised_strings_string_cha_faction_spanish_kingdom	Королівство Іспанія	true
campaign_localised_strings_string_religion_factor_character	Персонажі	true
campaign_localised_strings_string_politics_action_impossible_retainer	Політичні дії не можуть бути вжиті проти тих персонажів, які є наймитами.	true
campaign_localised_strings_string_public_order_slaves_tooltip	Війна і безлад змушують людей тікати до сусідніх провінцій і ставати там переселенцями.	true
campaign_localised_strings_string_military_history_foundation	Створення:	true
campaign_localised_strings_string_military_force_morale_won_battle	Битва виграна	true
campaign_localised_strings_string_public_order_uncertainty	Невизначеність (-1 за хід)	true
campaign_localised_strings_string_tax_exempt_food_description	Ця провінція звільнена від оподаткування, тому не приносе їжі.	true
campaign_localised_strings_string_military_force_morale_bonus_value_plague	Моровиця	true
campaign_localised_strings_string_edicts_disabled_cap_reached	[[col:red]]Наразі Ви не можете видавати додаткові едикти.[[/col]]\\nРозширення та розвиток збільшить імперіум Вашої держави, що дозволить Вам призначати додаткових губернаторів і видавати нові едикти.	true
campaign_localised_strings_string_att_eos_religious_mission_build_att_rel_judaism	Перетворіть або побудуйте 4 єврейські релігійні споруди, не будуючи жодних інших релігійних споруд.	true
campaign_localised_strings_string_religion_factor_osmosis	Проникнення	true
campaign_localised_strings_string_politics_character_heir	Спадкоємець	true
campaign_localised_strings_string_end_turn_warning_unused_edicts	Ви все ще можете видати едикт в одній із підконтрольних провінцій:	true
campaign_localised_strings_string_growth_faction	Держава	true
campaign_localised_strings_string_military_force_growth_events	Держава	true
campaign_localised_strings_string_building_restriction_bel_bld_all_resources_orchards_4	Щоб розблокувати цю будівлю, Ви повинні контролювати всі 4 регіони, що містять вино, і побудувати будівлю виготовлення вина в кожному з них.	true
campaign_localised_strings_string_end_turn_warning_character_loyalty_low	У цієї людини низька вірність:	true
campaign_localised_strings_string_growth_raiding	Напад	true
campaign_localised_strings_string_raise_army_no_valid_location	Неможливо зібрати військо.||Немає необхідного місця розташування.	true
campaign_localised_strings_string_military_force_growth_stance	Поточна позиція	true
campaign_localised_strings_string_cannot_recruit_unit_source_settlement_besieged	Неможливо завербувати цей загін||Поселення в облозі.	true
campaign_localised_strings_string_politics_ministerial_position_expected_effects	[[/col:green]]Вибраний персонаж може спробувати влаштуватися на цю посаду. Їх успіх – чи невдача – буде визначено на початку наступного ходу.[[/col]]\\n\\nНа посаді він матиме такі переваги:	true
campaign_localised_strings_string_building_restriction_att_slav_wonder_1	Цю будівлю буде розблоковано, коли буде виконано наступні умови:\\n[[col:yellow]]• Контроль джерела деревини.\\n• Контроль родовища заліза.\\n• Принаймні 70% населення сповідують державну релігію.[[/col]]	true
campaign_localised_strings_string_cha_faction_cordoba_caliphate	Кордовський халіфат	true
campaign_localised_strings_string_military_history_battles_victory_close	Ледве перемогли:	true
campaign_localised_strings_string_politics_event_target_family	Цільова партія:	true
campaign_localised_strings_string_unit_details_xp	Досвід:	true
campaign_localised_strings_string_cha_mission_carloman_succession	Захопіть столичний регіон Карломана та перемогти лоялістів, які зараз його утримують.	true
campaign_localised_strings_string_military_history_years_service	Вислуга років:	true
campaign_localised_strings_string_politics_event_assassination_wounded	Їм не вдалося вбити його, але вдалося поранити, коли він тікав!	true
campaign_localised_strings_string_bel_expedition_western_rome_separatists	Сепаратисти Римського королівства	true
campaign_localised_strings_string_politics_character_left_your_family_for	Цей персонаж залишив Вашу родину і пішов до такої держави:	true
campaign_localised_strings_string_edicts_incoming	Очікуваний едикт:	true
campaign_localised_strings_string_info_panel_effect_summary_force	Вплив війська	true
campaign_localised_strings_string_building_restriction_att_slav_wonder_military_2	Цю будівлю буде розблоковано, коли будуть виконані наступні умови:\\n[[col:yellow]]• Контроль над родовищем золота.\\n• Контроль над родовищем свинцю.\\n• Здобуто 10 героїчних перемог.\\n • Принаймні 70% населення сповідують державну релігію.[[/col]]	true
campaign_localised_strings_string_building_restriction_att_slav_wonder_military_3	Цю будівлю буде розблоковано, коли будуть виконані наступні умови:\\n[[col:yellow]]• Контроль родовища мармуру.\\n• Контроль родовища коштовного каміння.\\n• Здобуто 20 героїчних перемог.\\n • Принаймні 80% народу сповідують державну релігію.[[/col]]	true
campaign_localised_strings_string_edicts_allowed	Тут Ви можете видати едикт.	true
campaign_localised_strings_string_raise_legacy_no_funds	Неможливо відновити спадщину.||У Вас недостатньо коштів.	true
campaign_localised_strings_string_military_history_battles_victory_heroic	Героїчна перемога проти:	true
campaign_localised_strings_string_tooltip_over_landbridge	Віадук	true
campaign_localised_strings_string_military_history_battles_defeat_close	Незначна поразка від:	true
campaign_localised_strings_string_military_force_morale_bonus_value_raid_stance	Напад	true
campaign_localised_strings_string_end_turn_warning_spare_governor_slot	Ви все ще можете призначити губернатора провінції.	true
campaign_localised_strings_string_general_type_politician	Держ. діяч	true
campaign_localised_strings_string_building_restriction_att_bld_eos_military_infantry_5_semitic	Оселя захисників Шама буде розблоковано, коли будуть виконані наступні умови:\\n[[col:yellow]]• Віруючі Вашої держави повинна скаладатися принаймні на 75% із семітів-язичників.[[/col]]	true
campaign_localised_strings_string_edicts_heading	Провінційні едикти	true
campaign_localised_strings_string_cannot_recruit_unit_army_full	Неможливо набрати загін||Військо переповнене.	true
campaign_localised_strings_string_politics_event_adoption	Пропозиція усиновлення.	true
campaign_localised_strings_string_info_panel_effect_summary_agent	Вплив агента	true
campaign_localised_strings_string_politics_action_impossible_actor_not_married	[[col:red]]Щоб розлучитися, потрібно бути одруженим.[[/col]]	true
campaign_localised_strings_string_politics_action_impossible_actor_not_general	[[col:red]]Цей персонаж не є полководцем.[[/col]]	true
campaign_localised_strings_string_cha_faction_frankish_kingdom_objective	Держава Карломана не повинна існувати, і Ви повинні володіти принаймні 30 регіонами.	true
campaign_localised_strings_string_campaign_morale_title_tooltip	Єдність	true
campaign_localised_strings_string_politics_event_assassination_success	Вони успішно його вбили!	true
campaign_localised_strings_string_gdp_manufacture	Промисловість	true
campaign_localised_strings_string_growth_province	Провінція та регіон	true
campaign_localised_strings_string_tooltip_labour_points	Очки зростання:	true
campaign_localised_strings_string_public_order_desolation	Пустка (лише наступний хід)	true
campaign_localised_strings_string_details_panel_tradition_cannot_no_skill_points	Він не має очок звичаїв.	true
campaign_localised_strings_string_politics_action_impossible_different_faction	[[col:red]]Не можна діяти проти персонажів, які належать до інших держав.[[/col]]	true
campaign_localised_strings_string_military_force_morale_bonus_value_characters	Персонажі	true
campaign_localised_strings_string_politics_event_bribe_success	Він прийняв пропозицію та присягнув на вірність своїй новій партії. Тепер він служить їхнім інтересам.	true
campaign_localised_strings_string_details_panel_ancillary_remove	Видалити поточного наймита або речі із господи.	true
campaign_localised_strings_string_att_eos_axum_mission_1	Контролюйте 2 або більше джерел прянощів.	true
campaign_localised_strings_string_att_eos_axum_mission_2	Досягніть монополії на прянощі.	true
campaign_localised_strings_string_att_eos_axum_mission_3	Контролюйте родовище золота.	true
campaign_localised_strings_string_sea_region_control_status_recruitment_cost_mod	Вартість вербування фльоти: %d%%	true
campaign_localised_strings_string_cannot_migrate_not_migratory	Ви не можете переселитися, оскільки Ваша держава не є міграційною.	true
campaign_localised_strings_string_building_restriction_att_bld_religion_celtic_major_5	Святиня Белена буде розблокована, коли будуть виконані наступні умови: \\n\\n - Побудуйте 5 основних релігійних споруд \\n - Кельтське язичництво має бути релігією більшості в усіх провінціях, які Ви контролюєте.	true
campaign_localised_strings_string_public_order_desolation_tooltip	Руйнівні наслідки війни залишають мало приводів для задоволення, а переміщені особи спрямовують свій гнів на Вас.	true
campaign_localised_strings_string_military_force_morale_change_of_soil	Чужа земля	true
campaign_localised_strings_string_politics_character_cannot_become_governor_travelling	Цього персонажа не можна призначати посади під час його руху.	true
campaign_localised_strings_string_politics_event_bribe	Спроба підкупу!	true
campaign_localised_strings_string_building_restriction_att_bld_eos_military_infantry_5_judaism	Оселю Хаялимів буде розблоковано, коли будуть виконані такі умови:\\n[[col:yellow]]• Ваша держава складатиметься щонайменше 75% з євреїв.[[/col]]	true
campaign_localised_strings_string_politics_event_blackmail_discredited	Їхні вимоги були відхилені, тому його репутація була заплямована чутками.	true
campaign_localised_strings_string_politics_event_acting_family	Ініціююча сторона:	true
campaign_localised_strings_string_politics_event_marriage_failure	Він відмовився від пропозиції одружитися. Баланс сил залишається незмінним.	true
campaign_localised_strings_string_politics_event_adoption_success	Він прийняв пропозицію та присягнув на вірність своїй новій партії. Тепер він служить їхнім інтересам.	true
campaign_localised_strings_string_raise_navy_no_valid_location	Неможливо  зібрати фльоту.||Немає необхідного місця розташування.	true
campaign_localised_strings_string_garrison_no_units_no_building	Без залоги ||У Вас немає будівель, які забезпечують залогу.	true
campaign_localised_strings_string_politics_action_impossible_target_own_family	[[col:red]]Ця дія не може бути спрямована проти інших членів родини.[[/col]]	true
campaign_localised_strings_string_gdp_fertility	Родючість	true
campaign_localised_strings_string_politics_event_assassination	Замах на вбивство!	true
campaign_localised_strings_string_public_order_revolt_next_turn	За поточного стану справ раби повстануть наступного разу!	true
campaign_localised_strings_string_politics_action_make_heir_description	Спадкоємець почне керувати державою, коли поточний лідер піде. Виберіть кандидата, який, на Вашу думку, найкраще підходить для цього завдання, але пам’ятайте, що позбавлення іншого спадкоємця суттєво вплине на його вірність.\\n\\nДекларація про спадщину набуває чинності негайно.	true
campaign_localised_strings_string_cha_faction_avar_khaganate_objective	Лідер Вашої держави повинен мати принаймні 5 ранг.	true
campaign_localised_strings_string_military_force_morale_bonus_value_patrol_stance	Патрулювання	true
campaign_localised_strings_string_building_restriction_att_slav_wonder_civic_2	Цю будівлю буде розблоковано, коли будуть виконані наступні умови:\\n[[col:yellow]]• Контроль над родовищем золота.\\n• Контроль над родовищем свинцю.\\n• Принаймні 4000 торгівельного прибутку.\\n• Принаймні 70% населення сповідують державну релігію.[[/col]]	true
campaign_localised_strings_string_building_restriction_att_slav_wonder_civic_3	Цю будівлю буде розблоковано, коли будуть виконані наступні умови:\\n[[col:yellow]]• Контроль родовища мармуру.\\n• Контроль родовища коштовного каміння.\\n• Принаймні 8000 прибутку від торгівлі.\\n• Принаймні 80% народу сповідують державну релігію.[[/col]]	true
campaign_localised_strings_string_public_order_technology	Технології	true
campaign_localised_strings_string_military_force_morale_bonus_value_own_waters	Дружні води	true
campaign_localised_strings_string_tooltip_loyalty_header	Вірність	true
campaign_localised_strings_string_tooltip_levy_unit_recruitment_unit_mouseover	Клацніть ЛКМ, щоб додати загін до черги, клацніть ПКМ, щоб отримати додаткову інформацію.||Щоб мобілізувати загін, клацніть ЛКМ кнопку Найняти.	true
campaign_localised_strings_string_garrison_no_units_momentarily	Без залоги ||Загони не почнуть поповнюватися наступного ходу.	true
campaign_localised_strings_string_public_order_culture_tooltip	Плавильний котел культур може зв’язувати людей разом або створювати тертя.	true
campaign_localised_strings_string_building_restriction_att_bld_barbarian_civic_market_general_5_legendary_celts	Королівський базар буде розблоковано, коли будуть виконані такі умови: \\n\\n -Майте доступ до 9 торгівельних ресурсів.	true
campaign_localised_strings_string_politics_action_impossible_actor_not_politician	[[col:red]]Тільки державні діячі можуть стати наймитами іншого персонажа.[[/col]]	true
campaign_localised_strings_string_cha_mission_vikings_1	Спустошити 5 поселень в Англії. (Сюди входять провінції Вессекс, Мерсія та Нортумбрія.)	true
campaign_localised_strings_string_unit_upgrade_retrain_cannot_reason_none_multiple_horde	У цій орді немає подальшого навчання для цих загонів.	true
campaign_localised_strings_string_details_panel_tradition_select	Це військо може прийняти додаткові звичаї.\\nНатисніть на звичаї ЛКМ, щоб прийняти їх.	true
campaign_localised_strings_string_politics_action_impossible_actor_gravitas_insufficient	[[col:red]]Діючий персонаж має недостатній вплив для цієї дії.[[/col]]\\n\\nПерсонажі отримують вплив завдяки своїм успіхам на полі як командувачі чи губернатори або поступово під час участі в політиці в столиці.	true
campaign_localised_strings_string_province_shared	Спільна провінція.	true
campaign_localised_strings_string_politics_character_status_in_transit	В дорозі	true
campaign_localised_strings_string_military_force_morale_bonus_value_settle_stance	Табір	true
campaign_localised_strings_string_politics_action_gravitas_cost	Очки впливу:	true
campaign_localised_strings_string_politics_action_impossible_actor_faction_leader_only	[[col:red]]Тільки лідер держави може проводити цю політичну дію.[[/col]]	true
campaign_localised_strings_string_recruitment_unavailable_cannot_switch_stance	Не може вербувати. Ці війська зараз не в стані оселення та не має достатньо очок дій для поселення.	true
campaign_localised_strings_string_military_force_morale_bonus_value_tax	Податок	true
campaign_localised_strings_string_recruitment_levy_from_satrapy	Новобранці із маріонеткової держави	true
campaign_localised_strings_string_raise_navy_blockaded	Неможливо  зібрати фльоту.||Порт цього поселення заблоковано.	true
campaign_localised_strings_string_raise_navy_no_candidate	Неможливо зібрати фльоту.||Немає відповідних кандидатів.	true
campaign_localised_strings_string_raise_army_no_candidate	Неможливо зібрати військо.||Немає відповідних кандидатів.	true
campaign_localised_strings_string_retrain_upgrade_header	Перепідготовити	true
campaign_localised_strings_string_edicts_current	Чинний едикт:	true
campaign_localised_strings_string_current_office	Нині займає найвищу посаду:	true
campaign_localised_strings_string_public_order_culture	Релігія	true
campaign_localised_strings_string_force_not_in_correct_stance_expedition	Експедиції повинні стояти табором, щоб будувати будівлі. Видання цього наказу поставить експедицію в позицію табору.	true
campaign_localised_strings_string_politics_action_impossible_actor_post_requirement_fail	[[col:red]]Мінімальні вимоги для цієї посади не виконано.[[/col]]	true
campaign_localised_strings_string_public_order_faction_tooltip	Ваш народ втомився від майже постійного стану війни, в якому він змушений жити.	true
campaign_localised_strings_string_unit_upgrade_cannot_reason_none_single	У цій провінції немає покращеного обладнання для цього загону.	true
campaign_localised_strings_string_public_order_raiding_tooltip	Напад	true
campaign_localised_strings_string_authority_desc	Захист від дій агента на зниження авторитету.	true
campaign_localised_strings_string_military_history_battles_defeat_phyrric	Героїчно програли у:	true
campaign_localised_strings_string_tooltip_mercenary_recruitment_unit_mouseover	Клацніть ЛКМ, щоб додати загін найманців до черги, клацніть ПКМ, щоб дізнатися більше.||Щоб найняти найманців, клацніть ЛКМ кнопку Найняти.	true
campaign_localised_strings_string_character_type_child	Дитина	true
campaign_localised_strings_string_politics_event_adoption_failure	Він відмовився від пропозиції та залишається вірним своїй партії.	true
campaign_localised_strings_string_public_order_characters_tooltip	Присутність цієї людини та її оточення може вплинути на громадський порядок.	true
campaign_localised_strings_string_politics_event_marriage_success	Шлюб було організовано, і баланс сил відновлено.	true
campaign_localised_strings_string_politics_ministerial_position_expected_effects_when_qualified	[[/col:red]]Вибраний персонаж ще не відповідає мінімальним вимогам для цієї посади.[[/col]]\\n\\nНа посаді він матиме такі переваги:	true
campaign_localised_strings_string_public_order_resistance_to_occupation_tooltip	Зменшується на одиницю кожного ходу	true
campaign_localised_strings_string_politics_event_marriage	Пропозиція шлюбу.	true
campaign_localised_strings_string_politics_power_support_popular_gravitas	%u вплив	true
campaign_localised_strings_string_public_order_characters	Персонажі	true
campaign_localised_strings_string_growth_other	Інше	true
campaign_localised_strings_string_politics_event_assassination_failure	Їм не вдалося його вбити.	true
campaign_localised_strings_string_public_order_resistance_to_occupation	Нестабільність (-1 за хід)	true
campaign_localised_strings_string_growth_taxes	Податки	true
campaign_localised_strings_string_gdp_subsistence	Прогодування	true
campaign_localised_strings_string_gdp_animal_husbandry	Тваринництво	true
campaign_localised_strings_string_public_order_faction	Втома від війни	true
campaign_localised_strings_string_details_panel_ancillary_select	Наразі не призначено жодного наймита чи речі.\\nНатисніть на доступні, щоб призначити їх цьому персонажу. Властивості набудуть чинності з наступного ходу.	true
campaign_localised_strings_string_tooltip_cancel_unit_recruitment	Клацніть ЛКМ, щоб видалити загін з черги вербування||Клацніть ПКМ, щоб отримати додаткову інформацію	true
campaign_localised_strings_string_eos_empire_of_the_east	Імперія Сходу	true
campaign_localised_strings_string_public_order_raiding	Напад	true
campaign_localised_strings_string_military_force_morale_bonus_value_food	Їжа	true
campaign_localised_strings_string_other_nobles_candidates_header	Кандидати	true
campaign_localised_strings_string_politics_action_impossible_target_self	[[col:red]]Персонажі не можуть діяти проти самих себе.[[/col]]	true
campaign_localised_strings_string_development_points_tooltip_hordes_growth_max_expedition	[[col:yellow]]Надлишок населення для цієї експедиції досягає максимуму.[[/col]]	true
campaign_localised_strings_string_military_history_foundation_location	Розташування:	true
campaign_localised_strings_string_public_order_faction_province	%PLACEHOLDER% (UNUSED)	true
campaign_localised_strings_string_confirm_religious_conversion	Ви впевнені, що бажаєте прийняти таку релігію:	true
campaign_localised_strings_string_building_restriction_att_bld_all_resources_port_spice_4	Порт для торгівлі спеціями буде розблоковано, коли будуть виконані наступні умови:\\n[[col:yellow]]• Отримайте монополію на джерела спецій.[[/col]]	true
campaign_localised_strings_string_building_restriction_att_bld_all_resources_port_spice_3	Східний порт буде розблоковано, коли будуть виконані такі умови:\\n[[col:yellow]]• Володіння 2 або більше джерелами спецій.[[/col]]	true
campaign_localised_strings_string_att_slav_venedians_mission_1	Заселити 5 пустельних регіонів.	true
campaign_localised_strings_string_public_order_buildings	Споруди	true
campaign_localised_strings_string_character_retainer_of	Наймит:	true
campaign_localised_strings_string_politics_event_divorce	Розлучення!	true
campaign_localised_strings_string_unit_details_mancount	Людей:	true
campaign_localised_strings_string_politics_ministerial_position_effects	Цей персонаж зараз займає цю посаду, створюючи такий вплив:	true
campaign_localised_strings_string_growth_armies	Війська	true
campaign_localised_strings_string_events_strings_character_type	Тип персонажа:	true
campaign_localised_strings_string_unit_upgrade_retrain_cannot_reason_none_single_horde	У цій орді немає подальшого навчання для цього загону.	true
campaign_localised_strings_string_military_force_morale_sacked_settlement	Військова здобич	true
campaign_localised_strings_string_public_order_resources	Ресурси	true
campaign_localised_strings_string_public_order_rebellion	За поточного стану справ повстання відбудеться за %n ходів.	true
campaign_localised_strings_string_campaign_ambush_success_chance	Імовірність успіху засідки: %d%%	true
campaign_localised_strings_string_cannot_recruit_force_region_under_siege	Це поселення в облозі. Ви не можете збирати війська тут, доки її не буде знято.	true
campaign_localised_strings_string_military_force_morale_attrition	Виснаження	true
campaign_localised_strings_string_politics_event_divorce_success	Шлюб розірвано.	true
campaign_localised_strings_string_unit_upgrade_cannot_reason_foreign_territory	Армія знаходиться на чужині.	true
campaign_localised_strings_string_public_order_buildings_tooltip	Недавнє руйнування та розпад нашої інфраструктури викликає у людей невдоволення – ніхто не хоче жити у злиднях.	true
campaign_localised_strings_string_confirm_begin_migration	Ви впевнені, що бажаєте почати переселення?	true
campaign_localised_strings_string_military_force_morale_bonus_value_technologies	Технології	true
campaign_localised_strings_string_public_order_resources_tooltip	Коли багатство та розкіш течуть через міські ворота, населення, як правило, не хвилює, звідки воно йде.	true
campaign_localised_strings_string_cha_faction_scotland	Шотландія	true
campaign_localised_strings_string_politics_action_impossible_target_already_has_retainer	[[col:red]]Цей персонаж уже має наймита.[[/col]]	true
campaign_localised_strings_string_button_start_migration	Почати переселення||Ви залишите свої поселення, і почнете переселення. Вашу скарбницю буде відшкодовано за рахунок залишеної інфраструктури, а Ваші війська візьмуть із собою свої будівлі для переселення, будь то реколонізація порожнього поселення або захоплення існуючого. Надлишок населення перерозподіляється між Вашими існуючими військами.	true
campaign_localised_strings_string_cha_faction_holy_roman_empire	Священна Римська імперія	true
campaign_localised_strings_string_att_slav_sclaveneans_mission_2	Не програйте бій протягом 20 ходів.	true
campaign_localised_strings_string_att_slav_sclaveneans_mission_1	Перемогти гунів у бою 5 разів.	true
campaign_localised_strings_string_military_force_morale_supplies	Припаси	true
campaign_localised_strings_string_siege_cannot_surrender_without_blockade	Це поселення не здасться, доки воно підтримується портом. Заблокуйте поселення з моря, щоб виморити населення голодом.	true
campaign_localised_strings_string_character_neutral_effect_level	Рівень нейтральності. Немає ні негативних, ні позитивних ефектів.	true
campaign_localised_strings_string_raise_legacy_besieged	Неможливо відновити спадщину.||Це поселення в облозі.	true
campaign_localised_strings_string_battle_ambush_they_intercept	Ваша армія помітила ворогів, що чекали на засідці. Не злякавшись їх відкриття, ворог іде в бій.	true
campaign_localised_strings_string_military_force_morale_kings_own	Королівська власність	true
campaign_localised_strings_string_politics_action_cancel	Скасувати це політичне дійство.	true
campaign_localised_strings_string_cha_mission_pope_help_1	Захопіть або пограбуйте лангобардську столицю.	true
campaign_localised_strings_string_military_force_morale_concurrent_wars	Одночасні війни	true
campaign_localised_strings_string_development_points_tooltip_hordes_growth_max	[[col:yellow]]Надлишок населення цієї орди досягає максимуму.[[/col]]	true
campaign_localised_strings_string_building_restriction_att_bld_eos_mint	Королівський монетний двір буде розблоковано, коли будуть виконані наступні умови:\\n[[col:yellow]]• Контролюйте родовища золота.\\n• Отримайте монополію на джерела спецій.[[/col]]	true
campaign_localised_strings_string_gdp_fertility_livestock	Тваринництво[Родюч.]	true
campaign_localised_strings_string_imperium_tooltip_03	Вражаючий||Чутка про Ваші досягнення пішла далеко. До Вас ставляться як з повагою, так і з обережністю.	true
campaign_localised_strings_string_imperium_tooltip_02	Помітний||Ви утвердили себе як гідну силу.	true
campaign_localised_strings_string_imperium_tooltip_01	Незначний||Ваша сила мало має значення для світу... Поки що!	true
campaign_localised_strings_string_imperium_tooltip_07	Верховний||Ваша сила найвища.	true
campaign_localised_strings_string_imperium_tooltip_06	Жахливий||Світ тремтить перед Вашою могутністю.	true
campaign_localised_strings_string_imperium_tooltip_05	Загрозливий||Вашої сили водночас бояться та жадають вороги.	true
campaign_localised_strings_string_imperium_tooltip_04	Надихаючий||Ваші досягнення великі.  Ви приклад для наслідування - і виклик - для всіх.	true
campaign_localised_strings_string_building_restriction_att_bld_barbarian_civic_tavern_5_legendary_celts	Залю бардів буде розблоковано, коли будуть виконані наступні умови: \\n\\n - Здобути 3 героїчні перемоги.	true
campaign_localised_strings_string_religion_factor_faction_traits	Особливість держави	true
campaign_localised_strings_string_public_order_province	Провінція	true
campaign_localised_strings_string_military_force_morale_released_captives	Без полонених	true
campaign_localised_strings_string_military_force_morale_bonus_value_own_territory	Дружня територія	true
campaign_localised_strings_string_details_panel_tradition_cannot_select	Це військо не може прийняти ці звичаї:	true
campaign_localised_strings_string_gdp_land_trade	!NOT USED!	true
campaign_localised_strings_string_military_force_morale_bonus_value_march_stance	Масове переселення	true
campaign_localised_strings_string_politics_action_impossible_target_dead	[[col:red]]Цей персонаж мертвий! Проти нього не можна діяти.[[/col]]	true
campaign_localised_strings_string_development_points_tooltip_hordes_insufficent_development_points_number	Вам потрібен %n надлишок населення.||Орда з часом зростатиме, але поєднання набігів і поселення разом із відповідними будівлями допоможе збільшити швидкість зростання.	true
campaign_localised_strings_string_raise_legacy_no_surplus	Неможливо відновити спадщину.||У Вас недостатньо надлишку населення.	true
campaign_localised_strings_string_raise_legacy	Відновіть спадщину.||Відродіть ім'я одного з Ваших переможених або розформованих загонів.||Нове військо збереже всі звичаї свого попередника.	true
campaign_localised_strings_string_unit_upgrade_cannot_reason_none_single_horde	У цій орді немає покращеного обладнання для цього загону	true
campaign_localised_strings_string_politics_cursus_current_level	Поточний рівень	true
campaign_localised_strings_string_details_panel_tradition_cannot_low_rank	Його ранг занадто низький.	true
campaign_localised_strings_string_gdp_local_trade	Місцева торгівля	true
campaign_localised_strings_string_raise_force_navy_cannot	Неможливо  зібрати фльоту	true
campaign_localised_strings_string_cannot_recruit_agent_region_not_owned	Це поселення Вам не належить. Ви не можете завербувати тут агента.	true
campaign_localised_strings_string_military_force_morale_bonus_value_faction_trait	Особливість держави	true
campaign_localised_strings_string_politics_event_outcome	Наслідки	true
campaign_localised_strings_string_cha_faction_frankish_kingdom	Королівство Франків	true
campaign_localised_strings_string_cha_faction_cordoba_caliphate_objective	Ваша державна релігія іслам повинна становити щонайменше 75%.	true
campaign_localised_strings_string_politics_power_support_popular_current	Поточне володіння:	true
campaign_localised_strings_string_cannot_issue_edict_to_unowned_region	[[col:red]]Ви можете видавати едикти лише в регіонах, якими Ви володієте.[[/col]]	true
campaign_localised_strings_string_politics_event_target_character	Ціль:	true
campaign_localised_strings_string_details_panel_skills_cannot_low_rank	Їхній ранг занадто низький.	true
campaign_localised_strings_string_cunning_desc	Захист від дій агента на зниження хитрощів.	true
campaign_localised_strings_string_cannot_recruit_agent_region_under_siege	Це поселення в облозі. Ви не можете завербувати тут агента, доки її не буде знято.	true
campaign_localised_strings_string_politics_governor_cap_reached	У Вас уже є максимальна кількість губернаторів.	true
campaign_localised_strings_string_politics_power_support_political_description	Контроль є мірилом Вашої майстерності в політиці - Ваша влада над елітою. Він коливається в міру того, як члени Вашої сім’ї беруть участь у політичних інтригах і розгортаються інші події кампанії.\\n\\nУ поєднанні з пануванням це визначає загальну владу Вашої сім’ї.	true
campaign_localised_strings_string_unit_upgrade_retrain_cannot_reason_none_single	У цій провінції немає додаткового навчання для цього загону.	true
campaign_localised_strings_string_edicts_cancel	Скасування едикту\\nДія едикту буде припинена на початку наступного ходу. 	true
campaign_localised_strings_string_bel_western_roman_separatists	Західноримські сепаратисти	true
campaign_localised_strings_string_raise_legacy_blockaded	Неможливо відновити спадщину.||Порт цього поселення заблоковано.	true
campaign_localised_strings_string_garrison_no_units_siege	Без залоги ||Залога не може поповнюватися, поки місто в облозі.	true
campaign_localised_strings_string_military_force_morale_decimated	Децимація	true
campaign_localised_strings_string_gdp_sea_trade	Морська торгівля	true
campaign_localised_strings_string_public_order_improving	Громадський порядок покращується.	true
campaign_localised_strings_string_end_turn_warning_character_skill_to_be_picked	Цей персонаж має ще вільне вміння:	true
campaign_localised_strings_string_cha_mission_asturias_1	Заселити 2 із таких регіонів:\\nЛеон, Вальядолід, Саламанка	true
campaign_localised_strings_string_sea_region_control_status_port_gdp_modifier_reduction	-%d%% багатства від морської торгівлі (піратство)	true
campaign_localised_strings_string_military_force_morale_ambitious_leader	Амбітний Лідер	true
campaign_localised_strings_string_details_panel_tradition_unlocked_rank	Буде розблоковано в ранзі:	true
campaign_localised_strings_string_gdp_learning	!NOT USED!	true
campaign_localised_strings_string_growth_tooltip_description_expedition	Відповідно до зростання експедиції її населення можна використовувати для зміцнення або створення нових експедицій.	true
campaign_localised_strings_string_unit_upgrade_cannot_reason_insufficient_funds	У Вас недостатньо коштів.	true
campaign_localised_strings_string_public_order_military_crackdown_tooltip	Коли цивільні засоби зазнають невдачі, порядок буде підтримуватися сталевою силою.	true
campaign_localised_strings_string_unit_upgrade_cannot_reason_none_multiple_horde	У цій орді немає покращеного обладнання для цих загонів.	true
campaign_localised_strings_string_public_order_military_activity	Військова присутність	true
campaign_localised_strings_string_politics_character_is_faction	Цей персонаж є частиною родини наступної держави:	true
campaign_localised_strings_string_cannot_recruit_force_region_not_owned	Це поселення Вам не належить. Тут війська не набереш.	true
campaign_localised_strings_string_raise_force_navy_cannot_port_required	[[col:red]]Ви можете створювати фльоту лише в портових поселеннях.[[/col]]	true
campaign_localised_strings_string_public_order_buildings_squalor_tooltip	Забруднення	true
campaign_localised_strings_string_public_order_banditry_tooltip	Бродяги та хулігани порушують мир громади, порушуючи спокій і сіючи нещастя	true
campaign_localised_strings_string_details_panel_ancillary_none	Наразі немає наймитів чи речей, доступних для призначення.	true
campaign_localised_strings_string_public_order_conquest_tooltip	Тягар війни і військове гноблення роблять народ непокірним.	true
campaign_localised_strings_string_public_order_baseline_tooltip	Налаштування складності Вашої кампанії вплине на громадський порядок.	true
campaign_localised_strings_string_cha_faction_viking_kingdom_objective	Спустошити не менше 25 поселень.	true
campaign_localised_strings_string_province_fertility_factor_base	Базова родючість	true
campaign_localised_strings_string_politics_character_cannot_act_wounded	Цей персонаж не може здійснювати політичні дії або бути під впливом їх, коли він поранений.	true
campaign_localised_strings_string_public_order_buildings_squalor	Споруди	true
campaign_localised_strings_string_public_order_banditry	Розбійники	true
campaign_localised_strings_string_military_force_morale_bonus_value_guarded_navy	Супровід вантажних човнів	true
campaign_localised_strings_string_cha_faction_english_kingdom_objective	Володійте провінціями Вессекс, Мерсія і Нортумбрія.	true
campaign_localised_strings_string_cha_faction_italian_kingdom_objective	Володійте провінціями Фріулі, Ломбардія, Екзархат, Беневенто, Калабрія, Сицилія та Рим (за винятком міста Риму).	true
campaign_localised_strings_string_military_force_morale_raiding	Напад	true
campaign_localised_strings_string_raise_legacy_no_legacy	Неможливо відновити спадщину.||У Вас немає військових спадщин для відновлення.	true
campaign_localised_strings_string_public_order_garrison	Залога	true
campaign_localised_strings_string_politics_character_cannot_be_acted_or_act_travelling	Цей персонаж не може діяти під час руху.	true
campaign_localised_strings_string_public_order_baseline	Складність	true
campaign_localised_strings_string_public_order_conquest	Завоювання(лиш наст.хід)	true
campaign_localised_strings_string_cannot_recruit_unit_source_settlement_blockaded	Неможливо завербувати цей загін||Поселення в блокаді.	true
campaign_localised_strings_string_character_type_daughter	Дочка	true
campaign_localised_strings_string_edicts_issued	Видані едикти:	true
campaign_localised_strings_string_province_owned	Власна провінція.	true
campaign_localised_strings_string_general_type_general	Полководець	true
campaign_localised_strings_string_public_order_military_crackdown	Військові репресії	true
campaign_localised_strings_string_military_history_battles_defeat_heroic	Розгромна поразка від:	true
campaign_localised_strings_string_details_panel_ancillary_cannot_assign	[[col:yellow]]Наразі немає вільних наймитів чи речей, необхідних для призначення.[[/col]]	true
campaign_localised_strings_string_cha_faction_spanish_kingdom_objective	Володійте  провінціями Валенсія, Толедо, Іспанська Марка, Нижня Марка, Середня Марка, Наварра, Леон і Галісія.	true
campaign_localised_strings_string_general_type_admiral	Адмірал	true
campaign_localised_strings_string_sanitation_tooltip_current_sanitation	Нинішня санітарія:	true
campaign_localised_strings_string_public_order_military_activity_tooltip	Останні військові дії в регіоні дали людям привід для розмов	true
