key	text	tooltip
#Loc;1;text/db/cdir_events_dilemma_choice_details.loc		
cdir_events_dilemma_choice_details_localised_choice_label_att_dilemma_religious_celtic_religious_sanctions_1SECOND	Накласти санкції	true
cdir_events_dilemma_choice_details_localised_choice_title_cha_dilemma_pope_attacked_1SECOND	Бог посилає випробування, щоб зміцнити нас. Я не можу нести цей тягар за Вас.	true
cdir_events_dilemma_choice_details_localised_choice_label_cha_dilemma_lombard_pope_demands_1FIRST	Здати Равенну	true
cdir_events_dilemma_choice_details_localised_choice_title_political_event_assassinationFIRST	Подвоїти варту і нагадати всім, як ми вирішуємо справу зі зрадниками!	true
cdir_events_dilemma_choice_details_localised_choice_label_att_political_action_dilemma_secure_loyalty_briberyTHIRD	Забути це	true
cdir_events_dilemma_choice_details_localised_choice_label_att_political_action_dilemma_assassinate_suspiciousFIRST	Замітати сліди	true
cdir_events_dilemma_choice_details_localised_choice_title_att_political_action_dilemma_secure_loyalty_mutilationTHIRD	Він нас не стосується. У нас є важливіші справи.	true
cdir_events_dilemma_choice_details_localised_choice_title_att_subject_domestic_nordic_the_flyting_1THIRD	Призначте полководця своїм борцем. Він доведе Вашу перевагу.	true
cdir_events_dilemma_choice_details_localised_choice_title_ybor_level_A_alamanniSECOND	Священство каже, що вона дарує мудрість і захист Годана.	true
cdir_events_dilemma_choice_details_localised_choice_label_att_subject_politics_civil_challengerFOURTH	Дати йому посаду	true
cdir_events_dilemma_choice_details_localised_choice_label_att_subject_politics_civil_hostageSECOND	Тримати його в заручниках	true
cdir_events_dilemma_choice_details_localised_choice_label_att_political_action_dilemma_secure_loyalty_briberyFIRST	Великий хабар	true
cdir_events_dilemma_choice_details_localised_choice_label_att_political_action_dilemma_assassinate_suspiciousTHIRD	Забути це	true
cdir_events_dilemma_choice_details_localised_choice_title_att_political_action_dilemma_secure_loyalty_mutilationFIRST	Після цього він більше нікому не згодиться!	true
cdir_events_dilemma_choice_details_localised_choice_title_att_subject_domestic_nordic_the_flyting_1FIRST	У нас немає часу на такі легковажності.	true
cdir_events_dilemma_choice_details_localised_choice_label_att_subject_military_roman_master_hostile_governorSECOND	Оббрехати його	true
cdir_events_dilemma_choice_details_localised_choice_title_ybor_level_A_burgundiFIRST	Взятий із мертвої хватки ворожого короля.	true
cdir_events_dilemma_choice_details_localised_choice_label_att_subject_domestic_barb_nomad_stolen_swordFIRST	Зробити новий	true
cdir_events_dilemma_choice_details_localised_choice_label_att_political_action_dilemma_seek_office_obstructionSECOND	Наказ	true
cdir_events_dilemma_choice_details_localised_choice_label_cha_dilemma_lombard_pope_demands_3FIRST	Здати Равенну	true
cdir_events_dilemma_choice_details_localised_choice_label_cha_dilemma_lombard_pope_demands_2THIRD	Підлизатися до Карла Великого	true
cdir_events_dilemma_choice_details_localised_choice_title_att_dilemma_religious_christian_the_council_of_toledo_1FIRST	Цих людей досить довго переслідували. Нам слід повернути їх у лоно.	true
cdir_events_dilemma_choice_details_localised_choice_label_att_subject_politics_barb_nomad_tribal_loyaltyTHIRD	Бути посередником	true
cdir_events_dilemma_choice_details_localised_choice_label_att_subject_politics_civil_secret_meetingsSECOND	Зустрітися з ними	true
cdir_events_dilemma_choice_details_localised_choice_title_att_subject_domestic_none_the_silk_trader_1SECOND	Цей новий торговий шлях може мати велике значення для нашого народу. Допоможемо розширити його діяльність.	true
cdir_events_dilemma_choice_details_localised_choice_label_att_subject_domestic_barb_nomad_stolen_swordTHIRD	Нічого не робити	true
cdir_events_dilemma_choice_details_localised_choice_title_ollam_ri_A1iSECOND	У Рі немає часу на казки, але він має час на золото!	true
cdir_events_dilemma_choice_details_localised_choice_label_att_dilemma_religious_orthodox_religious_sanctions_1SECOND	Накласти санкції	true
cdir_events_dilemma_choice_details_localised_choice_label_cha_dilemma_lombard_pope_demands_2FIRST	Здати Равенну	true
cdir_events_dilemma_choice_details_localised_choice_label_att_dilemma_religious_germanic_religious_sanctions_1SECOND	Накласти санкції	true
cdir_events_dilemma_choice_details_localised_choice_title_att_subject_domestic_civil_idiot_magistrateSECOND	Ви не можете керувати своїм народом шляхом азартних ігор!	true
cdir_events_dilemma_choice_details_localised_choice_title_att_subject_domestic_none_hidden_treasure_1SECOND	Люди заслуговують на щедрість цієї випадкової знахідки. Розподіліть його між ними порівну.	true
cdir_events_dilemma_choice_details_localised_choice_title_cha_dilemma_cordoba_1SECOND	Поставте людей на узбережжі у повній бойовій формі. Ми теж можемо продемонструвати силу.	true
cdir_events_dilemma_choice_details_localised_choice_label_att_subject_military_none_war_child_1SECOND	Брехати	true
cdir_events_dilemma_choice_details_localised_choice_label_att_subject_politics_barb_nomad_tribal_loyaltyFIRST	Похвалити одну групу	true
cdir_events_dilemma_choice_details_localised_choice_title_att_eos_marib_dam_repair_2THIRD	Ми не можемо дозволити нашим селянам втратити віру в дамбу!	true
cdir_events_dilemma_choice_details_localised_choice_title_att_eos_marib_dam_repair_3FIRST	Мабуть, витримає... так?	true
cdir_events_dilemma_choice_details_localised_choice_label_att_political_action_dilemma_embezzlement_suspiciousTHIRD	Забути це	true
cdir_events_dilemma_choice_details_localised_choice_label_att_subject_domestic_civil_idiot_magistrateFOURTH	Нічого не робити	true
cdir_events_dilemma_choice_details_localised_choice_label_att_subject_religious_christian_candidate_for_bishopFIRST	Зняти його кандидатуру	true
cdir_events_dilemma_choice_details_localised_choice_label_att_subject_domestic_civil_master_agitatorFOURTH	Нічого не робити	true
cdir_events_dilemma_choice_details_localised_choice_title_att_eos_marib_dam_repair_3THIRD	Ми не можемо дозволити нашим селянам втратити віру в дамбу!	true
cdir_events_dilemma_choice_details_localised_choice_title_att_eos_marib_dam_repair_2FIRST	Мабуть, витримає... так?	true
cdir_events_dilemma_choice_details_localised_choice_label_att_political_action_dilemma_embezzlement_suspiciousFIRST	Замітати сліди	true
cdir_events_dilemma_choice_details_localised_choice_label_att_dilemma_religious_catholic_religious_sanctions_1SECOND	Накласти санкції	true
cdir_events_dilemma_choice_details_localised_choice_label_att_subject_religious_christian_candidate_for_bishopTHIRD	Чекайте результату	true
cdir_events_dilemma_choice_details_localised_choice_label_cha_dilemma_cordoba_1FOURTH	Нічого не робити	true
cdir_events_dilemma_choice_details_localised_choice_title_att_subject_religious_hun_lightningTHIRD	Обраний Тенгрі? Що робити, якщо його відзначили за лідерство?	true
cdir_events_dilemma_choice_details_localised_choice_label_att_political_action_dilemma_adoption_added_incentiveFIRST	Підкупити його	true
cdir_events_dilemma_choice_details_localised_choice_title_att_eos_marib_dam_repair_0THIRD	Ми не можемо дозволити нашим селянам втратити віру в дамбу!	true
cdir_events_dilemma_choice_details_localised_choice_title_att_eos_marib_dam_repair_1FIRST	Мабуть, витримає... так?	true
cdir_events_dilemma_choice_details_localised_choice_label_att_subject_domestic_eastern_the_chovgan_tourney_1THIRD	Оприлюднити його особу	true
cdir_events_dilemma_choice_details_localised_choice_title_att_subject_domestic_nomad_sword_of_attilaFOURTH	Це якісь холопські фантазії, не витрачати час.	true
cdir_events_dilemma_choice_details_localised_choice_label_att_subject_military_nomad_master_swordsmithFOURTH	Нічого не робити	true
cdir_events_dilemma_choice_details_localised_choice_title_att_subject_domestic_none_workers_on_strike_1SECOND	… так, саме ви.	true
cdir_events_dilemma_choice_details_localised_choice_title_ollam_ri_pictiFIRST	Чорне дзеркало його поверхні відображає всі таємниці людства.	true
cdir_events_dilemma_choice_details_localised_choice_title_att_subject_politics_civil_challengerSECOND	Краще замовкнути йому, перш ніж він скаже щось отруйне.	true
cdir_events_dilemma_choice_details_localised_choice_label_att_subject_diplomatic_none_tribute_1SECOND	Прийняти Подарунок	true
cdir_events_dilemma_choice_details_localised_choice_title_att_subject_religious_hun_lightningFIRST	Чоловік, якого так любить Тенгрі, стане чудовим доповненням до Вашого дому.	true
cdir_events_dilemma_choice_details_localised_choice_label_att_political_action_dilemma_adoption_added_incentiveTHIRD	Залякування	true
cdir_events_dilemma_choice_details_localised_choice_label_att_subject_politics_nomad_hostageSECOND	Взяти його в заручники	true
cdir_events_dilemma_choice_details_localised_choice_label_att_subject_politics_roman_hostageSECOND	Тримати його в заручниках	true
cdir_events_dilemma_choice_details_localised_choice_title_att_eos_marib_dam_repair_1THIRD	Ми не можемо дозволити нашим селянам втратити віру в дамбу!	true
cdir_events_dilemma_choice_details_localised_choice_title_att_eos_marib_dam_repair_0FIRST	Мабуть, витримає... так?	true
cdir_events_dilemma_choice_details_localised_choice_label_att_subject_domestic_eastern_the_chovgan_tourney_1FIRST	Ігнорувати проблему	true
cdir_events_dilemma_choice_details_localised_choice_label_att_subject_politics_rome_corruptionSECOND	Заспокоїти людей	true
cdir_events_dilemma_choice_details_localised_choice_title_cha_dilemma_charlemagne_daughter_1FIRST	Не під моїм дахом? Ні, не в моєму королівстві!	true
cdir_events_dilemma_choice_details_localised_choice_label_att_subject_domestic_roman_a_little_flutter_1SECOND	Поставити на гладіатора	true
cdir_events_dilemma_choice_details_localised_choice_label_att_subject_domestic_roman_a_little_flutter_2SECOND	Поставити на ветерана	true
cdir_events_dilemma_choice_details_localised_choice_label_cha_dilemma_pope_attacked_1SECOND	Відмовитися від втручання	true
cdir_events_dilemma_choice_details_localised_choice_label_att_subject_politics_nomad_hostageFOURTH	Нічого не робити	true
cdir_events_dilemma_choice_details_localised_choice_label_att_subject_politics_roman_hostageFOURTH	Нічого не робити	true
cdir_events_dilemma_choice_details_localised_choice_title_ybor_level_A_alamanniFIRST	Взятий із мертвої хватки ворожого короля.	true
cdir_events_dilemma_choice_details_localised_choice_title_att_subject_domestic_barb_nomad_enemy_tradeFIRST	Убити зрадника!	true
cdir_events_dilemma_choice_details_localised_choice_label_att_subject_politics_rome_corruptionFOURTH	Ігнорувати людей	true
cdir_events_dilemma_choice_details_localised_choice_label_att_political_action_dilemma_secure_loyalty_mutilationFIRST	Каструвати	true
cdir_events_dilemma_choice_details_localised_choice_label_att_eos_sassanid_insult_2FIRST	Вигнати його	true
cdir_events_dilemma_choice_details_localised_choice_title_att_subject_domestic_nomad_sword_of_attilaSECOND	Цей чоловік намагається завоювати Вашу прихильність, Вам не потрібні його «подарунки».	true
cdir_events_dilemma_choice_details_localised_choice_label_att_subject_military_nomad_master_swordsmithSECOND	Убити його	true
cdir_events_dilemma_choice_details_localised_choice_title_cha_dilemma_lombard_pope_demands_1FIRST	Який християнин з честю міг би заперечити прохання Святішого Отця і відмовитися від урочистої обіцянки?	true
cdir_events_dilemma_choice_details_localised_choice_label_att_political_action_dilemma_secure_loyalty_mutilationTHIRD	Забути це	true
cdir_events_dilemma_choice_details_localised_choice_label_att_eos_sassanid_insult_3FIRST	Ввічливо відмовитися	true
cdir_events_dilemma_choice_details_localised_choice_title_att_subject_politics_civil_challengerFOURTH	Заманити його багатством і становищем.	true
cdir_events_dilemma_choice_details_localised_choice_label_ybor_level_A_alamanniSECOND	Брошка	true
cdir_events_dilemma_choice_details_localised_choice_title_att_subject_domestic_barb_nomad_stolen_swordFIRST	Попросіть ковалів викувати новий меч.	true
cdir_events_dilemma_choice_details_localised_choice_label_att_subject_domestic_civil_master_agitatorSECOND	Часткові реформи	true
cdir_events_dilemma_choice_details_localised_choice_title_att_eos_religious_event_rebellion_att_fact_himyar_att_rel_semitic_paganismSECOND	Його люди достатньо постраждали, якщо ми зможемо загладити провину, нехай буде так.	true
cdir_events_dilemma_choice_details_localised_choice_title_cha_dilemma_lombard_pope_demands_2FIRST	Я не зацікавлений у конфлікті з франками, нехай Папа бере, що хоче. Повідомте Карлу Великому, що справа вирішена.	true
cdir_events_dilemma_choice_details_localised_choice_label_cha_dilemma_cordoba_1SECOND	Скликати чоловіків	true
cdir_events_dilemma_choice_details_localised_choice_title_att_subject_military_none_war_child_1SECOND	Він справжній член родини, можливо, не по крові…	true
cdir_events_dilemma_choice_details_localised_choice_title_att_subject_domestic_nomadic_the_kassai_contest_1FIRST	Це його справа, а не наша.	true
cdir_events_dilemma_choice_details_localised_choice_title_att_subject_politics_barb_nomad_tribal_loyaltyFIRST	Нехай боги свідчать про велич обраної Вами групи воїнів!	true
cdir_events_dilemma_choice_details_localised_choice_title_att_subject_domestic_none_foreign_migrants_1SECOND	Нам ледве вистачає, щоб прогодувати своїх, не забруднюючи нас біженцями своїм примітивним існуванням.	true
cdir_events_dilemma_choice_details_localised_choice_title_att_subject_domestic_barb_nomad_stolen_swordTHIRD	У Вас немає часу на такі дрібні сварки.	true
cdir_events_dilemma_choice_details_localised_choice_label_att_subject_domestic_none_the_silk_trader_1SECOND	Дати йому караван	true
cdir_events_dilemma_choice_details_localised_choice_label_att_subject_domestic_civil_idiot_magistrateSECOND	Скасувати ставку	true
cdir_events_dilemma_choice_details_localised_choice_label_att_subject_domestic_none_hidden_treasure_1SECOND	Віддати це людям	true
cdir_events_dilemma_choice_details_localised_choice_title_cha_dilemma_lombard_pope_demands_3FIRST	Не варто залучати все королівство до війни через таку гордість. Нехай Папа візьме те, що він так важко виборював.	true
cdir_events_dilemma_choice_details_localised_choice_title_att_dilemma_religious_hellenic_religious_sanctions_1SECOND	Ми повинні прийняти закони, щоб обмежити права цих язичників на поклоніння вперед.	true
cdir_events_dilemma_choice_details_localised_choice_title_cha_dilemma_lombard_pope_demands_2THIRD	Зробити йому кілька компліментів, нехай він думає, що він кращий з нас. Натомість ми можемо взяти верх над ним.	true
cdir_events_dilemma_choice_details_localised_choice_title_att_subject_domestic_nomadic_the_kassai_contest_1THIRD	Цей чоловік водночас підтягнутий і сповнений хитрості. Доказ його вміння прислужиться нам добре.	true
cdir_events_dilemma_choice_details_localised_choice_label_att_eos_sassanid_insult_1FIRST	Захищати свій народ	true
cdir_events_dilemma_choice_details_localised_choice_title_att_subject_politics_barb_nomad_tribal_loyaltyTHIRD	Єдність потрібна. Плем'я проти всіх.	true
cdir_events_dilemma_choice_details_localised_choice_label_att_subject_politics_civil_secret_meetingsFOURTH	Найняти їх	true
cdir_events_dilemma_choice_details_localised_choice_label_att_dilemma_religious_tengri_religious_sanctions_1SECOND	Накласти санкції	true
cdir_events_dilemma_choice_details_localised_choice_title_att_subject_religious_christian_candidate_for_bishopFIRST	Ця людина не готова до такої честі. У нього багато роботи.	true
cdir_events_dilemma_choice_details_localised_choice_label_att_eos_marib_dam_repair_3THIRD	Капітальний ремонт	true
cdir_events_dilemma_choice_details_localised_choice_label_att_eos_marib_dam_repair_2FIRST	Нічого не робити	true
cdir_events_dilemma_choice_details_localised_choice_title_att_subject_domestic_civil_idiot_magistrateFOURTH	Цей дурень повинен розібратися в власному безладі.	true
cdir_events_dilemma_choice_details_localised_choice_title_att_political_action_dilemma_embezzlement_suspiciousTHIRD	Нехай пліткують і теоретизують, чого нам до селянської балачки?	true
cdir_events_dilemma_choice_details_localised_choice_title_cha_dilemma_cordoba_1FOURTH	Це вино смачне!	true
cdir_events_dilemma_choice_details_localised_choice_title_att_subject_diplomatic_none_the_feast_1THIRD	Запросити наших союзників, щоб вони також могли дивуватися. Така подія є корисною демонстрацією нашого багатства та могутності.	true
cdir_events_dilemma_choice_details_localised_choice_label_att_subject_military_roman_master_hostile_governorFOURTH	Нічого не робити	true
cdir_events_dilemma_choice_details_localised_choice_label_att_eos_religious_event_rebellion_att_fact_axum_att_rel_church_eastFIRST	Вигнати його	true
cdir_events_dilemma_choice_details_localised_choice_title_att_subject_religious_christian_candidate_for_bishopTHIRD	Ми повинні дозволити виборчому процесу йти своїм ходом без нашого втручання.	true
cdir_events_dilemma_choice_details_localised_choice_label_att_eos_marib_dam_repair_2THIRD	Капітальний ремонт	true
cdir_events_dilemma_choice_details_localised_choice_label_att_eos_marib_dam_repair_3FIRST	Нічого не робити	true
cdir_events_dilemma_choice_details_localised_choice_title_att_political_action_dilemma_embezzlement_suspiciousFIRST	Вони повинні переконатися, що жодні докази не вказують на їхню причетність.	true
cdir_events_dilemma_choice_details_localised_choice_title_att_subject_diplomatic_none_the_feast_1FIRST	Зараз не найкращий час для таких легковажних речей.	true
cdir_events_dilemma_choice_details_localised_choice_label_att_subject_politics_civil_hostageFOURTH	Нічого не робити	true
cdir_events_dilemma_choice_details_localised_choice_label_cha_dilemma_charlemagne_daughter_1FIRST	Розправитися з донькою	true
cdir_events_dilemma_choice_details_localised_choice_label_att_eos_marib_dam_repair_1THIRD	Капітальний ремонт	true
cdir_events_dilemma_choice_details_localised_choice_label_att_eos_marib_dam_repair_0FIRST	Нічого не робити	true
cdir_events_dilemma_choice_details_localised_choice_title_att_subject_domestic_eastern_the_chovgan_tourney_1FIRST	Чим займаються наші полководці у вільний час – це їхня справа.	true
cdir_events_dilemma_choice_details_localised_choice_label_att_subject_military_none_drunk_on_watch_1SECOND	Відшмагати його	true
cdir_events_dilemma_choice_details_localised_choice_title_att_subject_domestic_roman_a_little_flutter_1SECOND	Хоча він молодий, цей боєць демонструє великі перспективи. Можливо, настав час дати йому можливість проявити себе?	true
cdir_events_dilemma_choice_details_localised_choice_title_att_subject_domestic_roman_a_little_flutter_2SECOND	Ха! Молодість нічого не означає, коли стикаєшся з досвідом. Результат може бути тільки один, ставлю на ветерана.	true
cdir_events_dilemma_choice_details_localised_choice_label_att_eos_marib_dam_repair_0THIRD	Капітальний ремонт	true
cdir_events_dilemma_choice_details_localised_choice_label_att_eos_marib_dam_repair_1FIRST	Нічого не робити	true
cdir_events_dilemma_choice_details_localised_choice_title_att_subject_domestic_eastern_the_chovgan_tourney_1THIRD	Він не повинен ховатися в тіні, всі дворяни можуть конкурувати нарівні. Давайте підтримаємо його зусилля.	true
cdir_events_dilemma_choice_details_localised_choice_title_att_subject_domestic_barb_nomad_stolen_swordSECOND	Посадити обох та судити, і вияснити хто винен.	true
cdir_events_dilemma_choice_details_localised_choice_label_ollam_ri_pictiFIRST	Він прямує до озера.	true
cdir_events_dilemma_choice_details_localised_choice_label_att_subject_domestic_none_workers_on_strike_1SECOND	Розігнати натовп	true
cdir_events_dilemma_choice_details_localised_choice_label_att_subject_politics_civil_challengerSECOND	Заткнути його	true
cdir_events_dilemma_choice_details_localised_choice_title_att_subject_diplomatic_none_tribute_1SECOND	Ну хто може відмовити такому щедрому подарунку чи проігнорувати такий благородний жест?	true
cdir_events_dilemma_choice_details_localised_choice_title_att_political_action_dilemma_seek_office_obstructionFIRST	Час повернути підтримку, надану колись…	true
cdir_events_dilemma_choice_details_localised_choice_title_att_political_action_dilemma_adoption_added_incentiveFIRST	Можливо, це його переконає?	true
cdir_events_dilemma_choice_details_localised_choice_title_ollam_ri_A1iiSECOND	Простий, ефективний спосіб виграти будь-яку битву бажань.	true
cdir_events_dilemma_choice_details_localised_choice_title_att_subject_politics_civil_hostageSECOND	Хлопець може служити Вам так само добре, як заручник.	true
cdir_events_dilemma_choice_details_localised_choice_label_att_subject_religious_christian_the_money_lender_1THIRD	Стратити його	true
cdir_events_dilemma_choice_details_localised_choice_title_att_political_action_dilemma_secure_loyalty_briberyFIRST	Кожен має ціну. Кожен!	true
cdir_events_dilemma_choice_details_localised_choice_title_att_political_action_dilemma_assassinate_suspiciousTHIRD	Нехай пліткують і теоретизують, чого нам до селянської балачки?	true
cdir_events_dilemma_choice_details_localised_choice_title_att_subject_military_nomad_master_swordsmithFOURTH	У нас є важливіші справи.	true
cdir_events_dilemma_choice_details_localised_choice_label_slav_dilemma_venedians_2THIRD	Нічого їм не давати	true
cdir_events_dilemma_choice_details_localised_choice_label_slav_dilemma_venedians_3FIRST	Віддати їм данину	true
cdir_events_dilemma_choice_details_localised_choice_title_att_dilemma_domestic_roman_saint_telemachus_1SECOND	Ігри – це священні звичаї, що йдуть з покоління в покоління. Нехай продовжують!	true
cdir_events_dilemma_choice_details_localised_choice_title_att_political_action_dilemma_seek_office_obstructionTHIRD	Він того не вартий. У нас є важливіші справи.	true
cdir_events_dilemma_choice_details_localised_choice_title_att_political_action_dilemma_adoption_added_incentiveTHIRD	Він приєднається до нас або понесе кару.	true
cdir_events_dilemma_choice_details_localised_choice_label_ollam_ri_A1SECOND	Прискіпливо вдивлятися.	true
cdir_events_dilemma_choice_details_localised_choice_label_ollam_ri_A2SECOND	Спробувати його вмовити.	true
cdir_events_dilemma_choice_details_localised_choice_label_ollam_ri_A3SECOND	Підійти до неї.	true
cdir_events_dilemma_choice_details_localised_choice_label_ollam_ri_B1SECOND	Залишити шкіру.	true
cdir_events_dilemma_choice_details_localised_choice_label_ollam_ri_B2SECOND	Зглянутися над ним.	true
cdir_events_dilemma_choice_details_localised_choice_title_att_dilemma_religious_celtic_religious_sanctions_1SECOND	Ми повинні прийняти закони, щоб обмежити права цих язичників на поклоніння вперед.	true
cdir_events_dilemma_choice_details_localised_choice_label_att_subject_religious_christian_the_money_lender_1FIRST	Ігнорувати його гріх	true
cdir_events_dilemma_choice_details_localised_choice_title_att_political_action_dilemma_secure_loyalty_briberyTHIRD	Він нас не стосується. У нас є важливіші справи.	true
cdir_events_dilemma_choice_details_localised_choice_title_att_political_action_dilemma_assassinate_suspiciousFIRST	Вони повинні переконатися, що жодні докази не вказують на їхню причетність.	true
cdir_events_dilemma_choice_details_localised_choice_title_att_subject_politics_rome_corruptionSECOND	Мудрий керівник прислухається до громадської думки.	true
cdir_events_dilemma_choice_details_localised_choice_label_slav_dilemma_venedians_3THIRD	Нічого їм не давати	true
cdir_events_dilemma_choice_details_localised_choice_label_slav_dilemma_venedians_2FIRST	Віддати їм данину	true
cdir_events_dilemma_choice_details_localised_choice_label_att_dilemma_military_none_war_child_1SECOND	Залишити дитину	true
cdir_events_dilemma_choice_details_localised_choice_title_att_subject_politics_civil_secret_meetingsSECOND	Давайте подивимося, який у них порядок денний. Підіть і зустріньтеся з ними.	true
cdir_events_dilemma_choice_details_localised_choice_title_att_subject_military_none_the_spy_1FOURTH	Давайте навернемо його до нашої справи.	true
cdir_events_dilemma_choice_details_localised_choice_title_att_eos_religious_event_rebellion_att_fact_axum_att_rel_church_eastSECOND	Його люди достатньо постраждали, якщо ми зможемо загладити провину, нехай буде так.	true
cdir_events_dilemma_choice_details_localised_choice_label_att_subject_religious_hun_lightningFOURTH	Нічого не робити	true
cdir_events_dilemma_choice_details_localised_choice_label_slav_dilemma_venedians_1FIRST	Віддати їм данину	true
cdir_events_dilemma_choice_details_localised_choice_title_att_political_action_dilemma_gather_support_oppositionTHIRD	Це нас не стосується. У нас є важливіші справи.	true
cdir_events_dilemma_choice_details_localised_choice_title_att_subject_military_roman_master_hostile_governorSECOND	Надіслати розповсюджувачів чуток, щоб дискредитувати цього дурня.	true
cdir_events_dilemma_choice_details_localised_choice_title_att_dilemma_religious_catholic_religious_sanctions_1SECOND	Ми повинні прийняти закони, щоб обмежити права віросповідання цих єретиків.	true
cdir_events_dilemma_choice_details_localised_choice_label_cha_dilemma_saxon_1SECOND	Нічого не робити	true
cdir_events_dilemma_choice_details_localised_choice_label_att_subject_religious_barb_strangerSECOND	Отримати інформацію	true
cdir_events_dilemma_choice_details_localised_choice_label_slav_dilemma_venedians_1THIRD	Нічого їм не давати	true
cdir_events_dilemma_choice_details_localised_choice_label_att_dilemma_religious_christian_the_council_of_toledo_1FIRST	Голосувати за Прісциліана	true
cdir_events_dilemma_choice_details_localised_choice_title_att_political_action_dilemma_gather_support_oppositionFIRST	Ми повинні довести це до кінця, незалежно від ціни.	true
cdir_events_dilemma_choice_details_localised_choice_label_att_political_action_dilemma_adoption_added_incentiveSECOND	Наказ	true
cdir_events_dilemma_choice_details_localised_choice_label_ybor_level_A_burgundiFIRST	Чарівний меч	true
cdir_events_dilemma_choice_details_localised_choice_title_att_subject_domestic_civil_master_agitatorFOURTH	Нещастя юрби - їхня справа.	true
cdir_events_dilemma_choice_details_localised_choice_title_att_political_action_dilemma_seek_office_obstructionSECOND	Жодна людина не може ігнорувати наказ свого полководця.	true
cdir_events_dilemma_choice_details_localised_choice_title_att_subject_religious_barb_strangerFOURTH	У нас немає часу на ці дурниці.	true
cdir_events_dilemma_choice_details_localised_choice_label_att_subject_military_none_the_spy_1SECOND	Допитати його	true
cdir_events_dilemma_choice_details_localised_choice_label_ollam_ri_A1iSECOND	Вкрасти кубок.	true
cdir_events_dilemma_choice_details_localised_choice_title_att_dilemma_religious_orthodox_religious_sanctions_1SECOND	Ми повинні прийняти закони, щоб обмежити права віросповідання цих єретиків.	true
cdir_events_dilemma_choice_details_localised_choice_title_att_subject_religious_hun_lightningSECOND	Якщо Ви підтримаєте цю людину, він розповсюдить інформацію про Ваші злочини.	true
cdir_events_dilemma_choice_details_localised_choice_label_slav_dilemma_sclaveneans_1FIRST	Перейти в наступ	true
cdir_events_dilemma_choice_details_localised_choice_title_att_dilemma_religious_germanic_religious_sanctions_1SECOND	Ми повинні прийняти закони, щоб обмежити права цих язичників на поклоніння вперед.	true
cdir_events_dilemma_choice_details_localised_choice_title_att_political_action_dilemma_adoption_added_incentiveFOURTH	Він того не вартий.	true
cdir_events_dilemma_choice_details_localised_choice_label_att_subject_domestic_none_withholding_taxes_1SECOND	Надіслати війська	true
cdir_events_dilemma_choice_details_localised_choice_title_att_subject_politics_nomad_hostageSECOND	Хлопець може служити Вам так само добре, як заручник.	true
cdir_events_dilemma_choice_details_localised_choice_title_att_subject_politics_roman_hostageSECOND	Хлопець може служити Вам так само добре, як заручник.	true
cdir_events_dilemma_choice_details_localised_choice_label_att_subject_religious_hun_lightningFIRST	Усиновити людину	true
cdir_events_dilemma_choice_details_localised_choice_label_political_event_assassinationFIRST	Приготуватися	true
cdir_events_dilemma_choice_details_localised_choice_label_slav_dilemma_venedians_4THIRD	Нічого їм не давати	true
cdir_events_dilemma_choice_details_localised_choice_title_att_subject_domestic_none_the_festival_1THIRD	Ми повинні відзначати полководців і перемоги, які зробили нашу націю великою. Розкішна демонстрація влади нікому ще не шкодила!	true
cdir_events_dilemma_choice_details_localised_choice_label_att_subject_domestic_nordic_the_flyting_1THIRD	Доручити борцю	true
cdir_events_dilemma_choice_details_localised_choice_label_att_subject_religious_hun_lightningTHIRD	Убити його	true
cdir_events_dilemma_choice_details_localised_choice_label_att_subject_domestic_nomad_sword_of_attilaFOURTH	Нічого не робити	true
cdir_events_dilemma_choice_details_localised_choice_label_slav_dilemma_venedians_4FIRST	Віддати їм данину	true
cdir_events_dilemma_choice_details_localised_choice_title_att_subject_domestic_none_the_festival_1FIRST	Ви говорите про святкування в такий час? Справді? Не турбуйте мене знову з цього приводу знову.	true
cdir_events_dilemma_choice_details_localised_choice_label_att_subject_domestic_nordic_the_flyting_1FIRST	Ігнорувати проблему	true
cdir_events_dilemma_choice_details_localised_choice_title_ybor_level_A_burgundiSECOND	Священство каже, що вона дарує мудрість і захист Годана.	true
cdir_events_dilemma_choice_details_localised_choice_label_att_political_action_dilemma_seek_office_obstructionFIRST	Політичне сприяння	true
cdir_events_dilemma_choice_details_localised_choice_title_att_subject_religious_christian_the_money_lender_1FIRST	Ми закриємо очі на його поведінку з цього приводу. Він добре служив нам у всіх інших справах.	true
cdir_events_dilemma_choice_details_localised_choice_label_att_subject_domestic_nomad_sword_of_attilaSECOND	Відіслати його	true
cdir_events_dilemma_choice_details_localised_choice_title_att_dilemma_military_none_war_child_1SECOND	Ми не можемо доглядати за цією дитиною. Віддати його рабу.	true
cdir_events_dilemma_choice_details_localised_choice_title_slav_dilemma_venedians_3FIRST	Якщо вони хочуть просто грошей, це варто того, щоб уникнути різанини, яку вони б спричинили.	true
cdir_events_dilemma_choice_details_localised_choice_title_slav_dilemma_venedians_2THIRD	Ми не кланяємося, не гнемося. Нічого їм не посилати.	true
cdir_events_dilemma_choice_details_localised_choice_label_ollam_ri_A1iiSECOND	Вдарити його в обличчя.	true
cdir_events_dilemma_choice_details_localised_choice_title_att_subject_politics_nomad_hostageFOURTH	Це дрібниця, якою можуть зайнятися інші.	true
cdir_events_dilemma_choice_details_localised_choice_title_att_subject_politics_roman_hostageFOURTH	Це дрібниця, якою можуть зайнятися інші.	true
cdir_events_dilemma_choice_details_localised_choice_title_ollam_ri_A1SECOND	Це кіт. Він має шанувати його!	true
cdir_events_dilemma_choice_details_localised_choice_title_ollam_ri_A2SECOND	Легендарний король стане могутнім союзником.	true
cdir_events_dilemma_choice_details_localised_choice_title_ollam_ri_A3SECOND	Вона може багато чому навчити Рі.	true
cdir_events_dilemma_choice_details_localised_choice_title_ollam_ri_B1SECOND	Якби шкіра мала силу, вони б уже використали її.	true
cdir_events_dilemma_choice_details_localised_choice_title_ollam_ri_B2SECOND	Можливо, таким чином він зможе загладити свою кривду.	true
cdir_events_dilemma_choice_details_localised_choice_label_att_political_action_dilemma_seek_office_obstructionTHIRD	Забути це	true
cdir_events_dilemma_choice_details_localised_choice_title_att_subject_religious_christian_the_money_lender_1THIRD	Явно нечесний і брехун, цей чоловік заслуговує лише смерті.	true
cdir_events_dilemma_choice_details_localised_choice_label_att_subject_domestic_barb_nomad_enemy_tradeFIRST	Стратити його	true
cdir_events_dilemma_choice_details_localised_choice_label_att_subject_domestic_barb_nomad_stolen_swordSECOND	Вирішити суперечку	true
cdir_events_dilemma_choice_details_localised_choice_title_slav_dilemma_venedians_2FIRST	Якщо вони хочуть просто грошей, це варто того, щоб уникнути різанини, яку вони б спричинили.	true
cdir_events_dilemma_choice_details_localised_choice_title_slav_dilemma_venedians_3THIRD	Ми не кланяємось, не гнемося. Нічого їм не посилати.	true
cdir_events_dilemma_choice_details_localised_choice_label_att_dilemma_domestic_roman_saint_telemachus_1SECOND	Ув'язнити протестувальників	true
cdir_events_dilemma_choice_details_localised_choice_label_att_subject_military_none_the_spy_1FOURTH	Завербувати його	true
cdir_events_dilemma_choice_details_localised_choice_label_att_eos_religious_event_rebellion_att_fact_axum_att_rel_church_eastSECOND	Купити його	true
cdir_events_dilemma_choice_details_localised_choice_title_att_subject_religious_hun_lightningFOURTH	Це ж якісь селяни придумали, відпустити чоловіка в дорогу.	true
cdir_events_dilemma_choice_details_localised_choice_title_att_political_action_dilemma_adoption_added_incentiveSECOND	Якщо його володар забажає, у нього не буде іншого вибору, як підкоритися!	true
cdir_events_dilemma_choice_details_localised_choice_title_slav_dilemma_venedians_1FIRST	Якщо вони хочуть просто грошей, це варто того, щоб уникнути різанини, яку вони б спричинили.	true
cdir_events_dilemma_choice_details_localised_choice_label_att_political_action_dilemma_gather_support_oppositionFIRST	Всі засоби гарні	true
cdir_events_dilemma_choice_details_localised_choice_title_att_subject_domestic_civil_master_agitatorSECOND	Дати деяким, привілейованим, громадянам податкові пільги, що має заспокоїти маси.	true
cdir_events_dilemma_choice_details_localised_choice_title_att_subject_religious_barb_strangerSECOND	Меч у спину - переконливий привід вирушити в подорож.	true
cdir_events_dilemma_choice_details_localised_choice_label_att_eos_religious_event_rebellion_att_fact_himyar_att_rel_semitic_paganismSECOND	Купити його	true
cdir_events_dilemma_choice_details_localised_choice_title_cha_dilemma_saxon_1SECOND	Залиште собі свого Бога і дрібні обіцянки! Мої люди житимуть на землі і в ній, куди Ви їх відправите.	true
cdir_events_dilemma_choice_details_localised_choice_title_slav_dilemma_venedians_1THIRD	Ми не кланяємося, не гнемося. Нічого їм не посилати.	true
cdir_events_dilemma_choice_details_localised_choice_label_att_political_action_dilemma_gather_support_oppositionTHIRD	Забути це	true
cdir_events_dilemma_choice_details_localised_choice_title_att_eos_religious_event_rebellion_att_fact_axum_att_rel_church_eastFIRST	У нас немає ні часу, ні грошей на цих єретиків, щоб реагувати на їхні порожні погрози.	true
cdir_events_dilemma_choice_details_localised_choice_title_att_subject_military_roman_master_hostile_governorFOURTH	Чи буде натовп слухати його отруйну брехню? Сумнівно.	true
cdir_events_dilemma_choice_details_localised_choice_title_slav_dilemma_sclaveneans_1FIRST	Склавини не тікають від бою і не чекають на нього. Ми атакуємо!	true
cdir_events_dilemma_choice_details_localised_choice_label_att_subject_religious_barb_strangerFOURTH	Нічого не робити	true
cdir_events_dilemma_choice_details_localised_choice_title_att_subject_domestic_none_withholding_taxes_1SECOND	Давайте надішлемо кілька солдатів, щоб забрати те, що належить нам по праву. Вбийте всіх, хто чинить опір.	true
cdir_events_dilemma_choice_details_localised_choice_label_att_political_action_dilemma_adoption_added_incentiveFOURTH	Забути це	true
cdir_events_dilemma_choice_details_localised_choice_label_att_subject_diplomatic_none_the_feast_1FIRST	Ігнорувати запит	true
cdir_events_dilemma_choice_details_localised_choice_label_att_subject_domestic_nomadic_the_kassai_contest_1FIRST	Ігнорувати проблему	true
cdir_events_dilemma_choice_details_localised_choice_title_att_subject_politics_civil_secret_meetingsFOURTH	Тримайте своїх ворогів поруч, призначайте їм позиції у Вашому режимі.	true
cdir_events_dilemma_choice_details_localised_choice_title_att_subject_military_none_the_spy_1SECOND	У нього є інформація про наших ворогів, ми повинні дізнатися, що він знає.	true
cdir_events_dilemma_choice_details_localised_choice_title_att_dilemma_religious_tengri_religious_sanctions_1SECOND	Ми повинні прийняти закони, щоб обмежити права цих язичників на поклоніння вперед.	true
cdir_events_dilemma_choice_details_localised_choice_label_att_subject_domestic_none_foreign_migrants_1SECOND	Змусити їх піти	true
cdir_events_dilemma_choice_details_localised_choice_label_att_dilemma_religious_hellenic_religious_sanctions_1SECOND	Накласти санкції	true
cdir_events_dilemma_choice_details_localised_choice_label_att_subject_religious_hun_lightningSECOND	Стань його протектором	true
cdir_events_dilemma_choice_details_localised_choice_label_att_subject_diplomatic_none_the_feast_1THIRD	Запросити наших союзників	true
cdir_events_dilemma_choice_details_localised_choice_title_att_eos_sassanid_insult_1FIRST	Ризикуєте викликати гнів Шаханшаха, зіткнувшись з ним безпосередньо.	true
cdir_events_dilemma_choice_details_localised_choice_label_att_subject_domestic_nomadic_the_kassai_contest_1THIRD	Спонсорувати його участь	true
cdir_events_dilemma_choice_details_localised_choice_label_ybor_level_A_alamanniFIRST	Чарівний меч	true
cdir_events_dilemma_choice_details_localised_choice_title_att_subject_politics_rome_corruptionFOURTH	Рим виживав протягом століть, коли Сенат працював, як є.	true
cdir_events_dilemma_choice_details_localised_choice_title_slav_dilemma_venedians_4THIRD	Ми не кланяємось, не гнемося. Нічого їм не посилати.	true
cdir_events_dilemma_choice_details_localised_choice_label_ybor_level_A_burgundiSECOND	Брошка	true
cdir_events_dilemma_choice_details_localised_choice_title_att_eos_sassanid_insult_2FIRST	З Вами так не розмовляють, виженіть його геть, і будуть прокляті наслідки!	true
cdir_events_dilemma_choice_details_localised_choice_label_att_subject_domestic_none_the_festival_1THIRD	Військові перемоги	true
cdir_events_dilemma_choice_details_localised_choice_title_att_subject_politics_civil_hostageFOURTH	Це дрібниця, якою можуть зайнятися інші.	true
cdir_events_dilemma_choice_details_localised_choice_title_att_subject_military_nomad_master_swordsmithSECOND	Вихваляння низів не повинно залишатися безкарним.	true
cdir_events_dilemma_choice_details_localised_choice_title_att_subject_military_none_drunk_on_watch_1SECOND	З нього треба брати приклад. Для всіх.	true
cdir_events_dilemma_choice_details_localised_choice_title_slav_dilemma_venedians_4FIRST	Якщо вони хочуть просто грошей, це варто того, щоб уникнути різанини, яку вони б спричинили.	true
cdir_events_dilemma_choice_details_localised_choice_title_att_eos_sassanid_insult_3FIRST	Скажіть йому, що Ви розумієте його точку зору, але не стали б королем, якби не захистили своїх підданих.	true
cdir_events_dilemma_choice_details_localised_choice_label_att_subject_domestic_none_the_festival_1FIRST	Ігнорувати проблему	true
cdir_events_dilemma_choice_details_localised_choice_title_att_subject_domestic_barb_nomad_enemy_tradeSECOND	Подати приклад цьому дурню.	true
cdir_events_dilemma_choice_details_localised_choice_title_political_event_ministerial_positionSECOND	Дозволити продовжити його просування. Давайте подивимося, як хлопець впорається з новою роллю.	true
cdir_events_dilemma_choice_details_localised_choice_label_att_subject_religious_none_the_holy_site_1FIRST	Ігнорувати проблему	true
cdir_events_dilemma_choice_details_localised_choice_label_att_subject_religious_none_the_relic_seller_1SECOND	Взяти хабар	true
cdir_events_dilemma_choice_details_localised_choice_label_att_subject_religious_tengri_illegal_practice_1FIRST	Стратити його	true
cdir_events_dilemma_choice_details_localised_choice_title_att_subject_domestic_eastern_the_chovgan_tourney_1SECOND	Ця людина надто важлива для нашої стратегії, щоб програти, якщо щось піде не так.	true
cdir_events_dilemma_choice_details_localised_choice_title_cha_dilemma_verdenSECOND	Зберіть своїх лідерів, вони приймуть Бога.	true
cdir_events_dilemma_choice_details_localised_choice_title_ollam_ri_ASECOND	Що ще за зброя - це кубок чи інструмент?	true
cdir_events_dilemma_choice_details_localised_choice_title_ollam_ri_BSECOND	Справді? Свиня? Вони заслуговують на смерть лише за цю брехню.	true
cdir_events_dilemma_choice_details_localised_choice_title_att_dilemma_religious_christian_council_of_ephesus_1SECOND	Несторію слід дозволити його точку зору, навіть якщо вона відрізняється від точки зору Папи.	true
cdir_events_dilemma_choice_details_localised_choice_label_att_subject_religious_none_the_holy_site_1THIRD	Взяти платню за вхід	true
cdir_events_dilemma_choice_details_localised_choice_title_political_event_assassinationSECOND	Більше чуток? Як нудно!	true
cdir_events_dilemma_choice_details_localised_choice_label_att_subject_military_none_the_gift_of_speed_1SECOND	Припнути коней	true
cdir_events_dilemma_choice_details_localised_choice_title_att_dilemma_religious_arian_religious_sanctions_1FIRST	Усі люди в наших очах рівні. До аріян треба ставитися так само, як до всіх інших.	true
cdir_events_dilemma_choice_details_localised_choice_label_att_subject_religious_tengri_illegal_practice_1THIRD	Залишити його у в'язниці	true
cdir_events_dilemma_choice_details_localised_choice_title_att_subject_domestic_barb_temple_sacrilegeFOURTH	Якщо боги вимагають покарання, вони подбають про це самі.	true
cdir_events_dilemma_choice_details_localised_choice_title_att_subject_religious_christian_the_money_lender_1SECOND	Він згрішив перед Богом, але не перед державою. Нехай Церква з ним розбирається.	true
cdir_events_dilemma_choice_details_localised_choice_label_att_bel_request_justinian_narses_1SECOND	Відсторонити його	true
cdir_events_dilemma_choice_details_localised_choice_label_att_bel_request_theodosia_ioannina_1SECOND	Убити Анастасія	true
cdir_events_dilemma_choice_details_localised_choice_label_att_subject_religious_hellenic_pilgrims_1THIRD	Дозволити їм	true
cdir_events_dilemma_choice_details_localised_choice_title_att_subject_religious_hellenic_illegal_practice_1THIRD	Його боги фальшиві. Нехай думає над цим, поки гниє у в'язниці!	true
cdir_events_dilemma_choice_details_localised_choice_title_att_political_action_dilemma_assassinate_suspiciousSECOND	Неможливо. У той час вони були... у королівських справах!	true
cdir_events_dilemma_choice_details_localised_choice_label_slav_dilemma_sclaveneans_1SECOND	Підготувати нашу оборону	true
cdir_events_dilemma_choice_details_localised_choice_title_political_event_marriage_maleFIRST	Це поганий союз. Ми не можемо допустити, щоб шлюб тривав.	true
cdir_events_dilemma_choice_details_localised_choice_label_att_subject_religious_hellenic_pilgrims_1FIRST	Ігнорувати їх	true
cdir_events_dilemma_choice_details_localised_choice_title_att_subject_religious_hellenic_illegal_practice_1FIRST	Убити цього язичника як приклад для інших.	true
cdir_events_dilemma_choice_details_localised_choice_label_att_eos_marib_dam_repair_0SECOND	Дрібний ремонт	true
cdir_events_dilemma_choice_details_localised_choice_label_att_eos_marib_dam_repair_1SECOND	Дрібний ремонт	true
cdir_events_dilemma_choice_details_localised_choice_label_att_eos_marib_dam_repair_2SECOND	Дрібний ремонт	true
cdir_events_dilemma_choice_details_localised_choice_label_att_eos_marib_dam_repair_3SECOND	Дрібний ремонт	true
cdir_events_dilemma_choice_details_localised_choice_title_ollam_ri_A1iiFIRST	Рі не відступає ні перед людиною, ні перед твариною.	true
cdir_events_dilemma_choice_details_localised_choice_label_att_dilemma_religious_celtic_religious_sanctions_1FIRST	Дати їм рівні права	true
cdir_events_dilemma_choice_details_localised_choice_label_att_subject_military_nomad_master_swordsmithFIRST	Поневолити його	true
cdir_events_dilemma_choice_details_localised_choice_title_att_subject_religious_none_the_true_cross_1SECOND	Ми могли б виставити цей артефакт у Церкві, люди приходили здалеку, щоб побачити його.	true
cdir_events_dilemma_choice_details_localised_choice_label_att_subject_religious_barb_bloodlessFOURTH	Нічого не робити	true
cdir_events_dilemma_choice_details_localised_choice_title_cha_dilemma_lombard_pope_demands_2FOURTH	Навіть якби Карл Великий підтримував Папу, моя відповідь все одно була б ні. Хто вони такі, щоб сміти керувати долею лангобардів?	true
cdir_events_dilemma_choice_details_localised_choice_label_att_bel_request_justinian_narses_1FIRST	Просувати його	true
cdir_events_dilemma_choice_details_localised_choice_label_att_subject_religious_christian_pontifex_maximus_1FIRST	Чекати на результат	true
cdir_events_dilemma_choice_details_localised_choice_title_att_subject_diplomatic_none_diplomatic_dispute_1FIRST	Я впевнений, що це була лише випивка. Зрештою, ми всі іноді схильні до такої нерозсудливості.	true
cdir_events_dilemma_choice_details_localised_choice_label_att_subject_religious_christian_the_black_sheep_1THIRD	Відлучити диякона	true
cdir_events_dilemma_choice_details_localised_choice_label_att_subject_domestic_civil_hostile_disputeSECOND	Відіслати його геть	true
cdir_events_dilemma_choice_details_localised_choice_label_att_subject_military_nomad_master_swordsmithTHIRD	Звільнити його	true
cdir_events_dilemma_choice_details_localised_choice_title_att_subject_religious_zoroastrian_illegal_practice_1SECOND	Ми толерантні до релігійних уподобань інших. Відпустити його.	true
cdir_events_dilemma_choice_details_localised_choice_label_att_subject_religious_christian_pontifex_maximus_1THIRD	Зняти кандидата	true
cdir_events_dilemma_choice_details_localised_choice_label_att_bel_request_antoninia_thedosius_1SECOND	Відмовитися	true
cdir_events_dilemma_choice_details_localised_choice_label_att_bel_request_theodosia_pope_1FIRST	Скинути його	true
cdir_events_dilemma_choice_details_localised_choice_title_att_subject_diplomatic_none_diplomatic_dispute_1THIRD	Зачинити цього ідіота, де ми його не побачимо, і його язик більше не зашкодить.	true
cdir_events_dilemma_choice_details_localised_choice_label_att_subject_religious_christian_the_black_sheep_1FIRST	Ігнорувати її провину	true
cdir_events_dilemma_choice_details_localised_choice_title_att_subject_religious_zoroastrian_pilgrims_1SECOND	Розігнати сектантів. Убити всіх, хто наважиться залишитися на вершині гори на світанку.	true
cdir_events_dilemma_choice_details_localised_choice_label_cha_dilemma_mercia_1SECOND	Вимагати, щоб він залишився	true
cdir_events_dilemma_choice_details_localised_choice_title_att_political_action_dilemma_secure_loyalty_briberySECOND	Можливо, якась дрібниця дозволить йому побачити речі по-нашому?	true
cdir_events_dilemma_choice_details_localised_choice_title_att_subject_religious_tengri_pilgrims_1THIRD	Це місце для цих людей є святим, як би примітивним це не здавалося. Хто ми такі, щоб стояти їм на шляху?	true
cdir_events_dilemma_choice_details_localised_choice_label_att_subject_domestic_all_stone_masonSECOND	Відіслати його	true
cdir_events_dilemma_choice_details_localised_choice_label_att_subject_politics_barb_nomad_challengerSECOND	Заткнути його	true
cdir_events_dilemma_choice_details_localised_choice_label_att_subject_domestic_none_excess_materials_1SECOND	Використати їх	true
cdir_events_dilemma_choice_details_localised_choice_title_att_subject_military_none_the_gift_of_speed_1FOURTH	Ці коні явно варті певних грошей.	true
cdir_events_dilemma_choice_details_localised_choice_title_att_subject_religious_tengri_pilgrims_1FIRST	Їхні справи не стосуються нас.	true
cdir_events_dilemma_choice_details_localised_choice_label_att_subject_domestic_barb_nomad_enemy_tradeSECOND	Покарати його	true
cdir_events_dilemma_choice_details_localised_choice_label_att_subject_diplomatic_none_border_dispute_1SECOND	Повернути землю силою	true
cdir_events_dilemma_choice_details_localised_choice_label_att_subject_domestic_all_stone_masonFOURTH	Нічого не робити	true
cdir_events_dilemma_choice_details_localised_choice_title_att_political_action_dilemma_embezzlement_suspiciousSECOND	Неможливо. У той час вони були... у королівських справах!	true
cdir_events_dilemma_choice_details_localised_choice_label_att_subject_politics_barb_nomad_challengerFOURTH	Найняти його	true
cdir_events_dilemma_choice_details_localised_choice_title_att_subject_religious_none_the_holy_site_1THIRD	Чому б не стягнути з цих прочан плату за вхід на це місце? Де твій меркантильний дух?	true
cdir_events_dilemma_choice_details_localised_choice_label_political_event_assassinationSECOND	Ігнорувати	true
cdir_events_dilemma_choice_details_localised_choice_label_cha_dilemma_pope_help_1FIRST	На боці Папи	true
cdir_events_dilemma_choice_details_localised_choice_label_att_subject_military_none_the_lanista_1THIRD	Завербувати його	true
cdir_events_dilemma_choice_details_localised_choice_title_att_subject_military_none_the_gift_of_speed_1SECOND	Нехай дадуть поріддя . Вони ще можуть принести багатство.	true
cdir_events_dilemma_choice_details_localised_choice_title_att_subject_religious_none_the_holy_site_1FIRST	Розбирайся сам, старий.	true
cdir_events_dilemma_choice_details_localised_choice_title_att_subject_religious_none_the_relic_seller_1SECOND	Очевидно, він просто торговець, який намагається вижити. Його підприємницький дух заслуговує на оплески!	true
cdir_events_dilemma_choice_details_localised_choice_label_att_subject_military_none_the_lanista_1FIRST	Ігнорувати його	true
cdir_events_dilemma_choice_details_localised_choice_label_att_subject_domestic_civil_hostile_disputeFOURTH	Нічого не робити	true
cdir_events_dilemma_choice_details_localised_choice_title_att_subject_politics_civil_challengerFIRST	Якщо публіка задоволена, то Вам буде легше жити.	true
cdir_events_dilemma_choice_details_localised_choice_title_cha_dilemma_charlemagne_daughter_1SECOND	Хто з нас не гуляв пізньої ночі з друзями?	true
cdir_events_dilemma_choice_details_localised_choice_title_cha_dilemma_viking_1_cha_fact_merciaSECOND	Ці родючі землі дійсно пропонують багатообіцяюче майбутнє для нашого народу, я впевнений, що ми зможемо знайти інші землі, щоб грабувати.	true
cdir_events_dilemma_choice_details_localised_choice_label_att_subject_religious_germanic_illegal_practice_1THIRD	Залишити його у в'язниці	true
cdir_events_dilemma_choice_details_localised_choice_title_att_subject_religious_germanic_pilgrims_1THIRD	Їхні святі місця є священними. Якої шкоди може бути, якщо залишити їх?	true
cdir_events_dilemma_choice_details_localised_choice_title_att_subject_military_none_mercenary_commander_1THIRD	Додаткові війська в потребі. Можливо, ми домовимося про взаємовигідну угоду?	true
cdir_events_dilemma_choice_details_localised_choice_label_att_subject_religious_orthodox_illegal_practice_1THIRD	Залишити його у в'язниці	true
cdir_events_dilemma_choice_details_localised_choice_title_att_subject_religious_none_the_golden_tongued_1FIRST	Він потрібен для духовного керівництва місцевими жителями. Залишити його там, де він є.	true
cdir_events_dilemma_choice_details_localised_choice_title_att_subject_religious_celtic_pilgrims_1THIRD	Це місце для них священне, хто ми такі, щоб стояти їм на шляху?	true
cdir_events_dilemma_choice_details_localised_choice_label_att_eos_marib_dam_repair_0FOURTH	Повний ремонт	true
cdir_events_dilemma_choice_details_localised_choice_label_att_eos_marib_dam_repair_1FOURTH	Повний ремонт	true
cdir_events_dilemma_choice_details_localised_choice_label_att_eos_marib_dam_repair_2FOURTH	Повний ремонт	true
cdir_events_dilemma_choice_details_localised_choice_label_att_eos_marib_dam_repair_3FOURTH	Повний ремонт	true
cdir_events_dilemma_choice_details_localised_choice_title_att_subject_politics_civil_challengerTHIRD	Заставити замовкнути його назавжди.	true
cdir_events_dilemma_choice_details_localised_choice_label_att_political_action_dilemma_assassinate_suspiciousSECOND	Потужне алібі	true
cdir_events_dilemma_choice_details_localised_choice_label_att_subject_religious_barb_bloodlessSECOND	Принести в жертву людину	true
cdir_events_dilemma_choice_details_localised_choice_title_cha_dilemma_lombard_pope_demands_1SECOND	Я не буду перекроювати свої кордони, щоб зберегти угоду, укладену між людьми, давно мертвими!	true
cdir_events_dilemma_choice_details_localised_choice_title_cha_dilemma_lombard_pope_demands_2SECOND	Наші землі для мене цінніші за будь-яку суму золота. Зробити Папі пропозицію, від якої він не зможе відмовитися, і вся ця справа вирішиться сама собою.	true
cdir_events_dilemma_choice_details_localised_choice_title_cha_dilemma_lombard_pope_demands_3SECOND	З мечем у руці — і кожною фіброю свого єства — я клянуся, що ці землі залишаться частиною території Ломбардії.	true
cdir_events_dilemma_choice_details_localised_choice_label_att_political_action_dilemma_diminish_popularity_followup_mercifulSECOND	Засудити	true
cdir_events_dilemma_choice_details_localised_choice_label_att_subject_religious_germanic_illegal_practice_1FIRST	Стратити його	true
cdir_events_dilemma_choice_details_localised_choice_title_att_subject_religious_germanic_pilgrims_1FIRST	Їхні справи не стосуються нас.	true
cdir_events_dilemma_choice_details_localised_choice_title_att_subject_military_none_mercenary_commander_1FIRST	Зараз нам не потрібна допомога найманців.	true
cdir_events_dilemma_choice_details_localised_choice_label_att_dilemma_religious_manichaeism_religious_sanctions_1FIRST	Дати їм рівні права	true
cdir_events_dilemma_choice_details_localised_choice_label_att_subject_religious_orthodox_illegal_practice_1FIRST	Стратити його	true
cdir_events_dilemma_choice_details_localised_choice_title_att_subject_religious_none_the_golden_tongued_1THIRD	Тому, хто настільки вміє розповсюджувати інформацію, слід дозволити продовжувати. Нехай він продовжує свою добру справу деінде на наших землях.	true
cdir_events_dilemma_choice_details_localised_choice_title_att_subject_religious_celtic_pilgrims_1FIRST	Їхні справи нас не стосуються, якщо вони не стосуються війни проти нас!	true
cdir_events_dilemma_choice_details_localised_choice_title_att_subject_military_nomad_master_swordsmithFIRST	Давайте подивимося, що може запропонувати цей прибулець із чужих країн.	true
cdir_events_dilemma_choice_details_localised_choice_title_att_subject_religious_manichaeism_pilgrims_1SECOND	Розігнати сектантів. Убити всіх, хто наважиться залишитися на світанку.	true
cdir_events_dilemma_choice_details_localised_choice_label_att_subject_religious_none_the_holy_site_1SECOND	Купити землю	true
cdir_events_dilemma_choice_details_localised_choice_title_att_subject_religious_christian_pontifex_maximus_1THIRD	Ми не хочемо, щоб він став Папою на даний момент.	true
cdir_events_dilemma_choice_details_localised_choice_label_att_subject_religious_none_the_true_cross_1SECOND	Купити реліквію	true
cdir_events_dilemma_choice_details_localised_choice_label_att_subject_religious_christian_candidate_for_bishopSECOND	Підкупити кардиналів	true
cdir_events_dilemma_choice_details_localised_choice_label_att_subject_religious_catholic_illegal_practice_1THIRD	Залишити його у в'язниці	true
cdir_events_dilemma_choice_details_localised_choice_title_att_subject_religious_catholic_pilgrims_1THIRD	Хто ми такі, щоб кидати виклик переконанням інших?	true
cdir_events_dilemma_choice_details_localised_choice_title_att_bel_request_antoninia_thedosius_1SECOND	Я вже усиновив одного з Ваших байстрюків, досить!	true
cdir_events_dilemma_choice_details_localised_choice_label_att_subject_diplomatic_none_diplomatic_dispute_1FIRST	Ігнорувати незначне	true
cdir_events_dilemma_choice_details_localised_choice_label_att_subject_religious_celtic_illegal_practice_1FIRST	Страти її	true
cdir_events_dilemma_choice_details_localised_choice_title_att_dilemma_religious_celtic_religious_sanctions_1FIRST	Усі люди в наших очах рівні. До язичників треба ставитися так само, як до всіх інших.	true
cdir_events_dilemma_choice_details_localised_choice_title_att_subject_military_nomad_master_swordsmithTHIRD	Вільна людина, безумовно, створить кращий твір, ніж людина, зв’язана й закута?	true
cdir_events_dilemma_choice_details_localised_choice_title_att_subject_domestic_barb_temple_sacrilegeSECOND	Нехай Юпітер вирішить його долю.	true
cdir_events_dilemma_choice_details_localised_choice_title_att_bel_request_justinian_narses_1FIRST	Кожен чоловік, який заслужив твою довіру, заслужив і мою.	true
cdir_events_dilemma_choice_details_localised_choice_title_att_subject_religious_christian_pontifex_maximus_1FIRST	Ми не повинні втручатися у внутрішню роботу Церкви.	true
cdir_events_dilemma_choice_details_localised_choice_label_att_subject_religious_catholic_illegal_practice_1FIRST	Стратити його	true
cdir_events_dilemma_choice_details_localised_choice_title_att_subject_religious_catholic_pilgrims_1FIRST	Їхні справи не стосуються нас.	true
cdir_events_dilemma_choice_details_localised_choice_label_att_subject_diplomatic_none_diplomatic_dispute_1THIRD	Ув'язнити його	true
cdir_events_dilemma_choice_details_localised_choice_title_att_bel_request_theodosia_pope_1FIRST	Влада на душами переважає людські земні потреби - я буду діяти.	true
cdir_events_dilemma_choice_details_localised_choice_label_att_subject_religious_celtic_illegal_practice_1THIRD	Залишити її у в'язниці	true
cdir_events_dilemma_choice_details_localised_choice_label_att_subject_religious_barb_strangerTHIRD	Торгувати з ним	true
cdir_events_dilemma_choice_details_localised_choice_title_cha_dilemma_verdenFOURTH	Не можна терпіти цих язичників. Знищити їх, щоб у Саксонії правив лише Бог.	true
cdir_events_dilemma_choice_details_localised_choice_label_att_subject_domestic_civil_idiot_magistrateTHIRD	Убити суддю	true
cdir_events_dilemma_choice_details_localised_choice_label_att_political_action_dilemma_secure_loyalty_briberySECOND	Невеликий хабар	true
cdir_events_dilemma_choice_details_localised_choice_label_att_subject_religious_christian_pontifex_maximus_1SECOND	Змастити колеса	true
cdir_events_dilemma_choice_details_localised_choice_label_att_bel_request_theodosia_amalasuntha_1FIRST	Відхилити вхідну місію	true
cdir_events_dilemma_choice_details_localised_choice_label_att_subject_military_none_the_gift_of_speed_1FOURTH	Продати їх	true
cdir_events_dilemma_choice_details_localised_choice_label_att_subject_religious_barb_strangerFIRST	Заплатити чоловікові	true
cdir_events_dilemma_choice_details_localised_choice_label_att_subject_domestic_civil_idiot_magistrateFIRST	Прийняти переможця	true
cdir_events_dilemma_choice_details_localised_choice_title_att_subject_religious_manichaeism_illegal_practice_1SECOND	Ми толерантні до релігійних уподобань інших. Відпустити його.	true
cdir_events_dilemma_choice_details_localised_choice_title_att_dilemma_religious_zoroastrian_religious_sanctions_1FIRST	У наших очах усі люди рівні. До зороастрійців слід ставитися так само, як до всіх інших.	true
cdir_events_dilemma_choice_details_localised_choice_label_att_subject_domestic_eastern_the_chovgan_tourney_1SECOND	Відкликати його	true
cdir_events_dilemma_choice_details_localised_choice_label_att_subject_religious_zoroastrian_pilgrims_1SECOND	Заборонити	true
cdir_events_dilemma_choice_details_localised_choice_title_cha_dilemma_mercia_1SECOND	Поставте людей біля його дверей - він не повинен піти ні за яких умов!	true
cdir_events_dilemma_choice_details_localised_choice_label_ollam_ri_ASECOND	Ріг.	true
cdir_events_dilemma_choice_details_localised_choice_label_ollam_ri_BSECOND	Убити їх.	true
cdir_events_dilemma_choice_details_localised_choice_label_cha_dilemma_verdenSECOND	Навертайте своїх лідерів	true
cdir_events_dilemma_choice_details_localised_choice_title_att_subject_religious_tengri_illegal_practice_1THIRD	Я сумніваюся, що щось може змінити думку цього простого дурня. Нехай гниє в підземеллях.	true
cdir_events_dilemma_choice_details_localised_choice_title_att_subject_domestic_all_stone_masonSECOND	Ми не потребуємо «чужої» допомоги.	true
cdir_events_dilemma_choice_details_localised_choice_title_att_subject_domestic_none_excess_materials_1SECOND	Використати матеріали для майбутніх будівельних проектів. Не марнуйте залишки.	true
cdir_events_dilemma_choice_details_localised_choice_label_political_event_marriage_maleSECOND	Дати благословіння	true
cdir_events_dilemma_choice_details_localised_choice_title_att_dilemma_domestic_none_plentiful_harvest_1SECOND	Ми повинні зберегти його на той час, коли він нам найбільше знадобиться.	true
cdir_events_dilemma_choice_details_localised_choice_title_att_dilemma_religious_zoroastrian_the_manichean_heresy_1FIRST	Маніхеї є загрозою. Ми повинні з усією швидкістю вигнати їх з наших земель!	true
cdir_events_dilemma_choice_details_localised_choice_title_att_subject_religious_tengri_illegal_practice_1FIRST	Убити цього примітивного кретина публічно найповільнішим способом, який є в нашому розпорядженні.	true
cdir_events_dilemma_choice_details_localised_choice_title_att_subject_politics_rome_corruptionTHIRD	Давайте послухаємо, що скажуть люди та сенатори.	true
cdir_events_dilemma_choice_details_localised_choice_title_att_subject_military_none_drunk_on_watch_1FIRST	Нам потрібно тримати людей на стороні, давайте провчимо його, але більше нічого.	true
cdir_events_dilemma_choice_details_localised_choice_label_ollam_ri_A1iiFIRST	Ви продовжуєте дивитися.	true
cdir_events_dilemma_choice_details_localised_choice_title_slav_dilemma_sclaveneans_1SECOND	Їх зброя та лють марні проти нашої рішучості. Нехай приходять!	true
cdir_events_dilemma_choice_details_localised_choice_title_att_subject_nomadic_tribal_strife_1SECOND	Тільки сила може вирішити, хто правий.	true
cdir_events_dilemma_choice_details_localised_choice_title_att_subject_domestic_all_stone_masonTHIRD	Я не довіряю цій людині, щось у ньому є...	true
cdir_events_dilemma_choice_details_localised_choice_label_att_bel_request_antoninia_rumours_1SECOND	Убити його	true
cdir_events_dilemma_choice_details_localised_choice_title_att_subject_religious_barb_bloodlessFOURTH	Ми нічого не можемо зробити, щоб це виправити.	true
cdir_events_dilemma_choice_details_localised_choice_title_att_subject_religious_christian_the_black_sheep_1THIRD	Мабуть, він знав про переконання своєї сестри. Звільнити його з посади і покарати її відповідним чином.	true
cdir_events_dilemma_choice_details_localised_choice_label_att_subject_domestic_barb_temple_sacrilegeFOURTH	Нічого не робити	true
cdir_events_dilemma_choice_details_localised_choice_label_att_subject_religious_christian_the_money_lender_1SECOND	Видати його	true
cdir_events_dilemma_choice_details_localised_choice_title_att_subject_politics_rome_corruptionFIRST	Вигнати сенаторів, які не служать Риму.	true
cdir_events_dilemma_choice_details_localised_choice_title_att_subject_military_none_drunk_on_watch_1THIRD	Нехай кожні десять чоловік витягнуть соломинку, той, хто витягне найкоротшу, буде вбитий своїми товаришами.	true
cdir_events_dilemma_choice_details_localised_choice_label_att_subject_religious_zoroastrian_illegal_practice_1SECOND	Звільнити його	true
cdir_events_dilemma_choice_details_localised_choice_title_att_subject_domestic_all_stone_masonFIRST	Подумайте про всі могутні споруди, які Ви могли б залишити собі на згадку з цією людиною у Вас на службі.	true
cdir_events_dilemma_choice_details_localised_choice_title_att_bel_request_justinian_narses_1SECOND	Вибачте, але моє завдання настільки дорогоцінне, що я не довірю його нікому іншому.	true
cdir_events_dilemma_choice_details_localised_choice_title_att_bel_request_justinian_photius_1SECOND	Моя дружина лише підтримує мою службу, я не можу жити без неї.	true
cdir_events_dilemma_choice_details_localised_choice_title_att_dilemma_religious_christian_conference_of_carthage_1FIRST	Церква Риму є єдиною істинною вірою, ці люди є єретиками.	true
cdir_events_dilemma_choice_details_localised_choice_title_att_subject_religious_christian_the_black_sheep_1FIRST	Ми закриємо очі на її шанування старовини. Це нікому не шкодить.	true
cdir_events_dilemma_choice_details_localised_choice_title_att_subject_domestic_civil_hostile_disputeSECOND	Вигнати його звідси, публіка скоро забуде.	true
cdir_events_dilemma_choice_details_localised_choice_title_att_bel_request_theodosia_ioannina_1SECOND	Ви більше не будете чинити свою тиранію над моєю родиною. Я зроблю так, як хочу.	true
cdir_events_dilemma_choice_details_localised_choice_label_att_subject_religious_barb_bloodlessTHIRD	Спалити барана	true
cdir_events_dilemma_choice_details_localised_choice_label_att_subject_religious_hellenic_illegal_practice_1THIRD	Залишити його у в'язниці	true
cdir_events_dilemma_choice_details_localised_choice_title_att_subject_religious_hellenic_pilgrims_1THIRD	Це місце для них священне, хто ми такі, щоб стояти їм на шляху?	true
cdir_events_dilemma_choice_details_localised_choice_title_att_eos_marib_dam_repair_0SECOND	Надіслати невелику робочу силу, щоб зробити те, що вони можуть, цього має бути достатньо.	true
cdir_events_dilemma_choice_details_localised_choice_title_att_eos_marib_dam_repair_1SECOND	Надіслати невелику робочу силу, щоб зробити те, що вони можуть, цього має бути достатньо.	true
cdir_events_dilemma_choice_details_localised_choice_title_att_eos_marib_dam_repair_2SECOND	Надіслати невелику робочу силу, щоб зробити те, що вони можуть, цього має бути достатньо.	true
cdir_events_dilemma_choice_details_localised_choice_title_att_eos_marib_dam_repair_3SECOND	Надіслати невелику робочу силу, щоб зробити те, що вони можуть, цього має бути достатньо.	true
cdir_events_dilemma_choice_details_localised_choice_label_political_event_ministerial_positionFIRST	Заблокувати просування	true
cdir_events_dilemma_choice_details_localised_choice_label_political_event_marriage_maleFIRST	Втручатися	true
cdir_events_dilemma_choice_details_localised_choice_label_cha_dilemma_lombard_pope_demands_2FOURTH	Стояти на своєму	true
cdir_events_dilemma_choice_details_localised_choice_label_att_subject_religious_barb_bloodlessFIRST	Пожертвувати більше баранів	true
cdir_events_dilemma_choice_details_localised_choice_label_att_subject_religious_hellenic_illegal_practice_1FIRST	Стратити його	true
cdir_events_dilemma_choice_details_localised_choice_title_att_subject_religious_hellenic_pilgrims_1FIRST	Їхні справи не стосуються нас.	true
cdir_events_dilemma_choice_details_localised_choice_label_att_dilemma_religious_christian_council_of_carthage_1SECOND	Прийняти пелагіанство	true
cdir_events_dilemma_choice_details_localised_choice_label_ollam_ri_A1iFIRST	Шукати воду.	true
cdir_events_dilemma_choice_details_localised_choice_label_political_event_ministerial_positionSECOND	Нічого не робити	true
cdir_events_dilemma_choice_details_localised_choice_title_att_subject_politics_barb_nomad_challengerSECOND	Залякати його, щоб він мовчав.	true
cdir_events_dilemma_choice_details_localised_choice_label_att_subject_religious_tengri_pilgrims_1FIRST	Ігнорувати їх	true
cdir_events_dilemma_choice_details_localised_choice_label_att_dilemma_religious_tengri_religious_sanctions_1FIRST	Дати їм рівні права	true
cdir_events_dilemma_choice_details_localised_choice_label_att_dilemma_religious_christian_council_of_ephesus_1SECOND	На боці Несторія	true
cdir_events_dilemma_choice_details_localised_choice_label_att_dilemma_religious_arian_religious_sanctions_1FIRST	Дати їм рівні права	true
cdir_events_dilemma_choice_details_localised_choice_label_att_subject_religious_tengri_pilgrims_1THIRD	Дозволити їм	true
cdir_events_dilemma_choice_details_localised_choice_title_political_event_marriage_maleSECOND	Цей союз має наше офіційне благословення.	true
cdir_events_dilemma_choice_details_localised_choice_label_att_dilemma_domestic_none_plentiful_harvest_1SECOND	Зберігати це	true
cdir_events_dilemma_choice_details_localised_choice_title_att_subject_military_none_the_lanista_1FIRST	Він добре послужив своїй країні, дозвольте йому жити спокійно.	true
cdir_events_dilemma_choice_details_localised_choice_title_att_subject_politics_barb_nomad_challengerFOURTH	Нагородіть його місцем у своїй раді.	true
cdir_events_dilemma_choice_details_localised_choice_label_att_subject_religious_manichaeism_illegal_practice_1SECOND	Звільнити його	true
cdir_events_dilemma_choice_details_localised_choice_label_att_dilemma_religious_zoroastrian_the_manichean_heresy_1FIRST	Вигнати їх	true
cdir_events_dilemma_choice_details_localised_choice_title_cha_dilemma_pope_help_1FIRST	Мій батько проливав кров за цю землю, тому я вимагаю виконання обіцянки!	true
cdir_events_dilemma_choice_details_localised_choice_title_att_subject_military_none_the_lanista_1THIRD	Він знову може активно служити своїй країні. Нам потрібна його майстерність володіння зброєю.	true
cdir_events_dilemma_choice_details_localised_choice_title_att_eos_marib_dam_repair_0FOURTH	Не шкодуйте! Дамба має залишатися міцною, а вода – контрольованою.	true
cdir_events_dilemma_choice_details_localised_choice_title_att_eos_marib_dam_repair_1FOURTH	Не шкодуйте! Дамба має залишатися міцною, а вода – контрольованою.	true
cdir_events_dilemma_choice_details_localised_choice_title_att_eos_marib_dam_repair_2FOURTH	Не шкодуйте! Дамба має залишатися міцною, а вода – контрольованою.	true
cdir_events_dilemma_choice_details_localised_choice_title_att_eos_marib_dam_repair_3FOURTH	Не шкодуйте! Дамба має залишатися міцною, а вода – контрольованою.	true
cdir_events_dilemma_choice_details_localised_choice_label_att_subject_politics_rome_corruptionTHIRD	Досягти компромісу	true
cdir_events_dilemma_choice_details_localised_choice_label_att_subject_religious_manichaeism_pilgrims_1SECOND	Заборонити це	true
cdir_events_dilemma_choice_details_localised_choice_label_att_subject_military_none_drunk_on_watch_1THIRD	Децимація	true
cdir_events_dilemma_choice_details_localised_choice_title_att_political_action_dilemma_diminish_popularity_followup_mercifulSECOND	Нехай буде відомо, що такі ганебні дії не залишаться безкарними.	true
cdir_events_dilemma_choice_details_localised_choice_label_att_subject_domestic_all_stone_masonTHIRD	Нехай його вб'ють	true
cdir_events_dilemma_choice_details_localised_choice_title_att_subject_religious_christian_candidate_for_bishopSECOND	Треба намагатися підвищити шанси нашого кандидата.	true
cdir_events_dilemma_choice_details_localised_choice_label_att_subject_nomadic_tribal_strife_1SECOND	Влаштуйте їм дуель	true
cdir_events_dilemma_choice_details_localised_choice_label_cha_dilemma_lombard_pope_demands_1SECOND	Категорично відмовитися	true
cdir_events_dilemma_choice_details_localised_choice_label_cha_dilemma_lombard_pope_demands_2SECOND	Натомість запропонувати гроші	true
cdir_events_dilemma_choice_details_localised_choice_label_cha_dilemma_lombard_pope_demands_3SECOND	Дати обітницю ніколи не виконувати	true
cdir_events_dilemma_choice_details_localised_choice_title_att_bel_request_antoninia_rumours_1SECOND	Ви мене за дурня маєте? Ти його більше ніколи не побачиш!	true
cdir_events_dilemma_choice_details_localised_choice_label_att_subject_religious_catholic_pilgrims_1THIRD	Надати їм прохід	true
cdir_events_dilemma_choice_details_localised_choice_label_att_subject_military_none_mercenary_commander_1FIRST	Ігнорувати його	true
cdir_events_dilemma_choice_details_localised_choice_title_att_subject_religious_catholic_illegal_practice_1THIRD	Єретик. Нехай гниє!	true
cdir_events_dilemma_choice_details_localised_choice_title_att_dilemma_religious_manichaeism_religious_sanctions_1FIRST	Усі люди в наших очах рівні. До маніхейців треба ставитися так само, як до всіх інших.	true
cdir_events_dilemma_choice_details_localised_choice_label_att_subject_religious_none_the_golden_tongued_1THIRD	Відправити його в інше місце	true
cdir_events_dilemma_choice_details_localised_choice_label_att_subject_religious_celtic_pilgrims_1FIRST	Ігнорувати їх	true
cdir_events_dilemma_choice_details_localised_choice_label_att_subject_politics_rome_corruptionFIRST	Заборонити корупціонерів	true
cdir_events_dilemma_choice_details_localised_choice_label_att_subject_military_none_drunk_on_watch_1FIRST	Ігнорувати проблему	true
cdir_events_dilemma_choice_details_localised_choice_title_att_subject_domestic_civil_hostile_disputeFOURTH	Пусте! Новина на вчора.	true
cdir_events_dilemma_choice_details_localised_choice_label_cha_dilemma_charlemagne_daughter_1SECOND	Розправитися з пліткарями	true
cdir_events_dilemma_choice_details_localised_choice_label_att_bel_request_justinian_photius_1SECOND	Убити Фотія	true
cdir_events_dilemma_choice_details_localised_choice_label_att_subject_domestic_all_stone_masonFIRST	Найняти його	true
cdir_events_dilemma_choice_details_localised_choice_label_att_subject_military_none_mercenary_commander_1THIRD	Запитати про знижку	true
cdir_events_dilemma_choice_details_localised_choice_label_att_subject_religious_catholic_pilgrims_1FIRST	Ігнорувати їх	true
cdir_events_dilemma_choice_details_localised_choice_title_att_subject_religious_catholic_illegal_practice_1FIRST	Убити його, щоб він був прикладом для інших.	true
cdir_events_dilemma_choice_details_localised_choice_label_att_dilemma_religious_christian_conference_of_carthage_1FIRST	Змусити їх приєднатися	true
cdir_events_dilemma_choice_details_localised_choice_label_att_subject_religious_none_the_golden_tongued_1FIRST	Залишити його	true
cdir_events_dilemma_choice_details_localised_choice_label_att_subject_religious_celtic_pilgrims_1THIRD	Дозволити їм	true
cdir_events_dilemma_choice_details_localised_choice_label_att_subject_domestic_barb_temple_sacrilegeSECOND	Видати його	true
cdir_events_dilemma_choice_details_localised_choice_label_att_subject_politics_civil_challengerFIRST	Нехай він говорить	true
cdir_events_dilemma_choice_details_localised_choice_title_att_subject_religious_barb_bloodlessTHIRD	Ми повинні віддати цю неприродну істоту вогню.	true
cdir_events_dilemma_choice_details_localised_choice_label_cha_dilemma_viking_1_cha_fact_merciaSECOND	Забрати землю	true
cdir_events_dilemma_choice_details_localised_choice_label_att_subject_religious_germanic_pilgrims_1THIRD	Нехай вони продовжують	true
cdir_events_dilemma_choice_details_localised_choice_title_att_subject_religious_germanic_illegal_practice_1THIRD	Нехай він думає про свій гріх, нам в угоду.	true
cdir_events_dilemma_choice_details_localised_choice_title_att_subject_religious_orthodox_illegal_practice_1THIRD	Нехай він думає про свій гріх, нам в угоду.	true
cdir_events_dilemma_choice_details_localised_choice_title_att_dilemma_religious_christian_council_of_carthage_1SECOND	Хто ми такі, щоб судити? Хто без гріха, нехай перший кине камінь, сказав Спаситель…	true
cdir_events_dilemma_choice_details_localised_choice_title_att_subject_religious_celtic_illegal_practice_1THIRD	Її бог фальшивий. Нехай думає про це, поки гниє!	true
cdir_events_dilemma_choice_details_localised_choice_label_att_subject_politics_civil_challengerTHIRD	Убити його	true
cdir_events_dilemma_choice_details_localised_choice_title_att_subject_religious_barb_bloodlessFIRST	Боги мають отримати належне.	true
cdir_events_dilemma_choice_details_localised_choice_title_att_subject_religious_none_the_holy_site_1SECOND	Ми викупимо Вашу землю і збудуємо святиню.	true
cdir_events_dilemma_choice_details_localised_choice_title_political_event_ministerial_positionFIRST	Він явно не той чоловік який потрібний для цієї роботи.	true
cdir_events_dilemma_choice_details_localised_choice_title_att_subject_religious_barb_bloodlessSECOND	Лише справжня жертва тепер задобрить богів.	true
cdir_events_dilemma_choice_details_localised_choice_label_att_subject_religious_germanic_pilgrims_1FIRST	Ігнорувати їх	true
cdir_events_dilemma_choice_details_localised_choice_title_att_subject_religious_germanic_illegal_practice_1FIRST	Убити його як приклад для інших.	true
cdir_events_dilemma_choice_details_localised_choice_title_att_subject_religious_orthodox_illegal_practice_1FIRST	Убити цього дурня і розбийте його ікони. У народу буде приклад.	true
cdir_events_dilemma_choice_details_localised_choice_title_att_subject_religious_celtic_illegal_practice_1FIRST	Убити її, щоб інші боялися.	true
cdir_events_dilemma_choice_details_localised_choice_title_att_subject_diplomatic_none_border_dispute_1SECOND	Такі дії можуть спровокувати ширші політичні проблеми. Надіслати війська і вирішіть справу.	true
cdir_events_dilemma_choice_details_localised_choice_title_att_dilemma_religious_tengri_religious_sanctions_1FIRST	У наших очах усі люди рівні. До тенгристів треба ставитися так само, як до всіх інших.	true
cdir_events_dilemma_choice_details_localised_choice_title_att_subject_religious_barb_strangerFIRST	У цій людині є відтінок долі, варто прислухатися до його слів.	true
cdir_events_dilemma_choice_details_localised_choice_label_att_political_action_dilemma_embezzlement_suspiciousSECOND	Потужне алібі	true
cdir_events_dilemma_choice_details_localised_choice_title_att_subject_domestic_civil_idiot_magistrateFIRST	Це дурня навчить!	true
cdir_events_dilemma_choice_details_localised_choice_title_ollam_ri_A1iFIRST	Рі хоче побачити це диво на власні очі.	true
cdir_events_dilemma_choice_details_localised_choice_title_att_subject_domestic_all_stone_masonFOURTH	У Вас є більш важливі справи.	true
cdir_events_dilemma_choice_details_localised_choice_label_att_dilemma_religious_zoroastrian_religious_sanctions_1FIRST	Дати їм рівні права	true
cdir_events_dilemma_choice_details_localised_choice_title_att_subject_religious_barb_strangerTHIRD	Усі люди мають ціну, я відчуваю, що його нижча, ніж він каже.	true
cdir_events_dilemma_choice_details_localised_choice_title_att_subject_domestic_civil_idiot_magistrateTHIRD	Це дурень підвів Вас, і його потрібно як годиться покарати, щоб інші знали.	true
cdir_events_dilemma_choice_details_localised_choice_label_cha_dilemma_verdenFOURTH	Знищити їх усіх	true
cdir_events_dilemma_choice_details_localised_choice_title_att_subject_religious_christian_pontifex_maximus_1SECOND	Трохи золота, нанесеного в потрібних місцях, може збільшити шанси нашого кандидата.	true
cdir_events_dilemma_choice_details_localised_choice_title_att_bel_request_theodosia_amalasuntha_1FIRST	Якщо Юстиніан наражає себе на небезпеку, мій обов’язок — вжити заходів, щоб захистити його.	true
cdir_events_dilemma_choice_details_localised_choice_title_att_bel_request_antoninia_rumours_1FIRST	Ах, можливо, я перестарався... крім того, кілька додаткових талантів не завадять.	true
cdir_events_dilemma_choice_details_localised_choice_title_att_subject_religious_hun_shamanSECOND	Цей чоловік ставить під сумнів Ваше право керувати, це не можна терпіти.	true
cdir_events_dilemma_choice_details_localised_choice_label_att_bel_request_antoninia_thedosius_1FIRST	Усиновити його	true
cdir_events_dilemma_choice_details_localised_choice_title_att_subject_religious_orthodox_illegal_practice_1SECOND	Ми толерантні до релігійних уподобань інших. Відпустити його.	true
cdir_events_dilemma_choice_details_localised_choice_label_att_subject_religious_arian_pilgrims_1SECOND	Заборонити	true
cdir_events_dilemma_choice_details_localised_choice_title_att_subject_politics_roman_hostageFIRST	Цей хлопець заслуговує на шанс викроїти собі кращу долю.	true
cdir_events_dilemma_choice_details_localised_choice_label_att_subject_domestic_nomad_sword_of_attilaTHIRD	Подарувати меч	true
cdir_events_dilemma_choice_details_localised_choice_title_att_subject_domestic_none_hidden_treasure_1THIRD	Закладаюся, це може ще на деякий час зменшити витрати армії, а також оплатити деяких найманців.	true
cdir_events_dilemma_choice_details_localised_choice_label_att_subject_military_roman_master_hostile_governorTHIRD	Убити його	true
cdir_events_dilemma_choice_details_localised_choice_label_cha_dilemma_verdenFIRST	Відпустити їх	true
cdir_events_dilemma_choice_details_localised_choice_label_political_event_assassination_failure_discoveredSECOND	Проявити милосердя	true
cdir_events_dilemma_choice_details_localised_choice_title_att_eos_tanukhids_settleSECOND	Тепер вони звільнені, наші вірні союзники повинні залишатися вільними, щоб керувати своїми землями.	true
cdir_events_dilemma_choice_details_localised_choice_label_att_subject_religious_arian_illegal_practice_1SECOND	Звільнити його	true
cdir_events_dilemma_choice_details_localised_choice_label_political_event_marriage_femaleSECOND	Дати благословіння	true
cdir_events_dilemma_choice_details_localised_choice_title_att_subject_politics_roman_hostageTHIRD	Повернення його до його сім’ї може поліпшити наш шлях до його варварського народу.	true
cdir_events_dilemma_choice_details_localised_choice_label_att_subject_domestic_nomad_sword_of_attilaFIRST	Прийняти Подарунок	true
cdir_events_dilemma_choice_details_localised_choice_title_att_subject_domestic_none_hidden_treasure_1FIRST	Не турбуйтеся, ми самі подбаємо про це…	true
cdir_events_dilemma_choice_details_localised_choice_label_att_subject_military_roman_master_hostile_governorFIRST	Підкупити його	true
cdir_events_dilemma_choice_details_localised_choice_title_cha_dilemma_pope_attacked_1FIRST	Той, кому Бог вважав за потрібне наділити владу, справді гідний нашої допомоги.	true
cdir_events_dilemma_choice_details_localised_choice_title_ollam_ri_votadiniSECOND	Первісні дерева обіцяють життя сміливим і смерть необережним.	true
cdir_events_dilemma_choice_details_localised_choice_label_cha_dilemma_verdenTHIRD	Убити їхніх лідерів	true
cdir_events_dilemma_choice_details_localised_choice_label_att_bel_request_theodosia_amalasuntha_1SECOND	Прийняти вхідну місію	true
cdir_events_dilemma_choice_details_localised_choice_label_att_dilemma_religious_zoroastrian_religious_sanctions_1SECOND	Накласти санкції	true
cdir_events_dilemma_choice_details_localised_choice_title_slav_dilemma_venedians_1SECOND	Що ми можемо зробити проти такого божевілля? Дати їм те, що вони хочуть.	true
cdir_events_dilemma_choice_details_localised_choice_title_slav_dilemma_venedians_2SECOND	Що ми можемо зробити проти такого божевілля? Дати їм те, що вони хочуть.	true
cdir_events_dilemma_choice_details_localised_choice_title_slav_dilemma_venedians_3SECOND	Що ми можемо зробити проти такого божевілля? Дати їм те, що вони хочуть.	true
cdir_events_dilemma_choice_details_localised_choice_title_slav_dilemma_venedians_4SECOND	Що ми можемо зробити проти такого божевілля? Дати їм те, що вони хочуть.	true
cdir_events_dilemma_choice_details_localised_choice_label_att_subject_religious_zoroastrian_corpseSECOND	Убити його	true
cdir_events_dilemma_choice_details_localised_choice_label_att_subject_military_none_the_spy_1THIRD	Тренувати інших	true
cdir_events_dilemma_choice_details_localised_choice_title_att_subject_domestic_roman_a_little_flutter_2THIRD	Хоча він молодий, цей боєць демонструє великі перспективи. Можливо, настав час дати йому можливість довести свою мужність?	true
cdir_events_dilemma_choice_details_localised_choice_title_att_bel_request_theodosia_ioannina_1FIRST	Як би жахливо це не було, ми повинні спробувати вилікувати цю ситуацію, а не погіршувати її.	true
cdir_events_dilemma_choice_details_localised_choice_title_att_subject_religious_none_the_true_cross_1THIRD	Цей чоловік явно не заслуговує довіри та продає підроблені реліквії заради прибутку. Ми повинні його зачинити.	true
cdir_events_dilemma_choice_details_localised_choice_label_att_political_action_dilemma_assassinate_wound_suspiciousTHIRD	Забути це	true
cdir_events_dilemma_choice_details_localised_choice_label_att_subject_military_barb_master_hostile_governorTHIRD	Убити його	true
cdir_events_dilemma_choice_details_localised_choice_label_att_subject_religious_arian_pilgrims_1FIRST	Ігнорувати їх	true
cdir_events_dilemma_choice_details_localised_choice_label_att_dilemma_religious_manichaeism_religious_sanctions_1SECOND	Накласти санкції	true
cdir_events_dilemma_choice_details_localised_choice_label_att_political_action_dilemma_assassinate_caughtSECOND	Засудити	true
cdir_events_dilemma_choice_details_localised_choice_label_att_subject_military_none_the_spy_1FIRST	Ігнорувати проблему	true
cdir_events_dilemma_choice_details_localised_choice_label_cha_dilemma_saxon_1FIRST	Прийняти Хрещення	true
cdir_events_dilemma_choice_details_localised_choice_label_att_dilemma_domestic_roman_saint_telemachus_1FIRST	Заборонити Ігри	true
cdir_events_dilemma_choice_details_localised_choice_label_cha_dilemma_viking_1_cha_fact_northumbriaSECOND	Забрати землю	true
cdir_events_dilemma_choice_details_localised_choice_title_att_subject_domestic_roman_a_little_flutter_2FIRST	Азартні ігри – це вада, в яких ніхто не повинен брати участі, і ми маємо займатися державними справами.	true
cdir_events_dilemma_choice_details_localised_choice_title_att_subject_religious_none_the_true_cross_1FIRST	Ми не повинні турбуватися про цю дурницю.	true
cdir_events_dilemma_choice_details_localised_choice_label_att_political_action_dilemma_assassinate_wound_suspiciousFIRST	Замітати сліди	true
cdir_events_dilemma_choice_details_localised_choice_label_att_subject_military_barb_master_hostile_governorFIRST	Підкупити його	true
cdir_events_dilemma_choice_details_localised_choice_label_att_subject_religious_arian_pilgrims_1THIRD	Дозволити їм пройти	true
cdir_events_dilemma_choice_details_localised_choice_title_ollam_ri_votadiniFIRST	Чорне дзеркало його поверхні відображає всі таємниці людства.	true
cdir_events_dilemma_choice_details_localised_choice_title_cha_dilemma_cordoba_1THIRD	Слова дешеві, і часто діють так само добре, як меч. Негайно надішліть емісара!	true
cdir_events_dilemma_choice_details_localised_choice_title_att_subject_domestic_roman_a_little_flutter_1FIRST	Азартні ігри – це вада, в яких ніхто не повинен брати участі, і ми маємо займатися державними справами.	true
cdir_events_dilemma_choice_details_localised_choice_label_att_eos_tanukhids_settleFIRST	Поглинути своїх звільнених союзників	true
cdir_events_dilemma_choice_details_localised_choice_title_political_event_adoptionSECOND	Дозволити продовжити усиновлення.	true
cdir_events_dilemma_choice_details_localised_choice_title_cha_dilemma_cordoba_1FIRST	Золото чи безпека мого народу - зробити легкий вибір.	true
cdir_events_dilemma_choice_details_localised_choice_title_att_subject_domestic_roman_a_little_flutter_1THIRD	Ха! Молодість нічого не означає, коли стикаєшся з досвідом. Може бути тільки один результат, я буду робити ставку проти молодого дурня.	true
cdir_events_dilemma_choice_details_localised_choice_title_att_political_action_dilemma_embezzlement_caughtSECOND	Нехай знають, що вони виконували замовлення на благо держави.	true
cdir_events_dilemma_choice_details_localised_choice_label_att_subject_religious_orthodox_illegal_practice_1SECOND	Звільнити його	true
cdir_events_dilemma_choice_details_localised_choice_title_political_event_assassination_success_discoveredSECOND	Кровопролиття було достатньо.	true
cdir_events_dilemma_choice_details_localised_choice_title_att_political_action_dilemma_embezzlement_caughtFOURTH	Вони можуть постояти за себе - їхня доля нас не хвилює.	true
cdir_events_dilemma_choice_details_localised_choice_title_ollam_ri_pictiSECOND	Первісні дерева обіцяють життя сміливим і смерть необережним.	true
cdir_events_dilemma_choice_details_localised_choice_title_att_subject_military_roman_master_hostile_governorFIRST	Великий хабар швидко змінить думку цієї людини.	true
cdir_events_dilemma_choice_details_localised_choice_label_att_subject_politics_roman_hostageTHIRD	Повернути його	true
cdir_events_dilemma_choice_details_localised_choice_title_att_subject_domestic_nomad_sword_of_attilaFIRST	Кожному великому лідеру потрібна легендарна зброя.	true
cdir_events_dilemma_choice_details_localised_choice_label_ollam_ri_votadiniSECOND	Він прямує до лісу.	true
cdir_events_dilemma_choice_details_localised_choice_title_cha_dilemma_verdenTHIRD	Убити їхніх лідерів як приклад для тих, хто кидає виклик Божому слову.	true
cdir_events_dilemma_choice_details_localised_choice_title_political_event_marriage_femaleSECOND	Вона має наше благословіння.	true
cdir_events_dilemma_choice_details_localised_choice_label_att_political_action_dilemma_diminish_popularity_reversalTHIRD	Забути це	true
cdir_events_dilemma_choice_details_localised_choice_label_att_subject_domestic_civil_married_slavesTHIRD	Нехай їх бичуть	true
cdir_events_dilemma_choice_details_localised_choice_title_att_subject_military_roman_master_hostile_governorTHIRD	Ніж у спину заглушить його волання.	true
cdir_events_dilemma_choice_details_localised_choice_label_att_subject_politics_roman_hostageFIRST	Дати йому громадянство	true
cdir_events_dilemma_choice_details_localised_choice_title_att_subject_domestic_nomad_sword_of_attilaTHIRD	Така зброя стане чудовим подарунком.	true
cdir_events_dilemma_choice_details_localised_choice_title_cha_dilemma_verdenFIRST	Милосердя — мірило справжнього християнського короля.	true
cdir_events_dilemma_choice_details_localised_choice_title_att_bel_request_theodosia_amalasuntha_1SECOND	На жаль, моя імператрице, я не можу не послухатися прямого наказу імператора.	true
cdir_events_dilemma_choice_details_localised_choice_title_att_dilemma_religious_zoroastrian_religious_sanctions_1SECOND	Ми повинні прийняти закони, щоб обмежити права цих язичників на поклоніння вперед.	true
cdir_events_dilemma_choice_details_localised_choice_title_att_bel_request_theodosia_pope_1SECOND	Імператор править божественним призначенням, тільки він має право судити Папу.	true
cdir_events_dilemma_choice_details_localised_choice_label_slav_dilemma_anteans_1SECOND	Убити його за зухвалість	true
cdir_events_dilemma_choice_details_localised_choice_label_slav_dilemma_anteans_2SECOND	Накажи його вбити	true
cdir_events_dilemma_choice_details_localised_choice_label_att_dilemma_religious_christian_conference_of_carthage_1SECOND	Терпіти їх	true
cdir_events_dilemma_choice_details_localised_choice_label_att_political_action_dilemma_diminish_popularity_reversalFIRST	Виправдати	true
cdir_events_dilemma_choice_details_localised_choice_label_att_subject_domestic_civil_married_slavesFIRST	Нехай одружуються	true
cdir_events_dilemma_choice_details_localised_choice_label_ollam_ri_A2FIRST	Ігнорувати його.	true
cdir_events_dilemma_choice_details_localised_choice_label_ollam_ri_B2FIRST	Втопити його в молоці.	true
cdir_events_dilemma_choice_details_localised_choice_label_att_subject_diplomatic_none_tribute_1FIRST	Ігнорувати його	true
cdir_events_dilemma_choice_details_localised_choice_title_att_subject_domestic_none_workers_on_strike_1FIRST	Зрештою вони здадуться	true
cdir_events_dilemma_choice_details_localised_choice_title_cha_dilemma_viking_1_cha_fact_northumbriaSECOND	Ці родючі землі дійсно пропонують багатообіцяюче майбутнє для нашого народу, я впевнений, що ми зможемо знайти інші землі, щоб грабувати.	true
cdir_events_dilemma_choice_details_localised_choice_label_att_bel_request_theodosia_ioannina_1FIRST	Ігнорувати свою дружину	true
cdir_events_dilemma_choice_details_localised_choice_title_att_dilemma_religious_manichaeism_religious_sanctions_1SECOND	Ми повинні прийняти закони, щоб обмежити права віросповідання цих єретиків.	true
cdir_events_dilemma_choice_details_localised_choice_title_att_subject_politics_barb_nomad_secret_meetingsFIRST	У Вас немає часу на ці дрібні ігри. Просто вбити їх.	true
cdir_events_dilemma_choice_details_localised_choice_title_att_subject_religious_arian_pilgrims_1THIRD	Хто ми такі, щоб кидати виклик переконанням інших?	true
cdir_events_dilemma_choice_details_localised_choice_label_att_political_action_dilemma_gather_support_oppositionSECOND	Зловживання владою	true
cdir_events_dilemma_choice_details_localised_choice_title_att_eos_religious_event_rebellion_att_fact_axum_att_rel_semitic_paganismSECOND	Його люди достатньо постраждали, якщо ми зможемо загладити провину, нехай буде так.	true
cdir_events_dilemma_choice_details_localised_choice_label_att_subject_religious_zoroastrian_corpseFOURTH	Нічого не робити	true
cdir_events_dilemma_choice_details_localised_choice_title_att_political_action_dilemma_marriage_impedimentSECOND	Якщо його володар забажає, у нього не буде іншого вибору, як підкоритися!	true
cdir_events_dilemma_choice_details_localised_choice_title_att_political_action_dilemma_assassinate_caughtSECOND	Вони зганьбили себе та королівський дім!	true
cdir_events_dilemma_choice_details_localised_choice_label_ollam_ri_A3FIRST	Схопити коня.	true
cdir_events_dilemma_choice_details_localised_choice_label_att_subject_diplomatic_none_tribute_1THIRD	Убити його	true
cdir_events_dilemma_choice_details_localised_choice_title_att_subject_domestic_none_workers_on_strike_1THIRD	Добре	true
cdir_events_dilemma_choice_details_localised_choice_label_att_dilemma_religious_christian_council_of_carthage_1FIRST	Засудити пелагіан	true
cdir_events_dilemma_choice_details_localised_choice_title_att_subject_politics_barb_nomad_secret_meetingsTHIRD	Один із змовників може все ще бути вірним Вам, використовуйте його, щоб зірвати їхні плани.	true
cdir_events_dilemma_choice_details_localised_choice_title_att_subject_religious_arian_pilgrims_1FIRST	Їхні справи не стосуються нас.	true
cdir_events_dilemma_choice_details_localised_choice_title_att_dilemma_religious_zoroastrian_the_manichean_heresy_1SECOND	Ці люди завдають шкоди іншим. Ми повинні залишити їх на розсуд їхньому незрозумілому культу.	true
cdir_events_dilemma_choice_details_localised_choice_label_att_subject_diplomatic_none_diplomatic_dispute_1SECOND	Вимагати данини	true
cdir_events_dilemma_choice_details_localised_choice_title_att_political_action_dilemma_secure_loyalty_mutilationSECOND	Не бачу зла, «тут» зла...	true
cdir_events_dilemma_choice_details_localised_choice_title_ybor_level_A_langobardiFIRST	Взятий із мертвої хватки ворожого короля.	true
cdir_events_dilemma_choice_details_localised_choice_title_att_eos_tanukhids_settleFIRST	Ці нові землі допоможуть нашій новій імперії процвітати!	true
cdir_events_dilemma_choice_details_localised_choice_title_att_dilemma_religious_christian_the_manichean_heresy_1SECOND	Маніхейство багато в чому схоже на християнство. Ми повинні бути толерантними до інших конфесій.	true
cdir_events_dilemma_choice_details_localised_choice_label_ollam_ri_A1FIRST	Шануйте це.	true
cdir_events_dilemma_choice_details_localised_choice_label_ollam_ri_B1FIRST	Використати їхню свинячу шкіру.	true
cdir_events_dilemma_choice_details_localised_choice_label_att_bel_request_justinian_photius_1FIRST	Зневажити Антоніною	true
cdir_events_dilemma_choice_details_localised_choice_title_att_subject_religious_hun_shamanFOURTH	Нехай цей шаман говорить, що хоче.	true
cdir_events_dilemma_choice_details_localised_choice_title_att_subject_politics_civil_hostageTHIRD	Повернувши його до родини, ми, безумовно, придбаємо їхню прихильність.	true
cdir_events_dilemma_choice_details_localised_choice_label_att_subject_religious_catholic_pilgrims_1SECOND	Заборонити	true
cdir_events_dilemma_choice_details_localised_choice_label_att_subject_domestic_roman_a_little_flutter_1FIRST	Ігнорувати проблему	true
cdir_events_dilemma_choice_details_localised_choice_label_cha_dilemma_cordoba_1THIRD	Надіслати дипломата	true
cdir_events_dilemma_choice_details_localised_choice_label_att_subject_diplomatic_none_border_dispute_1FIRST	Ігнорувати цю суперечку	true
cdir_events_dilemma_choice_details_localised_choice_label_political_event_adoptionSECOND	Дозволити	true
cdir_events_dilemma_choice_details_localised_choice_title_att_subject_religious_arian_pilgrims_1SECOND	Вони повинні знайти інший шлях до свого Бога.	true
cdir_events_dilemma_choice_details_localised_choice_title_att_subject_politics_civil_hostageFIRST	Не можна дозволяти його інтелекту пропасти даремно.	true
cdir_events_dilemma_choice_details_localised_choice_title_att_subject_religious_barb_stonesFOURTH	Ми нічого не можемо зробити, щоб зупинити те, що вже було відбувається.	true
cdir_events_dilemma_choice_details_localised_choice_label_att_subject_domestic_roman_a_little_flutter_1THIRD	Поставити проти гладіатора	true
cdir_events_dilemma_choice_details_localised_choice_label_cha_dilemma_cordoba_1FIRST	Сплатити податок	true
cdir_events_dilemma_choice_details_localised_choice_label_att_bel_request_antoninia_rumours_1FIRST	Заплющити очі	true
cdir_events_dilemma_choice_details_localised_choice_label_att_subject_diplomatic_none_border_dispute_1THIRD	Купити землю	true
cdir_events_dilemma_choice_details_localised_choice_label_att_political_action_dilemma_embezzlement_caughtSECOND	Вимагати відповідальності	true
cdir_events_dilemma_choice_details_localised_choice_label_att_subject_military_none_mercenary_commander_1SECOND	Прийняти його пропозицію	true
cdir_events_dilemma_choice_details_localised_choice_label_att_subject_domestic_roman_a_little_flutter_2THIRD	Поставити проти ветерана	true
cdir_events_dilemma_choice_details_localised_choice_label_att_subject_domestic_none_hidden_treasure_1FIRST	Ігнорувати проблему	true
cdir_events_dilemma_choice_details_localised_choice_label_cha_dilemma_pope_attacked_1FIRST	Обіцяти захист	true
cdir_events_dilemma_choice_details_localised_choice_label_att_subject_domestic_civil_hostile_disputeTHIRD	Критикувати свого опонента	true
cdir_events_dilemma_choice_details_localised_choice_title_att_political_action_dilemma_assassinate_wound_suspiciousTHIRD	Нехай пліткують і теоретизують, чого нам до селянської балачки?	true
cdir_events_dilemma_choice_details_localised_choice_title_att_subject_military_barb_master_hostile_governorTHIRD	Убити його і запекти на багатті!	true
cdir_events_dilemma_choice_details_localised_choice_label_att_subject_religious_hun_shamanFIRST	Заткнути його	true
cdir_events_dilemma_choice_details_localised_choice_label_att_subject_religious_arian_illegal_practice_1FIRST	Стратити його	true
cdir_events_dilemma_choice_details_localised_choice_label_att_subject_politics_barb_nomad_secret_meetingsFOURTH	Найняти їх	true
cdir_events_dilemma_choice_details_localised_choice_title_att_dilemma_domestic_roman_saint_telemachus_1FIRST	Вбивство цього мирного жителя – та крапля, яка переповнила перемогу. Ігри тривали досить довго.	true
cdir_events_dilemma_choice_details_localised_choice_label_att_subject_domestic_roman_a_little_flutter_2FIRST	Ігнорувати проблему	true
cdir_events_dilemma_choice_details_localised_choice_label_att_subject_domestic_none_hidden_treasure_1THIRD	Віддати в армію	true
cdir_events_dilemma_choice_details_localised_choice_label_att_subject_religious_catholic_illegal_practice_1SECOND	Звільнити їх	true
cdir_events_dilemma_choice_details_localised_choice_label_att_subject_domestic_civil_hostile_disputeFIRST	Покарати його	true
cdir_events_dilemma_choice_details_localised_choice_label_att_subject_military_barb_master_hostile_governorFOURTH	Нічого не робити	true
cdir_events_dilemma_choice_details_localised_choice_title_att_political_action_dilemma_assassinate_wound_suspiciousFIRST	Вони повинні переконатися, що жодні докази не вказують на їхню причетність.	true
cdir_events_dilemma_choice_details_localised_choice_title_att_subject_military_barb_master_hostile_governorFIRST	Щедрий подарунок багатства повинен заткнути йому рота.	true
cdir_events_dilemma_choice_details_localised_choice_label_att_subject_religious_hun_shamanTHIRD	Нехай живе	true
cdir_events_dilemma_choice_details_localised_choice_label_ybor_level_A_langobardiSECOND	Брошка	true
cdir_events_dilemma_choice_details_localised_choice_label_att_subject_religious_arian_illegal_practice_1THIRD	Залишити його у в'язниці	true
cdir_events_dilemma_choice_details_localised_choice_label_ollam_ri_votadiniFIRST	Він прямує до озера.	true
cdir_events_dilemma_choice_details_localised_choice_title_att_subject_religious_arian_illegal_practice_1SECOND	Ми доброзичливі та терпимі до інших. Звільнити його.	true
cdir_events_dilemma_choice_details_localised_choice_title_att_subject_politics_nomad_hostageFIRST	Цей хлопець може стати для Вас справжньою цінністю.	true
cdir_events_dilemma_choice_details_localised_choice_title_att_subject_military_none_the_spy_1FIRST	Нехай гниє в підземеллі.	true
cdir_events_dilemma_choice_details_localised_choice_title_cha_dilemma_saxon_1FIRST	За любов, яку я виявляю до свого народу, я буду хреститися в ім’я Бога.	true
cdir_events_dilemma_choice_details_localised_choice_label_att_subject_religious_hellenic_pilgrims_1SECOND	Заборонити	true
cdir_events_dilemma_choice_details_localised_choice_title_political_event_blackmailSECOND	Ці чутки безпідставні.	true
cdir_events_dilemma_choice_details_localised_choice_label_ollam_ri_BFIRST	Відпустити їх	true
cdir_events_dilemma_choice_details_localised_choice_label_att_subject_religious_none_the_true_cross_1FIRST	Ігнорувати угоду	true
cdir_events_dilemma_choice_details_localised_choice_label_att_eos_tanukhids_settleSECOND	Залишатися союзниками	true
cdir_events_dilemma_choice_details_localised_choice_title_political_event_assassination_failure_discoveredSECOND	Це божевілля має припинитися, перш ніж буде завдано реальної шкоди!	true
cdir_events_dilemma_choice_details_localised_choice_title_att_subject_politics_nomad_hostageTHIRD	Повернувши його до родини, ми, безумовно, придбаємо їхню прихильність.	true
cdir_events_dilemma_choice_details_localised_choice_label_att_subject_religious_germanic_pilgrims_1SECOND	Заборонити	true
cdir_events_dilemma_choice_details_localised_choice_title_att_subject_military_none_the_spy_1THIRD	Нехай він поділиться своїм досвідом з нашими агентами.	true
cdir_events_dilemma_choice_details_localised_choice_title_att_political_action_dilemma_assassinate_wound_suspiciousSECOND	Неможливо. У той час вони були... у королівських справах!	true
cdir_events_dilemma_choice_details_localised_choice_title_att_subject_military_barb_master_hostile_governorSECOND	Він сміє знущатися над твоєю мужністю? Тоді нехай буде відомо, хто буде плазувати!	true
cdir_events_dilemma_choice_details_localised_choice_label_att_subject_religious_none_the_true_cross_1THIRD	Конфіскувати товар	true
cdir_events_dilemma_choice_details_localised_choice_title_att_dilemma_religious_christian_the_council_of_toledo_1SECOND	Ці люди явно є єретиками, які кидають виклик вченням Господа. Вони повинні страждати за свої злочини.	true
cdir_events_dilemma_choice_details_localised_choice_title_att_subject_politics_barb_nomad_secret_meetingsSECOND	Нехай скажуть тобі в очі, що хочуть.	true
cdir_events_dilemma_choice_details_localised_choice_title_att_subject_religious_zoroastrian_corpseSECOND	Цей чоловік порушив закони нашої релігії. Його злочин не може залишитися безкарним.	true
cdir_events_dilemma_choice_details_localised_choice_label_slav_dilemma_venedians_1SECOND	Забезпечити їх їжею	true
cdir_events_dilemma_choice_details_localised_choice_label_slav_dilemma_venedians_2SECOND	Забезпечити їх їжею	true
cdir_events_dilemma_choice_details_localised_choice_label_slav_dilemma_venedians_3SECOND	Забезпечити їх їжею	true
cdir_events_dilemma_choice_details_localised_choice_label_slav_dilemma_venedians_4SECOND	Забезпечити їх їжею	true
cdir_events_dilemma_choice_details_localised_choice_label_ollam_ri_ATHIRD	Ніхто!	true
cdir_events_dilemma_choice_details_localised_choice_label_att_subject_religious_germanic_illegal_practice_1SECOND	Звільнити його	true
cdir_events_dilemma_choice_details_localised_choice_label_att_subject_religious_zoroastrian_corpseFIRST	Покарати його	true
cdir_events_dilemma_choice_details_localised_choice_label_att_subject_religious_hun_shamanSECOND	Убити його	true
cdir_events_dilemma_choice_details_localised_choice_label_att_subject_religious_barb_stonesSECOND	Зробити пропозицію	true
cdir_events_dilemma_choice_details_localised_choice_label_att_subject_religious_hellenic_illegal_practice_1SECOND	Звільнити його	true
cdir_events_dilemma_choice_details_localised_choice_label_ollam_ri_AFIRST	Друїд.	true
cdir_events_dilemma_choice_details_localised_choice_title_att_bel_request_antoninia_thedosius_1FIRST	Феодосій? Ой, він такий милий молодий чоловік - звичайно, любий!	true
cdir_events_dilemma_choice_details_localised_choice_label_att_subject_religious_zoroastrian_corpseTHIRD	Пробачити йому	true
cdir_events_dilemma_choice_details_localised_choice_label_att_subject_politics_civil_hostageFIRST	Взяти його на посаду	true
cdir_events_dilemma_choice_details_localised_choice_label_att_subject_religious_barb_stonesFOURTH	Нічого не робити	true
cdir_events_dilemma_choice_details_localised_choice_title_att_subject_diplomatic_none_border_dispute_1FIRST	Я впевнений, що ці двоє зможуть прийти до рішення без участі держави.	true
cdir_events_dilemma_choice_details_localised_choice_label_att_subject_politics_civil_hostageTHIRD	Повернути його	true
cdir_events_dilemma_choice_details_localised_choice_title_att_subject_religious_catholic_pilgrims_1SECOND	Прочани повинні негайно залишити нашу територію.	true
cdir_events_dilemma_choice_details_localised_choice_title_att_subject_diplomatic_none_border_dispute_1THIRD	Якщо держава є власником землі, то ніяких суперечок бути не може. Зробити кошти доступними.	true
cdir_events_dilemma_choice_details_localised_choice_label_att_subject_religious_hun_shamanFOURTH	Нічого не робити	true
cdir_events_dilemma_choice_details_localised_choice_title_att_subject_military_none_mercenary_commander_1SECOND	Його війська можуть бути корисні в майбутніх конфліктах, і пропозиція є гарною.	true
cdir_events_dilemma_choice_details_localised_choice_label_ollam_ri_pictiSECOND	Він прямує до лісу.	true
cdir_events_dilemma_choice_details_localised_choice_label_att_subject_domestic_none_workers_on_strike_1FIRST	Ігнорувати	true
cdir_events_dilemma_choice_details_localised_choice_title_att_subject_diplomatic_none_tribute_1FIRST	Відіслати цього чоловіка назад, ми його сьогодні не приймемо.	true
cdir_events_dilemma_choice_details_localised_choice_title_att_subject_domestic_civil_hostile_disputeFIRST	Справу має вирішити дуже публічний докір.	true
cdir_events_dilemma_choice_details_localised_choice_title_att_subject_military_barb_master_hostile_governorFOURTH	Хай дурень балакає.	true
cdir_events_dilemma_choice_details_localised_choice_title_att_subject_religious_catholic_illegal_practice_1SECOND	Ми толерантні до шляхів інших. Звільнити його.	true
cdir_events_dilemma_choice_details_localised_choice_title_att_subject_religious_arian_illegal_practice_1THIRD	Єретик. Нехай гниє!	true
cdir_events_dilemma_choice_details_localised_choice_label_att_eos_religious_event_rebellion_att_fact_axum_att_rel_semitic_paganismSECOND	Купити його	true
cdir_events_dilemma_choice_details_localised_choice_title_att_subject_religious_hun_shamanFIRST	Відріжте йому язика, тоді послухаємо, як він буде пророкувати загибель!	true
cdir_events_dilemma_choice_details_localised_choice_title_att_subject_politics_barb_nomad_secret_meetingsFOURTH	Тримайте їх поруч, дайте їм місце за своїм столом.	true
cdir_events_dilemma_choice_details_localised_choice_title_att_subject_religious_zoroastrian_corpseFOURTH	Це не Ваша справа, нехай цим займаються інші.	true
cdir_events_dilemma_choice_details_localised_choice_title_slav_dilemma_anteans_1SECOND	Ніхто не робить з мене дурня! Виволочіть його і переріжте йому брехливу горлянку!	true
cdir_events_dilemma_choice_details_localised_choice_title_slav_dilemma_anteans_2SECOND	Жалюгідний нахаба! Вистежте його та розріжте лиходія на шматки!	true
cdir_events_dilemma_choice_details_localised_choice_label_att_political_action_dilemma_marriage_impedimentSECOND	Наказ	true
cdir_events_dilemma_choice_details_localised_choice_label_att_subject_domestic_none_workers_on_strike_1THIRD	Збільшити їм платню	true
cdir_events_dilemma_choice_details_localised_choice_title_att_subject_diplomatic_none_tribute_1THIRD	Нехай їх усіх уб’ють, включно з посланцем. Очевидно, ці люди шпигуни.	true
cdir_events_dilemma_choice_details_localised_choice_title_att_subject_domestic_civil_hostile_disputeTHIRD	Винен, безумовно, його супротивник.	true
cdir_events_dilemma_choice_details_localised_choice_title_att_dilemma_religious_christian_council_of_carthage_1FIRST	Первісний гріх є основним принципом єдиної істинної віри! Ми не дозволимо цій єресі продовжуватися.	true
cdir_events_dilemma_choice_details_localised_choice_title_att_subject_religious_arian_illegal_practice_1FIRST	Убити його як приклад для інших.	true
cdir_events_dilemma_choice_details_localised_choice_label_att_dilemma_religious_zoroastrian_the_manichean_heresy_1SECOND	Залишити їх	true
cdir_events_dilemma_choice_details_localised_choice_title_ybor_level_A_langobardiSECOND	Священство каже, що вона дарує мудрість і захист Годана.	true
cdir_events_dilemma_choice_details_localised_choice_title_att_subject_religious_hun_shamanTHIRD	Можливо, Ви можете щось зробити, щоб змінити своє майбутнє?	true
cdir_events_dilemma_choice_details_localised_choice_title_att_subject_diplomatic_none_diplomatic_dispute_1SECOND	Ця образа не може залишитися без відповіді, адже ми горда нація.	true
cdir_events_dilemma_choice_details_localised_choice_label_att_political_action_dilemma_assassinate_wound_suspiciousSECOND	Потужне алібі	true
cdir_events_dilemma_choice_details_localised_choice_title_ollam_ri_A3FIRST	Кажуть, що потомство келпі чудові коні.	true
cdir_events_dilemma_choice_details_localised_choice_label_att_subject_politics_nomad_hostageTHIRD	Повернути його	true
cdir_events_dilemma_choice_details_localised_choice_title_att_subject_religious_germanic_pilgrims_1SECOND	Розігнати язичників. Вбийте всіх, хто залишиться в лісі на світанку.	true
cdir_events_dilemma_choice_details_localised_choice_label_att_subject_military_barb_master_hostile_governorSECOND	Оббрехати його	true
cdir_events_dilemma_choice_details_localised_choice_label_att_subject_politics_barb_nomad_secret_meetingsTHIRD	Порушити плани	true
cdir_events_dilemma_choice_details_localised_choice_title_att_political_action_dilemma_diminish_popularity_reversalTHIRD	Жоден чоловік нас не хвилює. У нас є важливіші справи.	true
cdir_events_dilemma_choice_details_localised_choice_title_att_subject_domestic_civil_married_slavesTHIRD	Таке мислення слід придушити в зародку.	true
cdir_events_dilemma_choice_details_localised_choice_title_ollam_ri_A2FIRST	Чоловік явно божевільний, і тепер Рі має побачення з рибою.	true
cdir_events_dilemma_choice_details_localised_choice_title_ollam_ri_B2FIRST	Цій людині не можна довіряти, тому Рі придумав йому гідний кінець.	true
cdir_events_dilemma_choice_details_localised_choice_label_att_subject_politics_nomad_hostageFIRST	Прийняти його	true
cdir_events_dilemma_choice_details_localised_choice_title_att_subject_religious_hellenic_pilgrims_1SECOND	Розігнати язичників. У світанку вбити всіх, хто залишився на місці.	true
cdir_events_dilemma_choice_details_localised_choice_label_political_event_blackmailSECOND	Ігнорувати	true
cdir_events_dilemma_choice_details_localised_choice_title_ollam_ri_BFIRST	Вони повинні мати шанс довести свою невинність.	true
cdir_events_dilemma_choice_details_localised_choice_title_att_political_action_dilemma_gather_support_oppositionSECOND	Давайте зробимо їм пропозицію, від якої вони не зможуть відмовитися...	true
cdir_events_dilemma_choice_details_localised_choice_label_att_dilemma_religious_christian_the_council_of_toledo_1SECOND	Голосувати проти Прісциліана	true
cdir_events_dilemma_choice_details_localised_choice_label_att_subject_politics_barb_nomad_secret_meetingsFIRST	Все одно вбити їх	true
cdir_events_dilemma_choice_details_localised_choice_label_att_bel_request_theodosia_pope_1SECOND	Не вживати заходів	true
cdir_events_dilemma_choice_details_localised_choice_title_att_political_action_dilemma_diminish_popularity_reversalFIRST	Нехай буде відомо, що чутки неправдиві - це просто непорозуміння!	true
cdir_events_dilemma_choice_details_localised_choice_label_att_subject_politics_barb_nomad_secret_meetingsSECOND	Зустрітися з ними	true
cdir_events_dilemma_choice_details_localised_choice_title_att_subject_domestic_civil_married_slavesFIRST	Хто ми такі, щоб стояти на шляху кохання?	true
cdir_events_dilemma_choice_details_localised_choice_title_att_dilemma_religious_christian_conference_of_carthage_1SECOND	Хіба ми не всі християни під оком Всемогутнього Бога?	true
cdir_events_dilemma_choice_details_localised_choice_title_att_subject_religious_barb_stonesSECOND	Можливо, пропозиція їжі полегшить ці неспокійні духи?	true
cdir_events_dilemma_choice_details_localised_choice_title_ollam_ri_A1FIRST	Це, мабуть, Кат Ші, сумно відома відьма, яка змінює форму!	true
cdir_events_dilemma_choice_details_localised_choice_title_ollam_ri_B1FIRST	Якщо він зможе їх врятувати, Рі зробить це.	true
cdir_events_dilemma_choice_details_localised_choice_title_att_bel_request_justinian_photius_1FIRST	Ваші слова відновили мій розум, я підкорюся.	true
cdir_events_dilemma_choice_details_localised_choice_title_att_subject_religious_hellenic_illegal_practice_1SECOND	Ми толерантні до релігійних уподобань інших. Відпустити його.	true
cdir_events_dilemma_choice_details_localised_choice_title_ollam_ri_AFIRST	Багатий і могутній, друїд все ще залишається інструментом для інших.	true
cdir_events_dilemma_choice_details_localised_choice_title_att_subject_religious_zoroastrian_corpseFIRST	Він повинен заплатити за цей жахливий злочин.	true
cdir_events_dilemma_choice_details_localised_choice_label_political_event_assassination_success_discoveredSECOND	Проявити милосердя	true
cdir_events_dilemma_choice_details_localised_choice_label_att_political_action_dilemma_embezzlement_caughtFOURTH	Забути це	true
cdir_events_dilemma_choice_details_localised_choice_title_ollam_ri_ATHIRD	Ви хапаєте рибу і біжите. Старий за тобою не біжить.	true
cdir_events_dilemma_choice_details_localised_choice_title_att_subject_religious_germanic_illegal_practice_1SECOND	У наших очах це лише незначна хиба. Звільнити його.	true
cdir_events_dilemma_choice_details_localised_choice_title_att_subject_religious_zoroastrian_corpseTHIRD	Горе явно звело чоловіка з розуму.	true
cdir_events_dilemma_choice_details_localised_choice_label_ybor_level_A_langobardiFIRST	Чарівний меч	true
cdir_events_dilemma_choice_details_localised_choice_label_att_political_action_dilemma_secure_loyalty_mutilationSECOND	Осліпити	true
cdir_events_dilemma_choice_details_localised_choice_label_att_dilemma_religious_christian_the_manichean_heresy_1SECOND	Жити у злагоді	true
cdir_events_dilemma_choice_details_localised_choice_label_cha_dilemma_mercia_1FIRST	Дозволити йому піти	true
cdir_events_dilemma_choice_details_localised_choice_title_att_subject_religious_none_the_relic_seller_1FIRST	Це не те, про що ми повинні хвилюватися.	true
cdir_events_dilemma_choice_details_localised_choice_title_political_event_adoptionFIRST	Ми не допустимо цього.	true
cdir_events_dilemma_choice_details_localised_choice_title_att_political_action_dilemma_assassinate_caughtTHIRD	Вони можуть захистити себе. Давайте не втручатися в хід правосуддя.	true
cdir_events_dilemma_choice_details_localised_choice_title_att_subject_religious_celtic_pilgrims_1SECOND	Ці варвари повинні поспішно залишити наші землі. Хто знає, що вони можуть задумати.	true
cdir_events_dilemma_choice_details_localised_choice_title_att_subject_domestic_roman_slave_murdererFOURTH	Нічого доброго з цього не вийде.	true
cdir_events_dilemma_choice_details_localised_choice_title_att_subject_religious_none_the_relic_seller_1THIRD	Ця погана поведінка є образою перед Богом. Закладаюся, що в цьому негіднику є щось пунічне, карфагенське! його треба терміново притягнути до відповідальності.	true
cdir_events_dilemma_choice_details_localised_choice_title_att_subject_politics_barb_nomad_tribal_loyaltyFOURTH	Воїни не завжди ладнають, навіщо Вам втручатися? Це природний порядок речей.	true
cdir_events_dilemma_choice_details_localised_choice_label_att_subject_religious_tengri_illegal_practice_1SECOND	Звільнити його	true
cdir_events_dilemma_choice_details_localised_choice_title_att_political_action_dilemma_assassinate_caughtFIRST	Просто вони опинилися не в тому місці в невідповідний час.	true
cdir_events_dilemma_choice_details_localised_choice_label_cha_dilemma_carloman_successionFOURTH	Нічого не робити	true
cdir_events_dilemma_choice_details_localised_choice_title_att_subject_domestic_none_foreign_migrants_1THIRD	Давайте рознесемо їх так, щоб вони не жили в одній місцевості. Роблячи це, ми обмежуємо вплив, який вони можуть мати на нашу культуру.	true
cdir_events_dilemma_choice_details_localised_choice_label_att_subject_nomadic_tribal_strife_1FIRST	Ігнорувати їх	true
cdir_events_dilemma_choice_details_localised_choice_label_att_subject_politics_barb_nomad_challengerFIRST	Нехай він говорить	true
cdir_events_dilemma_choice_details_localised_choice_label_att_subject_religious_zoroastrian_brazierSECOND	Убити його	true
cdir_events_dilemma_choice_details_localised_choice_label_att_subject_military_none_the_gift_of_speed_1THIRD	Відправити їх в армію	true
cdir_events_dilemma_choice_details_localised_choice_title_att_subject_religious_manichaeism_pilgrims_1FIRST	Їхні справи не стосуються нас.	true
cdir_events_dilemma_choice_details_localised_choice_label_att_subject_religious_barb_stonesFIRST	Надіслати мудреця	true
cdir_events_dilemma_choice_details_localised_choice_label_att_subject_domestic_roman_the_chariot_races_1FIRST	Ігнорувати проблему	true
cdir_events_dilemma_choice_details_localised_choice_label_att_subject_religious_tengri_pilgrims_1SECOND	Заборонити	true
cdir_events_dilemma_choice_details_localised_choice_label_att_eos_religious_event_rebellion_att_fact_himyar_att_rel_judaismSECOND	Купити його	true
cdir_events_dilemma_choice_details_localised_choice_title_att_subject_domestic_none_foreign_migrants_1FIRST	Якої шкоди вони можуть завдати? Ці люди можуть йти, куди їм заманеться.	true
cdir_events_dilemma_choice_details_localised_choice_label_att_subject_nomadic_tribal_strife_1THIRD	Вигнати обидві групи	true
cdir_events_dilemma_choice_details_localised_choice_title_att_subject_domestic_civil_married_slavesSECOND	Обидва вірні Вам, але цього не можна допустити.	true
cdir_events_dilemma_choice_details_localised_choice_label_att_subject_politics_barb_nomad_challengerTHIRD	Убити його	true
cdir_events_dilemma_choice_details_localised_choice_label_att_subject_military_none_the_gift_of_speed_1FIRST	Ігнорувати його	true
cdir_events_dilemma_choice_details_localised_choice_title_att_subject_religious_manichaeism_pilgrims_1THIRD	Для цих людей це свято є святим. Яку шкоду вони завдадуть державі?	true
cdir_events_dilemma_choice_details_localised_choice_label_att_subject_religious_barb_stonesTHIRD	Кривава жертва	true
cdir_events_dilemma_choice_details_localised_choice_title_att_subject_religious_celtic_illegal_practice_1SECOND	Ми доброзичливий народ і терпимо ставимося до чужої слабкості. Звільнити її.	true
cdir_events_dilemma_choice_details_localised_choice_title_political_event_assassination_success_discoveredFIRST	Він заплатить за це своїм життям!	true
cdir_events_dilemma_choice_details_localised_choice_label_att_subject_domestic_barb_nomad_hostile_disputeFOURTH	Нічого не робити	true
cdir_events_dilemma_choice_details_localised_choice_label_att_political_action_dilemma_seek_bride_successFIRST	Одружитися з нею	true
cdir_events_dilemma_choice_details_localised_choice_label_att_subject_domestic_roman_the_chariot_races_1THIRD	Поставити на зелених	true
cdir_events_dilemma_choice_details_localised_choice_label_att_subject_domestic_none_the_silk_trader_1FIRST	Ігнорувати його	true
cdir_events_dilemma_choice_details_localised_choice_title_att_subject_religious_zoroastrian_brazierFOURTH	Це справа священників.	true
cdir_events_dilemma_choice_details_localised_choice_title_att_subject_religious_zoroastrian_pilgrims_1THIRD	Хто ми такі, щоб кидати виклик переконанням інших? Вони не зможуть впливати на наші.	true
cdir_events_dilemma_choice_details_localised_choice_title_cha_dilemma_viking_1_cha_fact_merciaFIRST	Ми візьмемо Ваші гроші та збережемо Ваші життя.	true
cdir_events_dilemma_choice_details_localised_choice_label_att_dilemma_religious_christian_the_manichean_heresy_1FIRST	Вони єретики	true
cdir_events_dilemma_choice_details_localised_choice_label_att_political_action_dilemma_marriage_impedimentTHIRD	Забути це	true
cdir_events_dilemma_choice_details_localised_choice_label_att_subject_diplomatic_none_turncoat_1THIRD	Надати йому притулок	true
cdir_events_dilemma_choice_details_localised_choice_title_ollam_ri_ebdaniFIRST	Чорне дзеркало його поверхні відображає всі таємниці людства.	true
cdir_events_dilemma_choice_details_localised_choice_title_att_subject_domestic_barb_nomad_hostile_disputeSECOND	Зробити приклад для всіх. Виженіть його в дальній куток свого царства.	true
cdir_events_dilemma_choice_details_localised_choice_label_att_subject_domestic_none_the_silk_trader_1THIRD	Ув'язнити його	true
cdir_events_dilemma_choice_details_localised_choice_title_att_subject_religious_christian_the_black_sheep_1SECOND	Щоб диякон залишався таким, його родина повинна офіційно прийняти християнство.	true
cdir_events_dilemma_choice_details_localised_choice_label_att_subject_domestic_civil_married_slavesFOURTH	Нічого не робити	true
cdir_events_dilemma_choice_details_localised_choice_title_att_subject_religious_zoroastrian_pilgrims_1FIRST	Справи прочан державі нецікаві.	true
cdir_events_dilemma_choice_details_localised_choice_title_cha_dilemma_viking_1_cha_fact_merciaTHIRD	Ти нас за дурнів маєш? Коли Ви всі помрете, те, що належить Вам, стане нашим, тому нам не потрібно буде з Вами торгуватися!	true
cdir_events_dilemma_choice_details_localised_choice_label_att_political_action_dilemma_seek_bride_successSECOND	Відвернутися від неї	true
cdir_events_dilemma_choice_details_localised_choice_title_att_subject_diplomatic_none_turncoat_1SECOND	Ми не посміхаємося над зрадою, якою б вигідною вона не була. Відправте його назад, краще не ображайте сусідів.	true
cdir_events_dilemma_choice_details_localised_choice_label_att_political_action_dilemma_marriage_impedimentFIRST	Хабар	true
cdir_events_dilemma_choice_details_localised_choice_label_att_subject_domestic_none_the_festival_1SECOND	Народ	true
cdir_events_dilemma_choice_details_localised_choice_label_att_subject_diplomatic_none_turncoat_1FIRST	Ігнорувати його	true
cdir_events_dilemma_choice_details_localised_choice_title_att_dilemma_religious_orthodox_religious_sanctions_1FIRST	Усі люди в наших очах рівні. До православних християн потрібно ставитися так само, як до всіх інших.	true
cdir_events_dilemma_choice_details_localised_choice_title_att_political_action_dilemma_diminish_popularity_reversalSECOND	Нехай буде відомо, що такі ганебні дії не залишаться безкарними.	true
cdir_events_dilemma_choice_details_localised_choice_title_att_subject_domestic_barb_temple_sacrilegeTHIRD	Покарати боягуза і заслужити благоговіння перед богами.	true
cdir_events_dilemma_choice_details_localised_choice_title_cha_dilemma_carloman_successionSECOND	Підтримати сина	true
cdir_events_dilemma_choice_details_localised_choice_title_cha_dilemma_carloman_successionFIRST	Вимагати право власності	true
cdir_events_dilemma_choice_details_localised_choice_label_att_dilemma_military_none_war_child_1FIRST	Взяти дитину	true
cdir_events_dilemma_choice_details_localised_choice_label_att_subject_domestic_roman_slave_murdererSECOND	Повідомити про нього	true
cdir_events_dilemma_choice_details_localised_choice_title_att_subject_domestic_barb_temple_sacrilegeFIRST	Щедрий внесок на храм має вирішити цю проблему.	true
cdir_events_dilemma_choice_details_localised_choice_title_cha_dilemma_carloman_successionTHIRD	Фінансувати сепаратистів	true
cdir_events_dilemma_choice_details_localised_choice_label_att_subject_domestic_roman_slave_murdererFOURTH	Нічого не робити	true
cdir_events_dilemma_choice_details_localised_choice_title_cha_dilemma_mercia_1FIRST	Нам боляче втрачати Вас, але ми стояти проти Вас.	true
cdir_events_dilemma_choice_details_localised_choice_label_political_event_adoptionFIRST	Запобігти цьому	true
cdir_events_dilemma_choice_details_localised_choice_title_cha_dilemma_viking_1_cha_fact_northumbriaFIRST	Ми візьмемо Ваші гроші та збережемо Ваші життя.	true
cdir_events_dilemma_choice_details_localised_choice_label_att_subject_religious_celtic_pilgrims_1SECOND	Заборонити	true
cdir_events_dilemma_choice_details_localised_choice_title_att_subject_religious_tengri_illegal_practice_1SECOND	Ми толерантні до релігійних уподобань інших. Відпустити його.	true
cdir_events_dilemma_choice_details_localised_choice_title_cha_dilemma_viking_1_cha_fact_northumbriaTHIRD	Ти нас за дурнів маєш? Коли Ви всі помрете, те, що належить Вам, стане нашим, тому нам не потрібно буде з Вами торгуватися!	true
cdir_events_dilemma_choice_details_localised_choice_title_cha_dilemma_carloman_successionFOURTH	Нічого не робити	true
cdir_events_dilemma_choice_details_localised_choice_label_att_subject_domestic_none_withholding_taxes_1FIRST	Ігнорувати цю проблему	true
cdir_events_dilemma_choice_details_localised_choice_label_att_subject_domestic_none_foreign_migrants_1THIRD	Розігнати їх	true
cdir_events_dilemma_choice_details_localised_choice_title_att_eos_religious_event_rebellion_att_fact_himyar_att_rel_judaismSECOND	Його люди достатньо постраждали, якщо ми зможемо загладити провину, нехай буде так.	true
cdir_events_dilemma_choice_details_localised_choice_label_att_subject_domestic_civil_married_slavesSECOND	Відмовити їм	true
cdir_events_dilemma_choice_details_localised_choice_title_att_subject_politics_barb_nomad_challengerTHIRD	Забийте цього піцвинка.	true
cdir_events_dilemma_choice_details_localised_choice_title_att_dilemma_domestic_none_plentiful_harvest_1FIRST	Людям має бути корисний цей дар провидіння.	true
cdir_events_dilemma_choice_details_localised_choice_label_att_subject_religious_manichaeism_pilgrims_1FIRST	Нічого не робити	true
cdir_events_dilemma_choice_details_localised_choice_title_ybor_level_C_1SECOND	На самоті Ібор крокує вперед із солодкими словами переконання та примирення.	true
cdir_events_dilemma_choice_details_localised_choice_title_ybor_level_C_2SECOND	Будь-яка людина може позбавити життя, тільки величні можуть дати його.	true
cdir_events_dilemma_choice_details_localised_choice_title_ybor_level_C_3SECOND	Ібор відступає на священну галявину, щоб шукати ліки безпосередньо у Годана.	true
cdir_events_dilemma_choice_details_localised_choice_title_ybor_level_C_4SECOND	Риторика Ібора не потребує божественної підтримки – він обирає короля.	true
cdir_events_dilemma_choice_details_localised_choice_title_ybor_level_B_1SECOND	Годан свідок, йому відплатять.	true
cdir_events_dilemma_choice_details_localised_choice_title_ybor_level_B_2SECOND	Авторитетними словами Ібор спонукає селян до дії.	true
cdir_events_dilemma_choice_details_localised_choice_label_att_subject_domestic_none_the_festival_1FOURTH	Обряд	true
cdir_events_dilemma_choice_details_localised_choice_title_att_subject_domestic_roman_the_chariot_races_1THIRD	Настав час зеленим бути злими! Поставте весь бюджет санітарії на наступний рік на зелених.	true
cdir_events_dilemma_choice_details_localised_choice_title_att_subject_religious_tengri_pilgrims_1SECOND	Розігнати підлих язичників. Убити всіх, хто наважиться залишитися біля річки на світанку.	true
cdir_events_dilemma_choice_details_localised_choice_title_att_subject_domestic_roman_slave_murdererTHIRD	Що зробив цей чоловік після того, як залишив Вашу службу, Вас не хвилює.	true
cdir_events_dilemma_choice_details_localised_choice_label_att_subject_domestic_none_withholding_taxes_1THIRD	Вмовити їх	true
cdir_events_dilemma_choice_details_localised_choice_label_att_subject_domestic_none_foreign_migrants_1FIRST	Ігнорувати проблему	true
cdir_events_dilemma_choice_details_localised_choice_title_att_subject_politics_barb_nomad_challengerFIRST	Його нахабство уб'є його.	true
cdir_events_dilemma_choice_details_localised_choice_title_att_subject_religious_zoroastrian_brazierSECOND	Це не дрібна провина, хлопчика треба покарати.	true
cdir_events_dilemma_choice_details_localised_choice_label_att_subject_religious_manichaeism_pilgrims_1THIRD	Дозволити	true
cdir_events_dilemma_choice_details_localised_choice_label_political_event_assassination_success_discoveredFIRST	Стратити його	true
cdir_events_dilemma_choice_details_localised_choice_label_att_subject_religious_celtic_illegal_practice_1SECOND	Звільнити її	true
cdir_events_dilemma_choice_details_localised_choice_label_political_event_marriage_femaleFIRST	Втручатися	true
cdir_events_dilemma_choice_details_localised_choice_title_att_subject_domestic_roman_the_chariot_races_1FIRST	Я не буду витрачати наше багатство на ці дрібниці. Більше не говоріть про перегони та ставки.	true
cdir_events_dilemma_choice_details_localised_choice_title_att_subject_domestic_roman_slave_murdererFIRST	Найбезпечніший спосіб дій — змусити його замовкнути назавжди.	true
cdir_events_dilemma_choice_details_localised_choice_title_att_subject_domestic_barb_nomad_hostile_disputeFOURTH	Ці речі неминучі, ситуація вирішиться.	true
cdir_events_dilemma_choice_details_localised_choice_label_att_subject_religious_zoroastrian_pilgrims_1THIRD	Дозволити їм	true
cdir_events_dilemma_choice_details_localised_choice_label_cha_dilemma_viking_1_cha_fact_merciaFIRST	Взяти золото	true
cdir_events_dilemma_choice_details_localised_choice_label_att_subject_religious_christian_the_black_sheep_1SECOND	Змусити її навернутися	true
cdir_events_dilemma_choice_details_localised_choice_title_att_subject_domestic_civil_married_slavesFOURTH	Це не варте Вашого часу.	true
cdir_events_dilemma_choice_details_localised_choice_title_att_political_action_dilemma_marriage_impedimentTHIRD	Це нас не стосується. У нас є важливіші справи.	true
cdir_events_dilemma_choice_details_localised_choice_label_att_subject_domestic_barb_nomad_hostile_disputeSECOND	Відіслати його геть	true
cdir_events_dilemma_choice_details_localised_choice_title_att_subject_diplomatic_none_turncoat_1FIRST	Мені байдужі його благання, цей зрадник сам про себе подбає.	true
cdir_events_dilemma_choice_details_localised_choice_label_att_eos_religious_event_rebellion_att_fact_himyar_att_rel_judaismFIRST	Вигнати його	true
cdir_events_dilemma_choice_details_localised_choice_label_att_subject_religious_zoroastrian_brazierFIRST	Покарати його	true
cdir_events_dilemma_choice_details_localised_choice_label_att_subject_domestic_barb_nomad_hostile_disputeTHIRD	Критикувати свого опонента	true
cdir_events_dilemma_choice_details_localised_choice_label_att_subject_religious_zoroastrian_pilgrims_1FIRST	Ігнорувати його	true
cdir_events_dilemma_choice_details_localised_choice_label_cha_dilemma_viking_1_cha_fact_merciaTHIRD	Відмовитися від пропозиції	true
cdir_events_dilemma_choice_details_localised_choice_label_att_subject_religious_zoroastrian_brazierFOURTH	Нічого не робити	true
cdir_events_dilemma_choice_details_localised_choice_title_att_political_action_dilemma_seek_bride_successSECOND	Ні, вона не та, яку ми шукаємо.	true
cdir_events_dilemma_choice_details_localised_choice_title_att_dilemma_religious_christian_the_manichean_heresy_1FIRST	Їхнє вчення зіпсує добрих християн, якщо дозволити цьому продовжуватися.	true
cdir_events_dilemma_choice_details_localised_choice_title_att_political_action_dilemma_marriage_impedimentFIRST	Можливо, це їх переконає?	true
cdir_events_dilemma_choice_details_localised_choice_title_att_subject_diplomatic_none_turncoat_1THIRD	Будь-яке знання є цінним, незалежно від його джерела. Нехай ця людина залишиться, принаймні, поки вона буде корисною…	true
cdir_events_dilemma_choice_details_localised_choice_label_att_subject_religious_zoroastrian_brazierTHIRD	Пробачити йому	true
cdir_events_dilemma_choice_details_localised_choice_label_att_subject_domestic_barb_nomad_hostile_disputeFIRST	Покарати його	true
cdir_events_dilemma_choice_details_localised_choice_label_att_dilemma_religious_orthodox_religious_sanctions_1FIRST	Дати їм рівні права	true
cdir_events_dilemma_choice_details_localised_choice_title_att_subject_domestic_roman_slave_murdererSECOND	Ваш обов'язок повідомити про злочини цієї людини.	true
cdir_events_dilemma_choice_details_localised_choice_title_att_subject_military_none_war_child_1FIRST	Просто вдайте, що ми не чули. Яка дитина?	true
cdir_events_dilemma_choice_details_localised_choice_label_att_subject_domestic_barb_temple_sacrilegeFIRST	Відкупитися від храму	true
cdir_events_dilemma_choice_details_localised_choice_title_att_subject_politics_barb_nomad_tribal_loyaltySECOND	Все плем'я вирішить, хто кращий!	true
cdir_events_dilemma_choice_details_localised_choice_label_political_event_blackmailFIRST	Купити його	true
cdir_events_dilemma_choice_details_localised_choice_label_cha_dilemma_carloman_successionSECOND	Підтримати сина	true
cdir_events_dilemma_choice_details_localised_choice_title_att_subject_military_none_war_child_1THIRD	Він заслуговує знати правду. Кожен чоловік повинен знати своє походження.	true
cdir_events_dilemma_choice_details_localised_choice_label_att_political_action_dilemma_diminish_popularity_reversalSECOND	Засудити	true
cdir_events_dilemma_choice_details_localised_choice_label_att_subject_domestic_barb_temple_sacrilegeTHIRD	Покарати його власноруч	true
cdir_events_dilemma_choice_details_localised_choice_label_cha_dilemma_mercia_2_2SECOND	Погрожувати йому	true
cdir_events_dilemma_choice_details_localised_choice_label_att_subject_domestic_roman_the_chariot_races_1SECOND	Поставити на синіх 	true
cdir_events_dilemma_choice_details_localised_choice_title_att_subject_domestic_civil_master_agitatorFIRST	Почнемо з чистого аркушу.	true
cdir_events_dilemma_choice_details_localised_choice_title_att_political_action_dilemma_diminish_popularity_followup_mercifulTHIRD	Він нас не стосується. Ми не дбаємо про його репутацію.	true
cdir_events_dilemma_choice_details_localised_choice_label_att_subject_politics_barb_nomad_tribal_loyaltyFOURTH	Нічого не робити	true
cdir_events_dilemma_choice_details_localised_choice_label_att_political_action_dilemma_assassinate_caughtFIRST	Виправдати	true
cdir_events_dilemma_choice_details_localised_choice_label_att_subject_military_none_the_lanista_1SECOND	Тренувати ветеранів	true
cdir_events_dilemma_choice_details_localised_choice_title_att_subject_domestic_civil_master_agitatorTHIRD	Підбурюйте претензії цього політика, звинувачуйте його в цьому безладі!	true
cdir_events_dilemma_choice_details_localised_choice_title_att_dilemma_military_none_war_child_1FIRST	Ми не можемо залишити беззахисну дитину в цьому жахливому місці.	true
cdir_events_dilemma_choice_details_localised_choice_title_att_political_action_dilemma_diminish_popularity_followup_mercifulFIRST	Нехай буде відомо, що з цього приводу його було виправдано. Однак наступного разу ми можемо не бути такими милосердними…	true
cdir_events_dilemma_choice_details_localised_choice_label_att_political_action_dilemma_assassinate_caughtTHIRD	Забути це	true
cdir_events_dilemma_choice_details_localised_choice_title_att_eos_religious_event_rebellion_att_fact_axum_att_rel_semitic_paganismFIRST	У нас немає ні часу, ні грошей на цих єретиків, щоб реагувати на їхні порожні погрози.	true
cdir_events_dilemma_choice_details_localised_choice_label_slav_dilemma_anteans_1FIRST	Відправити його назад до римлян	true
cdir_events_dilemma_choice_details_localised_choice_title_att_subject_domestic_none_excess_materials_1FIRST	Будівля закінчена. Чому я маю піклуватися про залишки каменю?	true
cdir_events_dilemma_choice_details_localised_choice_title_att_subject_nomadic_tribal_strife_1THIRD	У нас немає часу на Ваші пустощі, забирайте свої речі і йдіть.	true
cdir_events_dilemma_choice_details_localised_choice_title_att_subject_religious_zoroastrian_illegal_practice_1THIRD	Я сумніваюся, що щось може змінити думку цього простого дурня. Нехай гниє в підземеллях.	true
cdir_events_dilemma_choice_details_localised_choice_label_slav_dilemma_anteans_2FIRST	Відпустити його	true
cdir_events_dilemma_choice_details_localised_choice_title_att_political_action_dilemma_seek_bride_successFIRST	Так! Вона файна панночка — це все, що можна бажати від дружини.	true
cdir_events_dilemma_choice_details_localised_choice_label_att_dilemma_religious_hellenic_religious_sanctions_1FIRST	Дати їм рівні права	true
cdir_events_dilemma_choice_details_localised_choice_label_att_dilemma_religious_germanic_religious_sanctions_1FIRST	Дати їм рівні права	true
cdir_events_dilemma_choice_details_localised_choice_title_att_subject_domestic_nomadic_the_kassai_contest_1SECOND	Його думка повинна бути зосереджена на війні, а не на іграх. У нас є плани, і він тут потрібен.	true
cdir_events_dilemma_choice_details_localised_choice_title_att_subject_domestic_none_excess_materials_1THIRD	Якщо ми не можемо використати ці матеріали, ми повинні принаймні спробувати відшкодувати частину наших витрат.	true
cdir_events_dilemma_choice_details_localised_choice_title_att_subject_nomadic_tribal_strife_1FIRST	Їхня хвиля зрештою вичерпається.	true
cdir_events_dilemma_choice_details_localised_choice_title_att_subject_religious_zoroastrian_illegal_practice_1FIRST	Убити цю людину публічно, як приклад для всіх.	true
cdir_events_dilemma_choice_details_localised_choice_title_att_dilemma_religious_christian_council_of_ephesus_1FIRST	Цей чоловік проповідував проти єдності Всемогутнього Бога Сина, Бога Отеця і Духа Святого як єдине неподільного цілого.	true
cdir_events_dilemma_choice_details_localised_choice_title_att_eos_sassanid_insult_1SECOND	Спробувати змінити тему якомога обережніше, давши свою згоду.	true
cdir_events_dilemma_choice_details_localised_choice_title_att_eos_sassanid_insult_2SECOND	Не ставити власну пиху вище безпеки своїх людей.	true
cdir_events_dilemma_choice_details_localised_choice_title_att_eos_sassanid_insult_3SECOND	Догоджати королю, ризикуєте глибоко поранити гордість свого народу, коли про це дізнаються.	true
cdir_events_dilemma_choice_details_localised_choice_title_att_subject_domestic_none_the_festival_1SECOND	Ми повинні відзначати тих, хто підтримує наше суспільство. Це має пом'якшити удар необхідного оподаткування.	true
cdir_events_dilemma_choice_details_localised_choice_label_ybor_level_C_4FIRST	Пропозиція проповідника	true
cdir_events_dilemma_choice_details_localised_choice_label_att_subject_politics_civil_secret_meetingsTHIRD	Порушити плани	true
cdir_events_dilemma_choice_details_localised_choice_title_att_subject_domestic_none_the_silk_trader_1THIRD	Його дешеві товари зашкодять нашій місцевій торгівлі. Нам слід прибрати його з вулиць, поки наші торговці не почнуть страждати.	true
cdir_events_dilemma_choice_details_localised_choice_title_att_subject_religious_manichaeism_illegal_practice_1FIRST	Убити цього мерзенного культиста як приклад для інших.	true
cdir_events_dilemma_choice_details_localised_choice_title_att_subject_military_none_the_gift_of_speed_1THIRD	Це має дещо знизити наші витрати на підбір персоналу. Тренуйте їх для війни!	true
cdir_events_dilemma_choice_details_localised_choice_label_att_political_action_dilemma_embezzlement_caughtTHIRD	Засудити	true
cdir_events_dilemma_choice_details_localised_choice_label_att_subject_diplomatic_none_turncoat_1SECOND	Відправити його назад	true
cdir_events_dilemma_choice_details_localised_choice_title_att_subject_religious_none_the_golden_tongued_1SECOND	Якби його відправили в чужі краї, він міг би донести всім слово про істинну релігію...	true
cdir_events_dilemma_choice_details_localised_choice_title_att_subject_religious_barb_stonesFIRST	Це був мудрий чоловік, який перетворив воїнів на камінь багато років тому.	true
cdir_events_dilemma_choice_details_localised_choice_label_ybor_level_C_3FIRST	Рукопокласти	true
cdir_events_dilemma_choice_details_localised_choice_label_att_dilemma_religious_catholic_religious_sanctions_1FIRST	Дати їм рівні права	true
cdir_events_dilemma_choice_details_localised_choice_label_att_subject_politics_civil_secret_meetingsFIRST	Все одно вбити їх	true
cdir_events_dilemma_choice_details_localised_choice_title_att_subject_domestic_none_the_silk_trader_1FIRST	Добре для нього. Єдиний закон у таких питаннях – попит і пропозиція!	true
cdir_events_dilemma_choice_details_localised_choice_title_att_subject_religious_manichaeism_illegal_practice_1THIRD	Нехай його фальшивий бог виведе його з підземель. Не кажіть більше про цього негідника.	true
cdir_events_dilemma_choice_details_localised_choice_title_att_subject_military_none_the_gift_of_speed_1FIRST	Зараз ми не зацікавлені в цьому.	true
cdir_events_dilemma_choice_details_localised_choice_label_att_political_action_dilemma_embezzlement_caughtFIRST	Прикриття	true
cdir_events_dilemma_choice_details_localised_choice_title_att_subject_religious_barb_stonesTHIRD	Вони прийшли по кров, тільки кров може повернути цих неспокійних духів у потойбічний світ.	true
cdir_events_dilemma_choice_details_localised_choice_label_ollam_ri_ebdaniFIRST	Він прямує до озера.	true
cdir_events_dilemma_choice_details_localised_choice_label_ybor_level_B_2FIRST	Через вогонь	true
cdir_events_dilemma_choice_details_localised_choice_label_ybor_level_C_2FIRST	Руйнувати	true
cdir_events_dilemma_choice_details_localised_choice_label_ollam_ri_ebdaniSECOND	Він прямує до лісу.	true
cdir_events_dilemma_choice_details_localised_choice_label_cha_dilemma_pope_help_1SECOND	На боці лангобардів	true
cdir_events_dilemma_choice_details_localised_choice_label_att_eos_religious_event_rebellion_att_fact_himyar_att_rel_semitic_paganismFIRST	Вигнати його	true
cdir_events_dilemma_choice_details_localised_choice_title_att_subject_domestic_nordic_the_flyting_1SECOND	Ха! Немов боягузливі собаки, що смокчуть соску, вони біжать до своїх матерів, підібгавши хвости!	true
cdir_events_dilemma_choice_details_localised_choice_label_att_subject_religious_none_the_relic_seller_1FIRST	Нічого не робити	true
cdir_events_dilemma_choice_details_localised_choice_title_political_event_assassination_failure_discoveredFIRST	Геть його голову з плечей!	true
cdir_events_dilemma_choice_details_localised_choice_label_att_subject_diplomatic_none_the_feast_1SECOND	Запросити наших сусідів	true
cdir_events_dilemma_choice_details_localised_choice_title_cha_dilemma_mercia_2_2FIRST	Пробач мою гордість, благородний Алкуїне. Проклади свій шлях на новій землі.	true
cdir_events_dilemma_choice_details_localised_choice_label_ybor_level_B_1FIRST	Поет	true
cdir_events_dilemma_choice_details_localised_choice_label_ybor_level_C_1FIRST	Славний наступ	true
cdir_events_dilemma_choice_details_localised_choice_label_cha_dilemma_carloman_successionTHIRD	Фінансувати сепаратистів	true
cdir_events_dilemma_choice_details_localised_choice_label_att_dilemma_religious_arian_religious_sanctions_1SECOND	Накласти санкції	true
cdir_events_dilemma_choice_details_localised_choice_label_att_subject_religious_none_the_relic_seller_1THIRD	Викрити його злочини	true
cdir_events_dilemma_choice_details_localised_choice_label_cha_dilemma_carloman_successionFIRST	Вимагайте його землі	true
cdir_events_dilemma_choice_details_localised_choice_label_att_subject_military_none_war_child_1FIRST	Ігнорувати його	true
cdir_events_dilemma_choice_details_localised_choice_label_att_subject_domestic_civil_master_agitatorTHIRD	Порушити плани	true
cdir_events_dilemma_choice_details_localised_choice_label_att_political_action_dilemma_diminish_popularity_followup_mercifulFIRST	Хіба я не милосердний?	true
cdir_events_dilemma_choice_details_localised_choice_title_political_event_blackmailFIRST	Можливо, це змусить його замовкнути?	true
cdir_events_dilemma_choice_details_localised_choice_title_slav_dilemma_anteans_1FIRST	Рим — могутня імперія — їхній гнів великий, але їхня дружба безцінна…	true
cdir_events_dilemma_choice_details_localised_choice_title_att_subject_military_none_the_lanista_1SECOND	Він може передати свій досвід наступним поколінням. На арену його.	true
cdir_events_dilemma_choice_details_localised_choice_label_att_subject_military_none_war_child_1THIRD	Сказати правду	true
cdir_events_dilemma_choice_details_localised_choice_label_att_subject_domestic_civil_master_agitatorFIRST	Ігнорувати борги	true
cdir_events_dilemma_choice_details_localised_choice_label_att_political_action_dilemma_diminish_popularity_followup_mercifulTHIRD	Забути це	true
cdir_events_dilemma_choice_details_localised_choice_label_att_eos_religious_event_rebellion_att_fact_axum_att_rel_semitic_paganismFIRST	Вигнати його	true
cdir_events_dilemma_choice_details_localised_choice_label_att_subject_religious_zoroastrian_illegal_practice_1THIRD	Залишити його у в'язниці	true
cdir_events_dilemma_choice_details_localised_choice_label_att_eos_sassanid_insult_1SECOND	Погодитися з ним	true
cdir_events_dilemma_choice_details_localised_choice_label_att_eos_sassanid_insult_2SECOND	Вибачитися	true
cdir_events_dilemma_choice_details_localised_choice_label_att_eos_sassanid_insult_3SECOND	Сказати, що він хоче	true
cdir_events_dilemma_choice_details_localised_choice_label_att_subject_domestic_nomadic_the_kassai_contest_1SECOND	Запобігти його участі	true
cdir_events_dilemma_choice_details_localised_choice_label_att_subject_domestic_none_excess_materials_1FIRST	Ігнорувати проблему	true
cdir_events_dilemma_choice_details_localised_choice_title_political_event_marriage_femaleFIRST	Цей чоловік не гідний її руки.	true
cdir_events_dilemma_choice_details_localised_choice_title_att_subject_religious_zoroastrian_brazierFIRST	Цьому хлопчику потрібно навчитися більш серйозно ставитися до своїх обов’язків.	true
cdir_events_dilemma_choice_details_localised_choice_title_att_eos_religious_event_rebellion_att_fact_himyar_att_rel_judaismFIRST	У нас немає ні часу, ні грошей на цих єретиків, щоб реагувати на їхні порожні погрози.	true
cdir_events_dilemma_choice_details_localised_choice_title_ybor_level_C_4FIRST	Хіба бог не більший за царя? Ібор приймає пропозицію проповідника.	true
cdir_events_dilemma_choice_details_localised_choice_title_att_dilemma_religious_germanic_religious_sanctions_1FIRST	Усі люди в наших очах рівні. До язичників треба ставитися так само, як до всіх інших.	true
cdir_events_dilemma_choice_details_localised_choice_title_att_dilemma_religious_hellenic_religious_sanctions_1FIRST	У наших очах усі люди рівні. До язичників треба ставитися так само, як до всіх інших.	true
cdir_events_dilemma_choice_details_localised_choice_label_att_dilemma_religious_christian_council_of_ephesus_1FIRST	Засудити Несторія	true
cdir_events_dilemma_choice_details_localised_choice_label_att_subject_religious_zoroastrian_illegal_practice_1FIRST	Стратити його	true
cdir_events_dilemma_choice_details_localised_choice_label_att_subject_domestic_none_excess_materials_1THIRD	Продати надлишки	true
cdir_events_dilemma_choice_details_localised_choice_title_slav_dilemma_anteans_2FIRST	Те, що зроблено, не можна відмінити. Не витрачайте час на його переслідування.	true
cdir_events_dilemma_choice_details_localised_choice_label_ybor_level_C_1SECOND	Сутичка бажань	true
cdir_events_dilemma_choice_details_localised_choice_label_ybor_level_C_2SECOND	Загоєння	true
cdir_events_dilemma_choice_details_localised_choice_label_ybor_level_C_3SECOND	Шукати мудрості	true
cdir_events_dilemma_choice_details_localised_choice_label_ybor_level_C_4SECOND	Пропозиція короля	true
cdir_events_dilemma_choice_details_localised_choice_label_ybor_level_B_1SECOND	Жриця	true
cdir_events_dilemma_choice_details_localised_choice_label_ybor_level_B_2SECOND	Боріться з вогнем	true
cdir_events_dilemma_choice_details_localised_choice_title_att_subject_religious_zoroastrian_brazierTHIRD	Він молодий, але навчиться.	true
cdir_events_dilemma_choice_details_localised_choice_title_att_subject_politics_civil_secret_meetingsFIRST	Нічого доброго з цих зібрань не вийде, убийте всіх учасників, за чутками, і покінчіть із цим.	true
cdir_events_dilemma_choice_details_localised_choice_title_att_subject_domestic_none_withholding_taxes_1FIRST	Наразі ми не вживатимемо жодних заходів, але їхню поведінку було помічено.	true
cdir_events_dilemma_choice_details_localised_choice_label_att_subject_religious_manichaeism_illegal_practice_1FIRST	Стратити його	true
cdir_events_dilemma_choice_details_localised_choice_label_att_dilemma_domestic_none_plentiful_harvest_1FIRST	Віддати це людям	true
cdir_events_dilemma_choice_details_localised_choice_label_att_subject_religious_none_the_golden_tongued_1SECOND	Відправити його за кордон	true
cdir_events_dilemma_choice_details_localised_choice_title_att_political_action_dilemma_embezzlement_caughtTHIRD	Нехай буде відомо, що такі ганебні дії не залишаться безкарними.	true
cdir_events_dilemma_choice_details_localised_choice_title_att_subject_domestic_none_the_festival_1FOURTH	Ми повинні славити богів. Без їхнього благословення наш народ був би нічим.	true
cdir_events_dilemma_choice_details_localised_choice_label_att_subject_domestic_roman_slave_murdererTHIRD	Заперечувати всі знання	true
cdir_events_dilemma_choice_details_localised_choice_title_att_subject_domestic_barb_nomad_hostile_disputeFIRST	Винесіть йому публічну догану, щоб усі побачили, що такі дії — більше, ніж проста дурість.	true
cdir_events_dilemma_choice_details_localised_choice_title_ybor_level_B_2FIRST	Відчувши присутність Годана навколо себе, Ібор кидається у вогонь.	true
cdir_events_dilemma_choice_details_localised_choice_title_ybor_level_C_2FIRST	Знищити зло до того, як воно завдасть шкоди, цілитель ніколи не знадобиться.	true
cdir_events_dilemma_choice_details_localised_choice_title_att_dilemma_religious_catholic_religious_sanctions_1FIRST	Усі люди в наших очах рівні. До католиків треба ставитися так само, як до всіх інших.	true
cdir_events_dilemma_choice_details_localised_choice_title_att_subject_politics_civil_secret_meetingsTHIRD	Викличте цих змовників, нехай громадськість почує про їхній обман.	true
cdir_events_dilemma_choice_details_localised_choice_title_att_subject_domestic_none_withholding_taxes_1THIRD	Давайте використовувати переконання, щоб розрядити ситуацію. Можуть бути почуті справжні скарги.	true
cdir_events_dilemma_choice_details_localised_choice_label_att_subject_religious_manichaeism_illegal_practice_1THIRD	Залишити його у в'язниці	true
cdir_events_dilemma_choice_details_localised_choice_title_att_political_action_dilemma_embezzlement_caughtFIRST	Рухайтеся, рухайтеся. Тут нема чого дивитися…	true
cdir_events_dilemma_choice_details_localised_choice_title_ollam_ri_ebdaniSECOND	Первісні дерева обіцяють життя сміливим і смерть необережним.	true
cdir_events_dilemma_choice_details_localised_choice_title_cha_dilemma_pope_help_1SECOND	Давня обіцянка між старими людьми, нехай вона не торкається кордонів сьогодення.	true
cdir_events_dilemma_choice_details_localised_choice_label_att_subject_domestic_roman_slave_murdererFIRST	Заткнути його	true
cdir_events_dilemma_choice_details_localised_choice_title_att_subject_domestic_barb_nomad_hostile_disputeTHIRD	Що за ..., він твій син, і ти підтримаєш його!	true
cdir_events_dilemma_choice_details_localised_choice_title_ybor_level_C_3FIRST	Ібор спускається в село, щоб принести зцілення безпосередньо населенню.	true
cdir_events_dilemma_choice_details_localised_choice_title_cha_dilemma_mercia_2_2SECOND	Ви смієте кинути виклик своєму королю!? Ми побачимо, як далеко Ви просунетеся з розбитими колінами!	true
cdir_events_dilemma_choice_details_localised_choice_title_att_dilemma_religious_arian_religious_sanctions_1SECOND	Ми повинні прийняти закони, щоб обмежити права віросповідання цих єретиків.	true
cdir_events_dilemma_choice_details_localised_choice_title_att_subject_diplomatic_none_the_feast_1SECOND	Мають бути присутні господарі наших сусідніх держав. Така подія є корисною демонстрацією нашого багатства та могутності.	true
cdir_events_dilemma_choice_details_localised_choice_label_cha_dilemma_viking_1_cha_fact_northumbriaFIRST	Взяти золото	true
cdir_events_dilemma_choice_details_localised_choice_label_political_event_assassination_failure_discoveredFIRST	Стратити його	true
cdir_events_dilemma_choice_details_localised_choice_title_att_subject_domestic_roman_the_chariot_races_1SECOND	Я вважаю, що останній вершник синьої команди – це сенсація, вони однозначно стануть переможцями.	true
cdir_events_dilemma_choice_details_localised_choice_title_att_eos_religious_event_rebellion_att_fact_himyar_att_rel_semitic_paganismFIRST	У нас немає ні часу, ні грошей на цих єретиків, щоб реагувати на їхні порожні погрози.	true
cdir_events_dilemma_choice_details_localised_choice_label_att_subject_domestic_nordic_the_flyting_1SECOND	Брати участь особисто	true
cdir_events_dilemma_choice_details_localised_choice_label_att_subject_politics_barb_nomad_tribal_loyaltySECOND	Організувати бій	true
cdir_events_dilemma_choice_details_localised_choice_label_cha_dilemma_viking_1_cha_fact_northumbriaTHIRD	Відмовитися від пропозиції	true
cdir_events_dilemma_choice_details_localised_choice_label_cha_dilemma_mercia_2_2FIRST	Дозволити йому піти	true
cdir_events_dilemma_choice_details_localised_choice_title_ybor_level_B_1FIRST	Слова можуть закрутити людині голову і пронизати серце.	true
cdir_events_dilemma_choice_details_localised_choice_title_ybor_level_C_1FIRST	Із полум’яними закликами Ібор занурюється в серце натовпу.	true
