key	text	tooltip
#Loc;1;text/db/character_trait_levels.loc		
character_trait_levels_onscreen_name_att_trait_general_personality_all_arse_1	Цікавий	true
character_trait_levels_onscreen_name_att_trait_general_personality_all_arse_3	Все підійде	true
character_trait_levels_onscreen_name_att_trait_general_personality_all_arse_2	Гордий	true
character_trait_levels_onscreen_name_att_trait_general_military_all_high_casualties_2	Кровожерливий	true
character_trait_levels_onscreen_name_att_trait_general_military_all_high_casualties_3	Не брати полонених!	true
character_trait_levels_onscreen_name_att_trait_general_military_all_high_casualties_1	Трішки бордовий	true
character_trait_levels_colour_text_att_trait_general_government_all_authoritarian_2	Мої руки зв'язані. Правила є правила.	true
character_trait_levels_colour_text_att_trait_general_government_all_authoritarian_3	Милосердний уряд – це оксиморон.	true
character_trait_levels_colour_text_att_trait_general_government_all_authoritarian_1	Уряд є твердим, люблячим батьком народу.	true
character_trait_levels_colour_text_att_trait_general_military_army_all_ambusher_bad_1	Незважаючи на всі його зусилля, засідки цієї людини ніколи не спрацьовують, як планувалося.	true
character_trait_levels_colour_text_att_trait_general_military_army_all_ambusher_bad_2	Цей чоловік міг би також поставити знак «попереду засідка».	true
character_trait_levels_colour_text_att_trait_general_military_army_all_ambusher_bad_3	Цей чоловік не зміг організувати сварку в храмі Вакха, не кажучи вже про раптовий напад.	true
character_trait_levels_colour_text_att_trait_general_physical_all_innate_handsome_1	Я бачу, як ти дивишся. І так, я займаюся.	true
character_trait_levels_colour_text_att_trait_general_military_army_all_siege_defender_bad_2	Його вміння захисту легендарні, але не в кращому сенсі.	true
character_trait_levels_colour_text_att_trait_general_military_army_all_siege_defender_bad_3	Горе тому місту, яке залишиться під опікою цієї людини!	true
character_trait_levels_colour_text_att_trait_general_military_army_all_siege_defender_bad_1	Цей чоловік втратив не одне місто, але, на жаль, врятувався.	true
character_trait_levels_onscreen_name_att_trait_general_ability_all_power_5	Потужні весла V	true
character_trait_levels_onscreen_name_att_trait_general_ability_all_power_4	Потужні весла IV	true
character_trait_levels_onscreen_name_att_trait_general_ability_all_power_1	Потужні весла I	true
character_trait_levels_onscreen_name_att_trait_general_ability_all_power_3	Потужні весла III	true
character_trait_levels_onscreen_name_att_trait_general_ability_all_power_2	Потужні весла II	true
character_trait_levels_onscreen_name_att_trait_all_personality_all_sober_1	Тверезий	true
character_trait_levels_onscreen_name_att_trait_all_personality_all_sober_2	Стриманий	true
character_trait_levels_onscreen_name_att_trait_all_personality_all_sober_3	Непитущий до сліз	true
character_trait_levels_onscreen_name_att_trait_general_personality_all_dishonest_2	Нечесний	true
character_trait_levels_onscreen_name_att_trait_general_personality_all_dishonest_3	Великий шахрай	true
character_trait_levels_onscreen_name_att_trait_general_personality_all_dishonest_1	Ненадійний	true
character_trait_levels_onscreen_name_att_trait_spy_actions_all_investigator_3	Головоріз	true
character_trait_levels_onscreen_name_att_trait_spy_actions_all_investigator_2	Шантажист	true
character_trait_levels_onscreen_name_att_trait_spy_actions_all_investigator_1	Слідчий	true
character_trait_levels_onscreen_name_att_trait_general_government_all_admin_good_3	Досвідчений керівник	true
character_trait_levels_onscreen_name_att_trait_general_government_all_admin_good_2	Умілий адміністратор	true
character_trait_levels_onscreen_name_att_trait_general_government_all_admin_good_1	Адміністратор	true
character_trait_levels_colour_text_att_trait_general_physical_all_eunuch_1	Цей чоловік ідеальний, якщо Ви бажаєте квітів від шлюбу, а не плодів.	true
character_trait_levels_colour_text_att_trait_general_personality_roman_unpatriotic_1	Багато хто не схвалює іноземні смаки цієї людини.	true
character_trait_levels_colour_text_att_trait_general_personality_roman_unpatriotic_2	Цей чоловік захоплюється неримськими речами. Жахливий хлопець.	true
character_trait_levels_colour_text_att_trait_general_personality_roman_unpatriotic_3	Ця людина балакає плутано. І він ще називає себе римляном не вміючи говорити!	true
character_trait_levels_onscreen_name_att_trait_all_personality_all_easily_trapped_1	Легко потрапить в пастку	true
character_trait_levels_onscreen_name_att_trait_all_personality_all_innate_uncompromising_1	Безкомпромісність	true
character_trait_levels_colour_text_att_trait_general_ability_all_inspire_4	У бою ця людина надихає своїх воїнів на вчинки божевільного героїзму.	true
character_trait_levels_colour_text_att_trait_general_ability_all_inspire_5	У бою ця людина надихає своїх воїнів на вчинки божевільного героїзму.	true
character_trait_levels_colour_text_att_trait_general_ability_all_inspire_1	У бою ця людина надихає своїх воїнів на вчинки божевільного героїзму.	true
character_trait_levels_colour_text_att_trait_general_ability_all_inspire_2	У бою ця людина надихає своїх воїнів на вчинки божевільного героїзму.	true
character_trait_levels_colour_text_att_trait_general_ability_all_inspire_3	У бою ця людина надихає своїх воїнів на вчинки божевільного героїзму.	true
character_trait_levels_onscreen_name_cha_trait_pope_1	Папа	true
character_trait_levels_colour_text_att_trait_general_military_navy_all_defender_sea_good_3	Морські боги благословили цю людину тактичною кмітливістю.	true
character_trait_levels_colour_text_att_trait_general_military_navy_all_defender_sea_good_2	Ця людина зазвичай перемагає під час оборони на морі.	true
character_trait_levels_colour_text_att_trait_general_military_navy_all_defender_sea_good_1	Ця людина розуміється на захисті в морі.	true
character_trait_levels_colour_text_att_trait_general_personality_all_mad_3	Я маленький горщик гарум, низький і кремезний…	true
character_trait_levels_colour_text_att_trait_general_personality_all_mad_2	Мені подобаються твої очі. У тебе гарні очі. Дуже гарні очі. так	true
character_trait_levels_colour_text_att_trait_general_personality_all_mad_1	Це важливо? Дз-ж-ж-ж! Дз-ж-ж-ж! Я сьогодні не зробив достатньо меду! Дз-ж-ж-ж!	true
character_trait_levels_colour_text_att_trait_all_personality_all_atheist_2	Поклоніння? Чому я хочу це зробити?	true
character_trait_levels_colour_text_att_trait_all_personality_all_atheist_3	Невже я виглядаю настільки дурним, щоб повірити в великих, бородатих, злих чоловіків у небі?	true
character_trait_levels_colour_text_att_trait_all_personality_all_atheist_1	Кожного разу, коли я молюся, я дивуюся, чому я турбуюсь...	true
character_trait_levels_onscreen_name_att_trait_general_personality_all_feck_2	Лихословлячий	true
character_trait_levels_onscreen_name_att_trait_general_status_all_unpopular_3	Зневажений усіма	true
character_trait_levels_onscreen_name_att_trait_general_personality_all_feck_3	Огидний	true
character_trait_levels_onscreen_name_att_trait_general_status_all_unpopular_2	Непопулярний	true
character_trait_levels_onscreen_name_att_trait_general_status_all_unpopular_1	В опалі	true
character_trait_levels_onscreen_name_att_trait_general_personality_all_feck_1	Лайливий	true
character_trait_levels_onscreen_name_att_trait_general_military_all_fighter_3	Майстер бою	true
character_trait_levels_onscreen_name_att_trait_general_military_all_fighter_2	Відмінний боєць	true
character_trait_levels_onscreen_name_att_trait_general_military_all_fighter_1	Вправний у битві	true
character_trait_levels_colour_text_att_trait_all_personality_all_sanguine_1	Безтурботний вираз обличчя приховує багато думок.	true
character_trait_levels_colour_text_att_trait_all_personality_all_choleric_1	Цього чоловіка легко роздратувати, розлютити. І пам'ятає своїх ворогів. О, так…	true
character_trait_levels_colour_text_att_trait_all_personality_all_easily_deceived_1	Цей чоловік довірливий від природи, чим інші користуються при кожній нагоді.	true
character_trait_levels_colour_text_bel_character_trait_last_roman_1	Своїми словами і вчинками про цю людину можна сказати, що вона втілює все добре і римське.	true
character_trait_levels_onscreen_name_att_trait_general_government_all_miner_3	Геній гірництва	true
character_trait_levels_onscreen_name_att_trait_general_government_all_miner_2	Гірничий інженер	true
character_trait_levels_onscreen_name_att_trait_general_government_all_miner_1	Копач	true
character_trait_levels_onscreen_name_att_trait_agent_personality_all_innate_stupid_1	Дурник	true
character_trait_levels_colour_text_att_trait_spy_actions_all_contaminator_1	Не їжте печиво. Я думаю, що воно зіпсоване.	true
character_trait_levels_colour_text_att_trait_spy_actions_all_contaminator_2	Ймовірний аванс. Здебільшого до вбиралень…	true
character_trait_levels_colour_text_att_trait_spy_actions_all_contaminator_3	У гіршому? Втечуть. У кращому випадку? Вони мертві!	true
character_trait_levels_colour_text_att_trait_priest_rank_orthodox_bishop_1	Ця людина була визнана своєю побожною відданістю Церкві.	true
character_trait_levels_onscreen_name_att_trait_general_ability_all_recon_1	Розвідка І	true
character_trait_levels_onscreen_name_att_trait_general_ability_all_recon_3	Розвідка III	true
character_trait_levels_onscreen_name_att_trait_general_ability_all_recon_2	Розвідка II	true
character_trait_levels_onscreen_name_att_trait_general_ability_all_recon_5	Розвідка V	true
character_trait_levels_onscreen_name_att_trait_general_ability_all_recon_4	Розвідка IV	true
character_trait_levels_onscreen_name_att_trait_priest_actions_all_devout_1	Благочестивий	true
character_trait_levels_onscreen_name_att_trait_priest_actions_all_devout_2	Праведний	true
character_trait_levels_onscreen_name_att_trait_priest_actions_all_devout_3	Фанатичний	true
character_trait_levels_colour_text_att_trait_not_priest_personality_monotheist_religious_2	Бог допомагає тим, хто найменше просить.	true
character_trait_levels_colour_text_att_trait_not_priest_personality_monotheist_religious_3	Ти знаєш, що таке справжнє кохання? Жертовність.	true
character_trait_levels_colour_text_att_trait_not_priest_personality_monotheist_religious_1	Можливо, Бога не існує, але якщо Він існує, то я хочу Його допомоги.	true
character_trait_levels_onscreen_name_att_trait_general_ability_all_presence_4	Присутність IV	true
character_trait_levels_onscreen_name_att_trait_general_ability_all_presence_5	Присутність V	true
character_trait_levels_onscreen_name_att_trait_general_ability_all_presence_2	Присутність II	true
character_trait_levels_onscreen_name_att_trait_general_ability_all_presence_3	Присутність III	true
character_trait_levels_onscreen_name_att_trait_general_ability_all_presence_1	Присутність І	true
character_trait_levels_onscreen_name_att_trait_priest_actions_all_betray_1	Підкупний	true
character_trait_levels_onscreen_name_att_trait_priest_actions_all_betray_3	Оманливий	true
character_trait_levels_onscreen_name_att_trait_priest_actions_all_betray_2	Підступний	true
character_trait_levels_colour_text_att_trait_general_military_all_looter_1	Переможцю здобич.	true
character_trait_levels_colour_text_att_trait_general_military_all_looter_2	Для цієї людини недостатньо грабувати переможених.	true
character_trait_levels_colour_text_att_trait_general_military_all_looter_3	Що таке маленький геноцид між друзями?	true
character_trait_levels_colour_text_att_trait_all_personality_all_innate_charismatic_1	Деякі чоловіки мають природне відчуття командування.	true
character_trait_levels_onscreen_name_att_trait_agent_status_not_roman_poor_1	Погане походження	true
character_trait_levels_colour_text_att_trait_general_physical_all_innate_deformed_1	Я не тварина!	true
character_trait_levels_onscreen_name_att_trait_general_ability_all_raise_3	Підняти стяг III	true
character_trait_levels_onscreen_name_att_trait_general_ability_all_raise_2	Підняти стяг II	true
character_trait_levels_onscreen_name_att_trait_general_ability_all_raise_1	Підняти стяг І	true
character_trait_levels_onscreen_name_att_trait_general_ability_all_rally_4	Згуртованість IV	true
character_trait_levels_onscreen_name_att_trait_general_ability_all_rally_5	Згуртованість V	true
character_trait_levels_onscreen_name_att_trait_general_ability_all_rally_2	Згуртованість II	true
character_trait_levels_onscreen_name_att_trait_general_ability_all_rally_3	Згуртованість III	true
character_trait_levels_onscreen_name_att_trait_general_ability_all_raise_5	Підняти стяг V	true
character_trait_levels_onscreen_name_att_trait_general_ability_all_raise_4	Підняти стяг IV	true
character_trait_levels_onscreen_name_att_trait_general_ability_all_rally_1	Згуртованість I	true
character_trait_levels_colour_text_bel_trait_mission_payload_supreme_commander_belisarius_1	Розділена команда означає втрату команди – Велізарій залишається один.	true
character_trait_levels_onscreen_name_att_trait_agent_status_roman_wealthy_1	Стара людина	true
character_trait_levels_colour_text_att_trait_general_military_navy_all_escort_bad_1	Так, вибачте, весла зачепилися за риф, а потім щогла впала.	true
character_trait_levels_colour_text_att_trait_general_military_navy_all_escort_bad_2	Ця людина ледве може захистити свій човен, не кажучи вже про інших.	true
character_trait_levels_colour_text_att_trait_general_military_navy_all_escort_bad_3	Ми були в супроводі? Справді? Що? Ті інші човни?	true
character_trait_levels_onscreen_name_cha_trail_wife_influence	Впливова	true
character_trait_levels_colour_text_att_trait_priest_actions_all_firebrand_1	Коли я говорю, люди слухають. Таке.	true
character_trait_levels_colour_text_att_trait_priest_actions_all_firebrand_3	Вставайте брати! Разом ми збудуємо нове майбутнє!	true
character_trait_levels_colour_text_att_trait_priest_actions_all_firebrand_2	Не мусить так бути, брати мої!	true
character_trait_levels_onscreen_name_att_trait_priest_actions_all_doomsayer_3	Пророк	true
character_trait_levels_onscreen_name_att_trait_priest_actions_all_doomsayer_2	Провокатор	true
character_trait_levels_onscreen_name_att_trait_priest_actions_all_doomsayer_1	Неспокійний	true
character_trait_levels_onscreen_name_att_trait_ruler_personality_all_unjust_1	Несправедливий	true
character_trait_levels_onscreen_name_att_trait_ruler_personality_all_unjust_2	Гнобитель	true
character_trait_levels_onscreen_name_att_trait_ruler_personality_all_unjust_3	Тиран	true
character_trait_levels_colour_text_att_trait_general_physical_all_fertile_2	Цілком ймовірно, що ця людина стане батьком нового покоління. Сам по собі.	true
character_trait_levels_colour_text_att_trait_general_physical_all_fertile_3	Очевидно, цьому чоловікові достатньо лише подивитися на дівчину, щоб вона завагітніла!	true
character_trait_levels_colour_text_att_trait_general_physical_all_fertile_1	Цей чоловік чудово вибирає партнерок по ліжку. А потім діє згідно з цим вибором.	true
character_trait_levels_onscreen_name_att_trait_general_personality_all_cowardice_2	Боягузливий	true
character_trait_levels_onscreen_name_att_trait_general_personality_all_cowardice_3	Боягузливий	true
character_trait_levels_onscreen_name_att_trait_general_personality_all_cowardice_1	Зляканий	true
character_trait_levels_onscreen_name_att_trait_ruler_government_all_taxman_2	Інспектор	true
character_trait_levels_onscreen_name_att_trait_ruler_government_all_taxman_3	Жорстоко вправний	true
character_trait_levels_onscreen_name_att_trait_ruler_government_all_taxman_1	Збирач податків	true
character_trait_levels_colour_text_att_trait_spy_actions_all_investigator_1	Змови та контрзмови інтригують цього агента.	true
character_trait_levels_colour_text_att_trait_spy_actions_all_investigator_2	У мене є листи. Ті, які Ви не хочете, щоб хтось бачив…	true
character_trait_levels_colour_text_att_trait_spy_actions_all_investigator_3	Я вважаю, що люди дуже допомагають, коли у них біля горла стоїть ніж…	true
character_trait_levels_colour_text_att_trait_general_military_army_all_attacker_bad_2	Ця людина має проблеми з організацією нападу.	true
character_trait_levels_colour_text_att_trait_general_military_army_all_attacker_bad_3	Ця людина може перетворити перемогу на принизливу поразку!	true
character_trait_levels_colour_text_att_trait_general_military_army_all_attacker_bad_1	Цій людині не вистачає впевненості в атаці.	true
character_trait_levels_onscreen_name_att_trait_ollam_ri_obstinance_1	Рішучість Оллама Рі (Верховного Короля)	true
character_trait_levels_colour_text_cha_trait_pope_1	[UNSEEN]	true
character_trait_levels_onscreen_name_att_trait_all_personality_all_choleric_1	Холерик	true
character_trait_levels_onscreen_name_att_trait_all_personality_all_sanguine_1	Сангвінік	true
character_trait_levels_colour_text_att_trait_agent_status_not_roman_wealthy_1	Багатство — це сила, і в цієї людини є сили в надлишку.	true
character_trait_levels_onscreen_name_bel_character_trait_last_roman_1	Останній з римлян	true
character_trait_levels_colour_text_att_trait_general_personality_all_feck_1	Сильні клятви роблять цю людину «характерником». І грубо.	true
character_trait_levels_colour_text_att_trait_general_status_all_unpopular_1	Деякі дії залишають бажати кращого.	true
character_trait_levels_colour_text_att_trait_general_personality_all_feck_3	З язика цієї людини постійно тече жахлива мерзота.	true
character_trait_levels_colour_text_att_trait_general_status_all_unpopular_2	Неприємний за своєю суттю чоловік, його уникають усі, хто його вже зустрічав.	true
character_trait_levels_colour_text_att_trait_general_personality_all_feck_2	Цей чоловік не може говорити без найгірших прокльонів.	true
character_trait_levels_colour_text_att_trait_general_status_all_unpopular_3	Цей чоловік не кращий за ласку, такої думки дотримуються всі, хто його знає.	true
character_trait_levels_colour_text_att_trait_general_military_all_fighter_1	Ця людина може сама впоратися в бійці.	true
character_trait_levels_colour_text_att_trait_general_military_all_fighter_2	Якщо потрібно боротися, Ви захочете, щоб цей хлопець був на боці. Бажано на Вашому.	true
character_trait_levels_colour_text_att_trait_general_military_all_fighter_3	Бойова звитяга цієї людини майже легендарна.	true
character_trait_levels_colour_text_att_trait_priest_rank_catholic_bishop_1	Ця людина була визнана своєю побожною відданістю Церкві.	true
character_trait_levels_removal_text_bel_character_trait_last_roman_1		true
character_trait_levels_onscreen_name_att_trait_general_government_all_authoritarian_1	Правила є правила	true
character_trait_levels_onscreen_name_att_trait_general_government_all_authoritarian_3	Авторитарний	true
character_trait_levels_onscreen_name_att_trait_general_government_all_authoritarian_2	Суворий	true
character_trait_levels_colour_text_att_trait_general_military_army_all_besieger_bad_3	…Але вони 10 метрів заввишки! Як ми маємо їх подолати?	true
character_trait_levels_colour_text_att_trait_general_military_army_all_besieger_bad_2	О, на шляху стоїть велика стіна… Є ідеї?	true
character_trait_levels_colour_text_att_trait_general_military_army_all_besieger_bad_1	Може, нам варто було спершу спробувати таран? Думки?	true
character_trait_levels_colour_text_att_trait_general_personality_all_arse_2	Це робить мене щасливим.	true
character_trait_levels_colour_text_att_trait_general_personality_all_arse_3	«Хто» чи «що» не має значення. «Як» - зазвичай має.	true
character_trait_levels_colour_text_att_trait_general_personality_all_arse_1	Є тілесні насолоди, якими користуються лише деякі.	true
character_trait_levels_colour_text_att_trait_not_priest_personality_polytheist_religious_2	Боги тут, зараз, слухають, і нам варто пам’ятати про це.	true
character_trait_levels_onscreen_name_att_trait_ruler_personality_all_miser_1	Заощадливий	true
character_trait_levels_colour_text_att_trait_not_priest_personality_polytheist_religious_3	Станьте на коліна і подякуйте богам!	true
character_trait_levels_onscreen_name_att_trait_ruler_personality_all_miser_3	Скупий	true
character_trait_levels_colour_text_att_trait_not_priest_personality_polytheist_religious_1	Дерево і камінь! Я шаную богів, чоловіче!	true
character_trait_levels_onscreen_name_att_trait_ruler_personality_all_miser_2	Середній	true
character_trait_levels_colour_text_att_trait_general_military_all_high_casualties_1	Цій людині подобається бачити кров, особливо кров ворога.	true
character_trait_levels_colour_text_att_trait_general_military_all_high_casualties_3	В'язні? Паразити! Додаткові роти для годування.	true
character_trait_levels_colour_text_att_trait_general_military_all_high_casualties_2	Цей чоловік насолоджується кровопролиттям заради нього самого.	true
character_trait_levels_onscreen_name_att_trait_general_military_army_all_siege_defender_bad_1	Недосвідчений захисник фортець	true
character_trait_levels_onscreen_name_att_trait_general_military_army_all_siege_defender_bad_3	Ховається за стінами	true
character_trait_levels_onscreen_name_att_trait_general_military_army_all_siege_defender_bad_2	Вірний	true
character_trait_levels_onscreen_name_att_trait_general_physical_all_innate_handsome_1	Красень	true
character_trait_levels_onscreen_name_att_trait_theodosius_marker_1	Феодосій	true
character_trait_levels_onscreen_name_att_trait_all_personality_all_innate_boring_1	Нудний	true
character_trait_levels_colour_text_att_trait_general_physical_all_scar_disfiguring_1	Жінки і діти бояться дивитися на обличчя цього чоловіка.	true
character_trait_levels_colour_text_att_trait_general_status_not_roman_blood_feud_1	Тобі справді не слід було вбивати мого дядька.	true
character_trait_levels_colour_text_att_trait_all_personality_all_unlucky_1	Не те місце, не той час... що ти будеш робити?	true
character_trait_levels_colour_text_att_trait_all_personality_all_unlucky_2	Добре. Гадаю, варто було спробувати.	true
character_trait_levels_colour_text_att_trait_all_personality_all_unlucky_3	Є «нещасливий» і є «проклятий згори». Бачиш різницю.	true
character_trait_levels_onscreen_name_att_trait_belisarius_marker_1	Велізарій	true
character_trait_levels_onscreen_name_att_trait_ybor_tongue_1	Язик Годана	true
character_trait_levels_onscreen_name_att_trait_general_physical_all_innate_deformed_1	Спотворений	true
character_trait_levels_onscreen_name_bel_trait_mission_payload_supreme_commander_belisarius_1	Верховний головнокомандувач	true
character_trait_levels_onscreen_name_att_trait_agent_personality_all_innate_sneaky_1	Підступний	true
character_trait_levels_colour_text_att_trait_general_military_navy_all_attacker_sea_good_1	Ця людина точно розвиває свої навички адмірала.	true
character_trait_levels_colour_text_att_trait_general_military_navy_all_attacker_sea_good_3	Командування на морі зробило цю людину легендою.	true
character_trait_levels_colour_text_att_trait_general_military_navy_all_attacker_sea_good_2	Ця людина чудово володіє морською тактикою.	true
character_trait_levels_onscreen_name_att_trait_general_military_navy_all_escort_bad_3	Який супровід? Конвой?	true
character_trait_levels_onscreen_name_att_trait_general_military_navy_all_escort_bad_2	Малотямущий в морському супроводі	true
character_trait_levels_onscreen_name_att_trait_general_military_navy_all_escort_bad_1	Неефективний морський супровід	true
character_trait_levels_colour_text_bel_trait_mission_payload_battle_hardened_narses_1	Цей чоловік, обраний імператором, керує неперевершеною майстерністю.	true
character_trait_levels_colour_text_att_trait_general_military_army_all_defender_bad_1	Цій людині не вистачає впевненості під час захисту.	true
character_trait_levels_colour_text_att_trait_general_military_army_all_defender_bad_2	Захист не є частиною військового мистецтва цієї людини.	true
character_trait_levels_colour_text_att_trait_general_military_army_all_defender_bad_3	Ця людина не має помітного таланту до захисту.	true
character_trait_levels_onscreen_name_att_trait_all_personality_all_lucky_1	Вдалий	true
character_trait_levels_onscreen_name_att_trait_all_personality_all_lucky_3	Благословенний	true
character_trait_levels_onscreen_name_att_trait_all_personality_all_lucky_2	Щасливчик	true
character_trait_levels_colour_text_att_trait_priest_rank_roman_high_priest_1	Через вік і досвід цей чоловік став лідером своєї віри.	true
character_trait_levels_colour_text_att_trait_all_personality_all_innate_intelligent_1	Розум може вивести людину далі, ніж міцні ноги.	true
character_trait_levels_colour_text_cha_trail_wife_influence	Її краса поєднується з гострим інтелектом. Тільки дурень відкинув би її думку.	true
character_trait_levels_onscreen_name_att_trait_priest_actions_all_firebrand_2	Ватажок	true
character_trait_levels_onscreen_name_att_trait_priest_actions_all_firebrand_3	Баламут	true
character_trait_levels_onscreen_name_att_trait_priest_actions_all_firebrand_1	Людина з народу	true
character_trait_levels_onscreen_name_att_trait_priest_rank_mobedan_mobed_1	Мобедан Мобед	true
character_trait_levels_onscreen_name_att_trait_general_physical_all_fertile_1	Фертильний	true
character_trait_levels_onscreen_name_att_trait_general_physical_all_fertile_3	Плідний	true
character_trait_levels_onscreen_name_att_trait_general_physical_all_fertile_2	Плідний	true
character_trait_levels_colour_text_att_trait_priest_actions_all_doomsayer_1	Цей чоловік має більше ніж здоровий інтерес до справ, які його не стосуються.	true
character_trait_levels_colour_text_att_trait_priest_actions_all_doomsayer_2	Слова ефективніші за каміння.	true
character_trait_levels_colour_text_att_trait_priest_actions_all_doomsayer_3	Все закінчилось. У нас немає шансу!	true
character_trait_levels_colour_text_att_trait_ruler_personality_all_spender_1	Щедрість подобається богам і мені.	true
character_trait_levels_colour_text_att_trait_ruler_personality_all_spender_2	Гроші не приносять ніякої користі, якщо вони сидять у моїй сумці.	true
character_trait_levels_colour_text_att_trait_ruler_personality_all_spender_3	Дайте цьому хлопцеві бігти з меншим гаманцем, єх молодець!	true
character_trait_levels_onscreen_name_att_trait_priest_actions_all_seeds_of_doubt_1	Сумнів і незгода	true
character_trait_levels_onscreen_name_att_trait_priest_actions_all_seeds_of_doubt_2	Шепіт у темряві	true
character_trait_levels_onscreen_name_att_trait_priest_actions_all_seeds_of_doubt_3	Підбурювач	true
character_trait_levels_colour_text_att_trait_ruler_personality_all_unjust_3	ВИ! Виконуйте їх швидше! Перестань бути добрим з цього приводу!	true
character_trait_levels_colour_text_att_trait_ruler_personality_all_unjust_2	Я розглянув цю петицію. Запитайте ще раз, і Вам знадобиться заповіт.	true
character_trait_levels_colour_text_att_trait_ruler_personality_all_unjust_1	Вашу справу відхилено. Залиш свій хабар на долівці.	true
character_trait_levels_onscreen_name_att_trait_spy_actions_all_contaminator_3	Акредитований агент з постачання	true
character_trait_levels_onscreen_name_att_trait_spy_actions_all_contaminator_2	Фальшивий інтендант	true
character_trait_levels_onscreen_name_att_trait_spy_actions_all_contaminator_1	Фальшивий постачальник	true
character_trait_levels_colour_text_att_trait_general_government_all_miner_1	Називай мене як хочеш. Я буду насолоджуватися багатством моїх копалень.	true
character_trait_levels_colour_text_att_trait_general_government_all_miner_2	Багато багатств можна знайти під землею.	true
character_trait_levels_colour_text_att_trait_general_government_all_miner_3	Мати-Земля віддає свої багатства тим, хто достатньо мудрий, щоб їх знайти.	true
character_trait_levels_onscreen_name_att_trait_agent_physical_all_innate_very_very_inbred_1	Тонкошкірий	true
character_trait_levels_onscreen_name_att_trait_ruler_personality_all_harsh_1	Суворий	true
character_trait_levels_onscreen_name_att_trait_ruler_personality_all_harsh_2	Кат	true
character_trait_levels_onscreen_name_att_trait_ruler_personality_all_harsh_3	Слово про жорстокість	true
character_trait_levels_onscreen_name_att_trait_anastasius_marker_1	Анастасій	true
character_trait_levels_onscreen_name_att_trait_all_personality_all_drink_3	Раб напою	true
character_trait_levels_onscreen_name_att_trait_all_personality_all_drink_2	П'яниця	true
character_trait_levels_onscreen_name_att_trait_all_personality_all_drink_1	Випивака	true
character_trait_levels_colour_text_att_trait_general_ability_all_presence_5	Грізний воєвода, якого поважали навіть вороги.	true
character_trait_levels_colour_text_att_trait_general_ability_all_presence_4	Грізний воєвода, якого поважали навіть вороги.	true
character_trait_levels_colour_text_att_trait_general_ability_all_presence_1	Грізний воєвода, якого поважали навіть вороги.	true
character_trait_levels_colour_text_att_trait_general_ability_all_presence_3	Грізний воєвода, якого поважали навіть вороги.	true
character_trait_levels_colour_text_att_trait_general_ability_all_presence_2	Грізний воєвода, якого поважали навіть вороги.	true
character_trait_levels_onscreen_name_att_trait_general_personality_roman_patriotic_3	Справжній римлянин	true
character_trait_levels_onscreen_name_att_trait_general_personality_roman_patriotic_2	Патріот	true
character_trait_levels_onscreen_name_att_trait_general_personality_roman_patriotic_1	Вірний	true
character_trait_levels_onscreen_name_att_trait_general_ability_all_brace_3	Готовність III	true
character_trait_levels_onscreen_name_att_trait_general_ability_all_brace_2	Готовність II	true
character_trait_levels_onscreen_name_att_trait_general_ability_all_brace_1	Готовність І	true
character_trait_levels_onscreen_name_att_trait_general_ability_all_brace_5	Готовність V	true
character_trait_levels_onscreen_name_att_trait_general_ability_all_brace_4	Готовність IV	true
character_trait_levels_colour_text_att_trait_agent_status_all_slave_1	Я розумію рабський розум і його плани...	true
character_trait_levels_onscreen_name_att_trait_priest_rank_orthodox_bishop_1	Єпископ	true
character_trait_levels_colour_text_att_trait_agent_personality_all_innate_stupid_1	Вибачте, старий, я боюся, що між вухами не відбувається нічого корисного!	true
character_trait_levels_colour_text_att_trait_narses_marker_1	Нарсес	true
character_trait_levels_colour_text_att_trait_agent_physical_all_innate_very_inbred_1	Коли батьками стають близькі родичі, наслідки можуть бути плачевними.	true
character_trait_levels_onscreen_name_att_trait_not_priest_personality_monotheist_religious_2	Релігійний	true
character_trait_levels_onscreen_name_att_trait_not_priest_personality_monotheist_religious_3	Благочестивий	true
character_trait_levels_onscreen_name_att_trait_not_priest_personality_monotheist_religious_1	Шанобливий	true
character_trait_levels_onscreen_name_att_trait_general_status_all_spurned_1	Відштовхнутий	true
character_trait_levels_colour_text_att_trait_ruler_scourge_of_god_1	Я буду дивитися, як горить твій світ.	true
character_trait_levels_onscreen_name_att_trait_general_military_all_looter_1	Мародер	true
character_trait_levels_onscreen_name_att_trait_general_military_all_looter_2	М'ясник	true
character_trait_levels_onscreen_name_att_trait_general_military_all_looter_3	Руйнівник	true
character_trait_levels_onscreen_name_bel_trait_mission_payload_influence_negative_1	Завжди збоку	true
character_trait_levels_onscreen_name_att_trait_ruler_personality_all_kind_3	Благодійний	true
character_trait_levels_onscreen_name_att_trait_ruler_personality_all_kind_2	Дбайливий керманич	true
character_trait_levels_onscreen_name_att_trait_ruler_personality_all_kind_1	Добрий	true
character_trait_levels_colour_text_att_trait_agent_status_not_roman_poor_1	Козопас може досягти величі, якщо це написано.	true
character_trait_levels_colour_text_att_trait_all_personality_all_phlegmatic_1	Холодний і не харизматичний, цей чоловік мало кому подобається.	true
character_trait_levels_onscreen_name_att_trait_general_military_barbarian_berserker_1	Щитокус	true
character_trait_levels_onscreen_name_att_trait_general_military_barbarian_berserker_2	Друг сокири	true
character_trait_levels_onscreen_name_att_trait_general_military_barbarian_berserker_3	Берсерк	true
character_trait_levels_colour_text_bel_trait_mission_payload_illegitimate_children_1	Навіть найспритніший полководець може не помітити ворога в своєму ліжку.	true
character_trait_levels_onscreen_name_att_trait_general_status_all_popular_3	Улюблений усіма	true
character_trait_levels_onscreen_name_att_trait_general_status_all_popular_2	Популярний	true
character_trait_levels_onscreen_name_att_trait_general_status_all_popular_1	Улюбленець	true
character_trait_levels_onscreen_name_att_trait_general_military_navy_all_defender_sea_bad_1	Байдужий морський захисник	true
character_trait_levels_onscreen_name_att_trait_general_military_navy_all_defender_sea_bad_2	Слабкий морський захисник	true
character_trait_levels_onscreen_name_att_trait_general_military_navy_all_defender_sea_bad_3	Ніякий морський захисник	true
character_trait_levels_colour_text_att_trait_ruler_personality_all_paranoid_1	За мною слідкують. Всюди. І не слуги.	true
character_trait_levels_colour_text_att_trait_ruler_personality_all_paranoid_2	Там! За гобеленом! І там! всюди!	true
character_trait_levels_colour_text_att_trait_ruler_personality_all_paranoid_3	У мене є вороги. Більше, ніж Ви можете порахувати. І це тільки в цих стінах!	true
character_trait_levels_onscreen_name_att_trait_ruler_personality_all_mad_2	Тривожна вдача	true
character_trait_levels_onscreen_name_att_trait_ruler_personality_all_mad_3	Принц Місячного народу	true
character_trait_levels_onscreen_name_att_trait_ruler_personality_all_mad_1	Дещо дивний	true
character_trait_levels_colour_text_att_trait_general_military_all_military_heritage_1	Під час кампанії зі своїм батьком цей чоловік виріс серед солдатів і знає їхні шляхи.	true
character_trait_levels_colour_text_att_trait_general_government_all_military_admin_1	Мечі та черевики корисні, але накази рухають армії.	true
character_trait_levels_colour_text_att_trait_general_government_all_military_admin_2	Залиште це мені… Ви отримаєте свої мечі.	true
character_trait_levels_colour_text_att_trait_general_government_all_military_admin_3	Армії йдуть на повними шлунками, але рухають ними папірці	true
character_trait_levels_colour_text_att_trait_ruler_government_all_taxman_2	У вмілого володаря завжди є витрати. Тому є податки.	true
character_trait_levels_colour_text_att_trait_ruler_government_all_taxman_3	Я люблю податки. Мені подобаються люди, які платять податки. Негайно.	true
character_trait_levels_colour_text_att_trait_ruler_government_all_taxman_1	Люди стають такими... ласими щодо монет. Зрештою, на них моє обличчя.	true
character_trait_levels_colour_text_att_trait_general_personality_all_honest_1	До чесного обличчя відповідає чесна манера.	true
character_trait_levels_colour_text_att_trait_general_personality_all_honest_2	Пряме спілкування створило цій людині завидну репутацію.	true
character_trait_levels_colour_text_att_trait_general_personality_all_honest_3	Ім’я цієї людини є синонімом чесності та порядності.	true
character_trait_levels_onscreen_name_att_trait_all_physical_all_unhealthy_1	Слабкий	true
character_trait_levels_onscreen_name_att_trait_all_physical_all_unhealthy_2	Бідолашний	true
character_trait_levels_onscreen_name_att_trait_all_physical_all_unhealthy_3	Кволий	true
character_trait_levels_onscreen_name_att_trait_general_physical_all_blind_1	Сліпий	true
character_trait_levels_colour_text_att_trait_general_personality_all_innate_stupid_1	Відверто кажучи, ця людина товще китового омлету.	true
character_trait_levels_onscreen_name_att_trait_champion_actions_all_callous_2	Безсердечний	true
character_trait_levels_onscreen_name_att_trait_champion_actions_all_callous_3	Безсердечний	true
character_trait_levels_onscreen_name_att_trait_champion_actions_all_callous_1	Безжалісний	true
character_trait_levels_onscreen_name_att_trait_champion_actions_all_violent_1	Брудне лезо	true
character_trait_levels_onscreen_name_att_trait_champion_actions_all_violent_3	Залитий кров'ю	true
character_trait_levels_onscreen_name_att_trait_champion_actions_all_violent_2	Закривавлений	true
character_trait_levels_colour_text_att_trait_general_military_navy_all_escort_good_1	Ця людина не раз направляла торгівлю і військові човни в безпечне місце.	true
character_trait_levels_colour_text_att_trait_general_military_navy_all_escort_good_2	Якщо Ви хочете, щоб Ваш супровід дістався в безпеці, доручіть цьому хлопцеві керувати.	true
character_trait_levels_colour_text_att_trait_general_military_navy_all_escort_good_3	Я ще жодного разу не втрачав вантажу! Жодного!	true
character_trait_levels_onscreen_name_bel_trait_mission_payload_attrition_immunity_1	Багатоводний	true
character_trait_levels_colour_text_att_trait_all_personality_all_innate_irresolute_1	Так. Ні, можливо. Я не знаю!	true
character_trait_levels_colour_text_att_trait_general_military_army_all_siege_defender_good_1	Ця людина може захистити поселення. Поодинці, якщо треба.	true
character_trait_levels_colour_text_att_trait_general_military_army_all_siege_defender_good_3	Дайте цій людині стіну, і він утримає її від богів!	true
character_trait_levels_colour_text_att_trait_general_military_army_all_siege_defender_good_2	Оборонні навички цієї людини варті епічної поеми.	true
character_trait_levels_onscreen_name_att_trait_general_physical_all_eunuch_1	Євнух	true
character_trait_levels_colour_text_att_trait_photius_marker_1	Фотій	true
character_trait_levels_colour_text_att_trait_eos_dam_repair_1	Небажаючі спини волають про удар батогом.	true
character_trait_levels_onscreen_name_att_trait_general_military_navy_all_attacker_sea_bad_2	Слабий адмірал	true
character_trait_levels_onscreen_name_att_trait_general_military_navy_all_attacker_sea_bad_3	Всі на морі	true
character_trait_levels_onscreen_name_att_trait_general_military_navy_all_attacker_sea_bad_1	Гідрофоб	true
character_trait_levels_onscreen_name_bel_trait_mission_payload_missionary_1	Захисник віри	true
character_trait_levels_onscreen_name_att_trait_general_ability_all_inspire_1	Надихання І	true
character_trait_levels_onscreen_name_att_trait_general_ability_all_inspire_2	Надихання II	true
character_trait_levels_onscreen_name_att_trait_general_ability_all_inspire_3	Надихання III	true
character_trait_levels_onscreen_name_att_trait_general_ability_all_inspire_4	Надихання IV	true
character_trait_levels_onscreen_name_att_trait_general_ability_all_inspire_5	Надихання V	true
character_trait_levels_colour_text_att_trait_priest_rank_tengri_high_priest_1	Нехай Тенгрі стереже Вас.	true
character_trait_levels_onscreen_name_att_trait_general_ability_all_second_5	Друге дихання V	true
character_trait_levels_onscreen_name_att_trait_general_ability_all_second_4	Друге дихання IV	true
character_trait_levels_onscreen_name_att_trait_general_ability_all_second_1	Друге дихання І	true
character_trait_levels_onscreen_name_att_trait_general_ability_all_second_3	Друге дихання III	true
character_trait_levels_onscreen_name_att_trait_general_ability_all_second_2	Друге дихання II	true
character_trait_levels_onscreen_name_att_trait_general_military_navy_all_defender_sea_good_3	Вищий морський захисник	true
character_trait_levels_onscreen_name_att_trait_general_military_navy_all_defender_sea_good_2	Чудовий морський захисник	true
character_trait_levels_onscreen_name_att_trait_general_military_navy_all_defender_sea_good_1	Гарний морський захисник	true
character_trait_levels_colour_text_att_trait_priest_rank_manichaean_leader_1	Помазаний наступник Мані.	true
character_trait_levels_onscreen_name_att_trait_champion_actions_all_cruel_1	Лякає	true
character_trait_levels_onscreen_name_att_trait_champion_actions_all_cruel_3	Жахливий	true
character_trait_levels_onscreen_name_att_trait_champion_actions_all_cruel_2	Загрозливий	true
character_trait_levels_onscreen_name_att_trait_champion_actions_all_arson_3	Піроман	true
character_trait_levels_onscreen_name_att_trait_champion_actions_all_arson_2	Підпалювач	true
character_trait_levels_onscreen_name_att_trait_champion_actions_all_arson_1	Розпалювач	true
character_trait_levels_onscreen_name_att_trait_all_personality_all_atheist_2	Безбожник	true
character_trait_levels_onscreen_name_att_trait_all_personality_all_atheist_3	Громадський атеїст	true
character_trait_levels_onscreen_name_att_trait_all_personality_all_atheist_1	Не вірить у потойбічне життя	true
character_trait_levels_onscreen_name_att_trait_general_personality_all_mad_3	Навіжений	true
character_trait_levels_onscreen_name_att_trait_general_personality_all_mad_2	Небезпечний	true
character_trait_levels_onscreen_name_att_trait_general_personality_all_mad_1	Не зовсім правильний	true
character_trait_levels_colour_text_att_trait_general_physical_all_infertile_2	Цей чоловік навряд чи стане батьком нового покоління.	true
character_trait_levels_colour_text_att_trait_general_physical_all_infertile_3	Дитячі стегна цього чоловіка ні нащо не здатні.	true
character_trait_levels_colour_text_att_trait_general_physical_all_infertile_1	Цей чоловік робить неправильний вибір щодо партнерок у ліжку. Це все. О, так.	true
character_trait_levels_colour_text_att_trait_general_government_all_farmer_1	Повний живіт не любить пояса з мечем.	true
character_trait_levels_colour_text_att_trait_general_government_all_farmer_2	Земля, яка залишилася невикористаною, також може бути під морем.	true
character_trait_levels_colour_text_att_trait_general_government_all_farmer_3	Добре доглянута земля — основа багатства.	true
character_trait_levels_colour_text_cha_trait_leader_influence	Коли ця людина говорить, люди слухають. Командувач, він найкращий полководець у всіх сенсах.	true
character_trait_levels_onscreen_name_att_trait_all_personality_all_easily_deceived_1	Легко обдурити	true
character_trait_levels_colour_text_att_trait_agent_personality_all_innate_sneaky_1	Цей чоловік має зміїний розум, якому не перешкоджають ввічливі умовності.	true
character_trait_levels_onscreen_name_att_trait_general_military_navy_all_attacker_sea_good_1	Морська стійкість	true
character_trait_levels_onscreen_name_att_trait_general_military_navy_all_attacker_sea_good_3	Вищий адмірал	true
character_trait_levels_onscreen_name_att_trait_general_military_navy_all_attacker_sea_good_2	Гарний морський капітан	true
character_trait_levels_colour_text_att_trait_general_military_barbarian_berserker_3	Цей чоловік: якщо Ви бачите, що він йде, біжіть. Просто біжи. швидко!	true
character_trait_levels_colour_text_att_trait_general_military_barbarian_berserker_2	На жорстоку лють цього чоловіка варто подивитись.	true
character_trait_levels_colour_text_att_trait_general_military_barbarian_berserker_1	Грррррррр! Настає червоний туман! Пустіть мене до них!	true
character_trait_levels_onscreen_name_att_trait_general_personality_not_barbarian_likes_barbarians_1	Любить варварів	true
character_trait_levels_onscreen_name_att_trait_general_personality_not_nomad_likes_nomads_1	Любить кочовиків	true
character_trait_levels_onscreen_name_att_trait_general_personality_not_roman_likes_romans_1	Любить римлян	true
character_trait_levels_onscreen_name_att_trait_ybor_blade_1	Лезо Годана	true
character_trait_levels_colour_text_att_trait_general_military_all_tactician_1	Цей чоловік читав теорії командування на бойовищі.	true
character_trait_levels_colour_text_att_trait_general_military_all_tactician_2	Після тривалого вивчення класичних боїв ця людина чудово розуміє тактику.	true
character_trait_levels_colour_text_att_trait_general_military_all_tactician_3	Енциклопедичне знання тактичних писань дає цій людині перевагу.	true
character_trait_levels_colour_text_att_trait_general_personality_all_innate_humble_1	Я лише гвинтик у машині. Більше нічого.	true
character_trait_levels_colour_text_att_trait_spy_actions_all_scout_1	Багато чоловіків. Подорожують швидко. Троє кульгали…	true
character_trait_levels_colour_text_att_trait_spy_actions_all_scout_3	Вороги не можуть сховатися від пронизливого погляду.	true
character_trait_levels_colour_text_att_trait_spy_actions_all_scout_2	Кожна травинка не на своєму місці розповідає історію.	true
character_trait_levels_onscreen_name_att_trait_ybor_touch_1	Дотик Годана	true
character_trait_levels_colour_text_att_trait_all_personality_all_energetic_3	Я буду спати, коли помру!	true
character_trait_levels_colour_text_att_trait_all_personality_all_energetic_2	Багато справ сьогодні! Чудово!	true
character_trait_levels_colour_text_att_trait_all_personality_all_energetic_1	Відпочити? Відпочити? Я не слабак!	true
character_trait_levels_onscreen_name_att_trait_agent_personality_all_mad_3	Навіжений	true
character_trait_levels_onscreen_name_att_trait_agent_personality_all_mad_2	Небезпечний	true
character_trait_levels_onscreen_name_att_trait_agent_personality_all_mad_1	Не зовсім правильний	true
character_trait_levels_onscreen_name_att_trait_general_personality_not_barbarian_hates_barbarians_1	Ненавидить смердючих варварів	true
character_trait_levels_onscreen_name_att_trait_general_personality_not_nomad_hates_nomads_1	Зневажає кочовиків, які люблять коней	true
character_trait_levels_onscreen_name_att_trait_general_personality_not_roman_hates_romans_1	Зневажає віроломних римлян	true
character_trait_levels_colour_text_att_trait_ruler_personality_all_harsh_1	Доброта - це слабкість.	true
character_trait_levels_colour_text_att_trait_ruler_personality_all_harsh_2	Використовуйте затискачі. Крихітні затискачі. Ті, що мають зуби.	true
character_trait_levels_colour_text_att_trait_ruler_personality_all_harsh_3	Твій біль, твій відчай... для мене як медове вино.	true
character_trait_levels_onscreen_name_att_trait_spy_actions_all_infiltrate_2	Непримітне обличчя	true
character_trait_levels_onscreen_name_att_trait_spy_actions_all_infiltrate_3	Безликий	true
character_trait_levels_onscreen_name_att_trait_spy_actions_all_infiltrate_1	Чесне обличчя	true
character_trait_levels_onscreen_name_att_trait_ollam_ri_judgement_1	Правосуддя Оллама Рі (Верховного Короля)	true
character_trait_levels_onscreen_name_att_trait_ruler_scourge_of_god_1	Король-воїн	true
character_trait_levels_onscreen_name_att_trait_general_government_all_government_heritage_1	Син губернатора	true
character_trait_levels_colour_text_att_trait_general_personality_roman_patriotic_3	Ця людина є взірцем римської прямоти і вищості. Переважно важливості.	true
character_trait_levels_colour_text_att_trait_general_personality_roman_patriotic_2	Любов до Риму порівнюється лише зрозумілою недовірою до іноземців.	true
character_trait_levels_colour_text_att_trait_general_personality_roman_patriotic_1	Вірність цієї людини короні та державі не викликає сумнівів.	true
character_trait_levels_colour_text_att_trait_general_military_all_survivor_3	Пращі та стріли жорстокої долі повністю обминули цю людину.	true
character_trait_levels_colour_text_att_trait_general_military_all_survivor_2	Ця людина має відчуття небезпеки, попереджаючи його, коли щось не так.	true
character_trait_levels_colour_text_att_trait_general_military_all_survivor_1	Від того, що Вас не вбиває, справді сльозяться очі.	true
character_trait_levels_colour_text_att_trait_all_personality_all_easily_distracted_1	О, подивіться, ось хмара, схожа на Ганнібала! Ні справді!	true
character_trait_levels_colour_text_att_trait_spy_actions_all_poison_1	Ця вода трохи пахне… ну, знаєте? Трупиками?	true
character_trait_levels_colour_text_att_trait_spy_actions_all_poison_3	Без води люди стають напрочуд гнучкими у своєму світогляді.	true
character_trait_levels_colour_text_att_trait_spy_actions_all_poison_2	Ви можете пустити мертвого коня у воду, але Ви не можете змусити когось іншого пити.	true
character_trait_levels_onscreen_name_att_trait_general_personality_not_roman_unpatriotic_1	Цікавість в іноземному	true
character_trait_levels_onscreen_name_att_trait_general_personality_not_roman_unpatriotic_2	Одержимість чужинському	true
character_trait_levels_onscreen_name_att_trait_general_personality_not_roman_unpatriotic_3	Іноземна вульгарність	true
character_trait_levels_colour_text_att_trait_ollam_ri_obstinance_1	Спина, як у дуба, сперлася проти завивання вітру.	true
character_trait_levels_onscreen_name_att_trait_general_personality_not_barbarian_fears_barbarians_1	Боїться диких варварів	true
character_trait_levels_onscreen_name_att_trait_general_personality_not_nomad_fears_nomads_1	Боїться мародерських кочовиків	true
character_trait_levels_onscreen_name_att_trait_general_personality_not_roman_fears_romans_1	Боїться бездушних римлян	true
character_trait_levels_colour_text_att_trait_ruler_government_all_spymaster_1	Ніщо не приносить цій людині більше задоволення, ніж таємниці інших.	true
character_trait_levels_colour_text_att_trait_ruler_government_all_spymaster_3	Мудрому володарю корисне всевидяче око.	true
character_trait_levels_colour_text_att_trait_ruler_government_all_spymaster_2	Ця людина всюди має очі та вуха.	true
character_trait_levels_colour_text_att_trait_priest_rank_celtic_high_druid_1	Дуби, вони говорять мною.	true
character_trait_levels_onscreen_name_att_trait_priest_rank_catholic_bishop_1	Єпископ	true
character_trait_levels_colour_text_att_trait_general_government_all_trader_1	Торгівля, дурню, за все це платить!	true
character_trait_levels_colour_text_att_trait_general_government_all_trader_3	Давай! Торгуйтесь! Воно того не варте!	true
character_trait_levels_colour_text_att_trait_general_government_all_trader_2	Ця людина знає ціну всьому і ціну нічого.	true
character_trait_levels_colour_text_att_trait_ruler_personality_all_miser_1	Гроші не ростуть на деревах і не плавають в морях!	true
character_trait_levels_onscreen_name_att_trait_not_priest_personality_polytheist_religious_2	Віруючий	true
character_trait_levels_onscreen_name_att_trait_not_priest_personality_polytheist_religious_3	Істинно віруючий	true
character_trait_levels_colour_text_att_trait_ruler_personality_all_miser_3	Я не отримую задоволення від витрачання грошей. Це завжди марна трата грошей!	true
character_trait_levels_colour_text_att_trait_ruler_personality_all_miser_2	Навіщо мені відкривати гаманець? Яка мета цьому?	true
character_trait_levels_onscreen_name_att_trait_not_priest_personality_polytheist_religious_1	Шанобливий	true
character_trait_levels_onscreen_name_bel_trait_mission_payload_influence_positive_1	Впливовий	true
character_trait_levels_colour_text_att_trait_general_personality_all_girls_2	Давай, давай, давай, давай. Ви будете. Будеш, будеш, будеш.	true
character_trait_levels_colour_text_att_trait_general_personality_all_girls_3	Ну, привіт. Дінь. Донг. Хіба ти не щаслива дівчина?	true
character_trait_levels_colour_text_att_trait_general_personality_all_girls_1	Мав її. Мав її. Мав її. Двічі. А її мама…	true
character_trait_levels_colour_text_att_trait_champion_actions_all_violent_2	Деякі воїни просто не знають, коли зупинитися.	true
character_trait_levels_colour_text_att_trait_champion_actions_all_violent_3	Заради богів! Він уже справді мертвий!	true
character_trait_levels_colour_text_att_trait_champion_actions_all_violent_1	Який сенс його чистити?	true
character_trait_levels_onscreen_name_att_trait_general_status_not_roman_blood_feud_1	Кровна помста	true
character_trait_levels_colour_text_att_trait_champion_actions_all_callous_1	Тяжке становище інших мало зворушує цю людину.	true
character_trait_levels_colour_text_att_trait_champion_actions_all_callous_3	Хтось вгамуйте цю нявкаючу дитину…	true
character_trait_levels_colour_text_att_trait_champion_actions_all_callous_2	Деякі люди просто холодні.	true
character_trait_levels_onscreen_name_att_trait_all_personality_all_unlucky_1	Невдаха	true
character_trait_levels_onscreen_name_att_trait_all_personality_all_unlucky_2	Нещасливий	true
character_trait_levels_onscreen_name_att_trait_all_personality_all_unlucky_3	Проклятий	true
character_trait_levels_colour_text_att_trait_ybor_tongue_1	Смерть і життя у владі язика, і ті, хто любить його, їдять його плоди	true
character_trait_levels_colour_text_bel_trait_mission_payload_harmony_1	Богові найкраще служать ті, хто береже його мир.	true
character_trait_levels_colour_text_att_trait_general_personality_not_barbarian_likes_barbarians_1	Вони роблять саме те, що кажуть, що будуть робити. Я це поважаю. Але не миються багато…	true
character_trait_levels_colour_text_att_trait_general_personality_not_nomad_likes_nomads_1	Вони насправді не такі вже й погані. Трохи смердюче, трохи вбивче - але хороші яйця для людини!	true
character_trait_levels_colour_text_att_trait_general_personality_not_roman_likes_romans_1	Чудова гонка, римляни... Чудова...	true
character_trait_levels_colour_text_att_trait_ybor_blade_1	Сталь, викувана у вогні божого гніву.	true
character_trait_levels_onscreen_name_att_trait_general_personality_not_roman_patriotic_1	Вірний	true
character_trait_levels_onscreen_name_att_trait_general_personality_not_roman_patriotic_3	Шовініст	true
character_trait_levels_onscreen_name_att_trait_general_personality_not_roman_patriotic_2	Віддані	true
character_trait_levels_colour_text_att_trait_general_military_navy_all_blockader_bad_3	Він ніколи не проводив успішної блокади. Командування взяло це на папірець.	true
character_trait_levels_colour_text_att_trait_general_military_navy_all_blockader_bad_2	Ага, якби ми були ближче один до одного. Нічого страшного.	true
character_trait_levels_colour_text_att_trait_general_military_navy_all_blockader_bad_1	Цій людині не вдалося заблокувати ворожі порти більше одного разу.	true
character_trait_levels_onscreen_name_att_trait_general_military_all_tactician_1	Розуміє битву	true
character_trait_levels_onscreen_name_att_trait_general_military_all_tactician_2	Тактик	true
character_trait_levels_onscreen_name_att_trait_general_military_all_tactician_3	Майстер-тактик	true
character_trait_levels_onscreen_name_att_trait_general_military_army_all_ambusher_good_2	Вправний із засідок	true
character_trait_levels_onscreen_name_att_trait_general_military_army_all_ambusher_good_3	Вищий влаштовувач засідок	true
character_trait_levels_onscreen_name_att_trait_general_military_army_all_ambusher_good_1	Майстер засідок	true
character_trait_levels_colour_text_att_trait_ybor_touch_1	Тіло, створене богом, може бути під владою ​лише його руки.	true
character_trait_levels_colour_text_att_trait_general_personality_not_barbarian_hates_barbarians_1	Смердючі, штани, надмірно бородаті виправдання для чоловіків. Байстрюки!	true
character_trait_levels_colour_text_att_trait_general_personality_not_nomad_hates_nomads_1	Я чув, що вони п'ють кров своїх коней. Це варварство.	true
character_trait_levels_colour_text_att_trait_general_personality_not_roman_hates_romans_1	Римляни з їхніми прямими дорогами, акведуками, законодавчими шляхами та великими зігнутими носами справді дратують цю людину.	true
character_trait_levels_onscreen_name_att_trait_all_personality_all_melancholic_1	Меланхолік	true
character_trait_levels_colour_text_att_trait_belisarius_marker_1	Велізарій	true
character_trait_levels_onscreen_name_att_trait_general_military_army_all_besieger_good_3	На прорив!	true
character_trait_levels_onscreen_name_att_trait_general_military_army_all_besieger_good_2	До стін!	true
character_trait_levels_onscreen_name_att_trait_general_military_army_all_besieger_good_1	Експерт з облоги	true
character_trait_levels_onscreen_name_att_trait_general_physical_all_scar_disfiguring_1	Потворний шрам	true
character_trait_levels_colour_text_att_trait_ollam_ri_judgement_1	Лезо, як сутінки, швидке і невблаганне.	true
character_trait_levels_onscreen_name_att_trait_ybor_eye_1	Око Годана	true
character_trait_levels_colour_text_att_trait_spy_actions_all_infiltrate_2	Ця людина може злитися з килимами.	true
character_trait_levels_colour_text_att_trait_spy_actions_all_infiltrate_3	Я змінюю своє обличчя так, як інші змінюють свій одяг.	true
character_trait_levels_colour_text_att_trait_spy_actions_all_infiltrate_1	Люди не сумніваються в чесному обличчі.	true
character_trait_levels_colour_text_att_trait_all_personality_all_innate_boring_1	Краще відгризти собі ногу, ніж терпіти товариство цієї людини.	true
character_trait_levels_colour_text_att_trait_ollam_ri_pillage_1	Хватка, як терен, що розриває плащі необережних.	true
character_trait_levels_colour_text_att_trait_theodosius_marker_1	Феодосій	true
character_trait_levels_onscreen_name_att_trait_general_government_all_pacifist_2	Неприхильник війни	true
character_trait_levels_onscreen_name_att_trait_general_government_all_pacifist_3	Пацифіст	true
character_trait_levels_onscreen_name_att_trait_general_government_all_pacifist_1	Не любить війни	true
character_trait_levels_onscreen_name_att_trait_general_military_army_all_defender_good_2	Чудовий захисник	true
character_trait_levels_onscreen_name_att_trait_general_military_army_all_defender_good_3	Відмінний захисник	true
character_trait_levels_onscreen_name_att_trait_general_military_army_all_defender_good_1	Впевнений захисник	true
character_trait_levels_colour_text_att_trait_general_government_all_government_heritage_1	Поки його батько керував провінціями, цей чоловік стежив за кожним його кроком.	true
character_trait_levels_colour_text_att_trait_priest_actions_all_seeds_of_doubt_1	Ви впевнені, що це цілком розумно?	true
character_trait_levels_colour_text_att_trait_priest_actions_all_seeds_of_doubt_2	У мене є це з надійних джерел, що...	true
character_trait_levels_colour_text_att_trait_priest_actions_all_seeds_of_doubt_3	Чи збрехав би я тобі, друже? Міг би я?	true
character_trait_levels_onscreen_name_att_trait_ruler_personality_all_spender_1	Щедрий	true
character_trait_levels_onscreen_name_att_trait_ruler_personality_all_spender_2	Надмірно щедрий	true
character_trait_levels_onscreen_name_att_trait_ruler_personality_all_spender_3	Марнотратний	true
character_trait_levels_onscreen_name_att_trait_spy_actions_all_poison_1	Постачальник отрути	true
character_trait_levels_onscreen_name_att_trait_spy_actions_all_poison_3	Майстер отрути	true
character_trait_levels_onscreen_name_att_trait_spy_actions_all_poison_2	Геніальний отруйник	true
character_trait_levels_onscreen_name_att_trait_general_military_navy_all_blockade_defender_good_1	Проривач блокад	true
character_trait_levels_onscreen_name_att_trait_general_military_navy_all_blockade_defender_good_2	Захисник порту	true
character_trait_levels_onscreen_name_att_trait_general_military_navy_all_blockade_defender_good_3	Руйнівник блокади	true
character_trait_levels_colour_text_att_trait_priest_rank_mobedan_mobed_1	Він проповідник проповідників і захисник святого вогню.	true
character_trait_levels_onscreen_name_att_trait_general_personality_all_innate_arrogant_1	Зарозумілий	true
character_trait_levels_onscreen_name_att_trait_general_military_navy_all_blockader_good_3	Неприступний в блокадах	true
character_trait_levels_onscreen_name_att_trait_general_military_navy_all_blockader_good_2	Майстер блокади	true
character_trait_levels_onscreen_name_att_trait_general_military_navy_all_blockader_good_1	Ефективний при блокаді	true
character_trait_levels_onscreen_name_att_trait_priest_rank_roman_high_priest_1	Понтифік Великий	true
character_trait_levels_colour_text_att_trait_all_personality_all_lucky_1	Деякі люди просто народжуються щасливчиками.	true
character_trait_levels_colour_text_att_trait_all_personality_all_lucky_3	Духи стережуть мене.	true
character_trait_levels_colour_text_att_trait_all_personality_all_lucky_2	Хтось назвав би це удачею, я називаю це вмінням.	true
character_trait_levels_colour_text_att_trait_general_personality_not_barbarian_fears_barbarians_1	Випадкове лепетання «вар-вар-вар» лунає крізь сни цієї людини.	true
character_trait_levels_colour_text_att_trait_general_personality_not_nomad_fears_nomads_1	«Я чув, що вони вбивають усіх своїх полонених. Я б краще помер на бойовищі.	true
character_trait_levels_colour_text_att_trait_general_personality_not_roman_fears_romans_1	Вже одне слово «Римлянин» викликає в цього чоловіка холодний піт.	true
character_trait_levels_onscreen_name_att_trait_ruler_government_all_spymaster_1	Підпільний	true
character_trait_levels_onscreen_name_att_trait_ruler_government_all_spymaster_3	Майстер секретів	true
character_trait_levels_onscreen_name_att_trait_ruler_government_all_spymaster_2	Ліпший шпигун	true
character_trait_levels_colour_text_att_trait_general_military_navy_all_blockade_defender_bad_2	Що Ви маєте на увазі, що ми не повинні дозволяти їм зійти на берег, перш ніж атакувати?	true
character_trait_levels_colour_text_att_trait_general_military_navy_all_blockade_defender_bad_3	Я не піду туди, можу померти!	true
character_trait_levels_colour_text_att_trait_general_military_navy_all_blockade_defender_bad_1	Зачекайте, доки Ви не побачите їхні… О, біда, вони над нами, готуйтеся!	true
character_trait_levels_colour_text_att_trait_general_ability_all_brace_3	Приготуйтеся, мої хлопці, ось вони йдуть!	true
character_trait_levels_colour_text_att_trait_general_ability_all_brace_2	Приготуйтеся, мої хлопці, ось вони йдуть!	true
character_trait_levels_colour_text_att_trait_general_ability_all_brace_1	Приготуйтеся, мої хлопці, ось вони йдуть!	true
character_trait_levels_colour_text_att_trait_general_ability_all_brace_5	Приготуйтеся, мої хлопці, ось вони йдуть!	true
character_trait_levels_colour_text_att_trait_general_ability_all_brace_4	Приготуйтеся, мої хлопці, ось вони йдуть!	true
character_trait_levels_colour_text_bel_trait_mission_payload_influence_positive_1	Велізарій стоїть на голову вище своїх колег-полководців.	true
character_trait_levels_colour_text_att_trait_priest_rank_germanic_high_priest_1	Через вік і досвід ця жінка стала лідером своєї віри.	true
character_trait_levels_colour_text_att_trait_all_personality_all_drink_3	Пийте! Пийте! Чому не п'єте, наволоч?	true
character_trait_levels_colour_text_att_trait_all_personality_all_drink_2	Смійтеся, і світ сміється, коли Ви розливаєте свій напій.	true
character_trait_levels_colour_text_att_trait_all_personality_all_drink_1	Трохи вина нікому не зашкодить.	true
character_trait_levels_colour_text_att_trait_anastasius_marker_1	Анастасій	true
character_trait_levels_colour_text_att_trait_general_government_all_admin_bad_1	Час випити? Ми можемо все це розібрати за тиждень…	true
character_trait_levels_colour_text_att_trait_general_government_all_admin_bad_3	Цей чоловік надто зарозумілий, щоб знати, що він не має першої підказки.	true
character_trait_levels_colour_text_att_trait_general_government_all_admin_bad_2	Ні, я не знаю, куди він подівся. Не важливо...	true
character_trait_levels_onscreen_name_att_trait_spy_actions_all_corrupt_2	Розкрадач	true
character_trait_levels_onscreen_name_att_trait_spy_actions_all_corrupt_3	Аморальний	true
character_trait_levels_onscreen_name_att_trait_spy_actions_all_corrupt_1	Корумпований	true
character_trait_levels_onscreen_name_att_trait_agent_status_all_slave_1	Звільнений раб	true
character_trait_levels_onscreen_name_att_trait_eos_queen_mavia_1	Цариця Танухідів	true
character_trait_levels_colour_text_att_trait_general_personality_all_dishonest_2	Речі такі, які вони є. Вода мокра. Цей чоловік не заслуговує довіри.	true
character_trait_levels_colour_text_att_trait_general_personality_all_dishonest_3	Цей чоловік настільки ж огидно фальшивий, як і вони.	true
character_trait_levels_colour_text_att_trait_general_personality_all_dishonest_1	Цьому чоловікові не можна довіряти більше, ніж його можна кинути. З онагра.	true
character_trait_levels_onscreen_name_att_trait_general_status_roman_blood_feud_1	Вендета	true
character_trait_levels_colour_text_att_trait_all_personality_all_sober_1	Вино може бути приємним, але ця людина ніколи цього не дізнається.	true
character_trait_levels_colour_text_att_trait_all_personality_all_sober_2	Тверезе обмірковування всього - життєвий шлях цієї людини.	true
character_trait_levels_colour_text_att_trait_all_personality_all_sober_3	Під моїм дахом ми не розпусні, хтиві п'яниці, що купаються у власній блювоті!	true
character_trait_levels_colour_text_att_trait_ybor_eye_1	Одним оком дивитися на сьогодення, іншим дивитися в майбутнє.	true
character_trait_levels_colour_text_att_trait_general_ability_all_power_5	Рівно спини, чоловіки, або я їх відріжу!	true
character_trait_levels_colour_text_att_trait_general_ability_all_power_4	Рівно спини, чоловіки, або я їх відріжу!	true
character_trait_levels_colour_text_att_trait_general_ability_all_power_1	Рівно спини, чоловіки, або я їх відріжу!	true
character_trait_levels_colour_text_att_trait_general_ability_all_power_3	Рівно спини, чоловіки, або я їх відріжу!	true
character_trait_levels_colour_text_att_trait_general_ability_all_power_2	Рівно спини, чоловіки, або я їх відріжу!	true
character_trait_levels_onscreen_name_att_trait_ollam_ri_pillage_1	Хижість Оллама Рі (Верховного Короля)	true
character_trait_levels_colour_text_bel_trait_mission_payload_influence_negative_1	Велізарій бачить, що його влада ослабла.	true
character_trait_levels_colour_text_att_trait_general_status_all_spurned_1	Втрата статусу та престижу зробила цю людину озлобленою, заздрісною та незадоволеною.	true
character_trait_levels_colour_text_att_trait_ruler_personality_all_kind_3	Я вирішую бути добрим до свого народу. Це заохочує вірність.	true
character_trait_levels_colour_text_att_trait_ruler_personality_all_kind_2	Будь-який дурень може зробити нещастя. Я вибираю бути кращим за дурня.	true
character_trait_levels_colour_text_att_trait_ruler_personality_all_kind_1	Доброта – це не слабкість. Доброта – це сила.	true
character_trait_levels_colour_text_att_trait_general_personality_civilised_adulterer_3	Його дружина, дружина командувача, дружина губернатора. Всі гарні і всі піддалися…	true
character_trait_levels_colour_text_att_trait_general_personality_civilised_adulterer_2	Не будьте такими провінційними щодо цих речей.	true
character_trait_levels_colour_text_att_trait_general_personality_civilised_adulterer_1	Гарна сукня. Це краще виглядатиме на підлозі моєї спальні.	true
character_trait_levels_onscreen_name_att_trait_all_personality_all_phlegmatic_1	Флегматик	true
character_trait_levels_onscreen_name_att_trait_general_government_civilised_politician_1	Політична тварина	true
character_trait_levels_onscreen_name_att_trait_general_government_civilised_politician_3	Політичний політик	true
character_trait_levels_onscreen_name_att_trait_general_government_civilised_politician_2	Політик	true
character_trait_levels_colour_text_att_trait_champion_actions_all_guerrilla_activity_1	Я воюю там, де немає ворога.	true
character_trait_levels_colour_text_att_trait_champion_actions_all_guerrilla_activity_3	Темрява ховає армію ножів.	true
character_trait_levels_colour_text_att_trait_champion_actions_all_guerrilla_activity_2	Я не борюся з силою мого ворога, тільки з його слабкістю.	true
character_trait_levels_colour_text_att_trait_general_status_all_popular_3	Сонячна особистість і способи перемоги цієї людини подобаються кожному, кого він зустрічає.	true
character_trait_levels_colour_text_att_trait_general_status_all_popular_2	Сіль землі, більшість людей високо оцінюють цю людину.	true
character_trait_levels_colour_text_att_trait_general_status_all_popular_1	Людина слова, він говорить те, що має на увазі, і робить саме те, що говорить.	true
character_trait_levels_colour_text_att_trait_general_military_navy_all_defender_sea_bad_1	Цей чоловік викинув за борт книгу з морської тактики. Дурень.	true
character_trait_levels_colour_text_att_trait_general_military_navy_all_defender_sea_bad_2	Цей чоловік не міг захистити честь своєї матері, не кажучи вже про фльоту.	true
character_trait_levels_colour_text_att_trait_general_military_navy_all_defender_sea_bad_3	Екскременти чайок мають більшу захисну здатність.	true
character_trait_levels_onscreen_name_att_trait_ruler_personality_all_paranoid_1	Нервовий	true
character_trait_levels_onscreen_name_att_trait_ruler_personality_all_paranoid_2	Збентежений	true
character_trait_levels_colour_text_att_trait_all_personality_all_innate_uncompromising_1	Я не приймаю ні як відповідь.	true
character_trait_levels_onscreen_name_att_trait_ruler_personality_all_paranoid_3	Зляканий	true
character_trait_levels_onscreen_name_att_trait_general_personality_roman_unpatriotic_1	Цікавість в іноземному	true
character_trait_levels_onscreen_name_att_trait_general_personality_roman_unpatriotic_2	Одержимість чужинському	true
character_trait_levels_onscreen_name_att_trait_general_personality_roman_unpatriotic_3	Іноземна вульгарність	true
character_trait_levels_colour_text_att_trait_general_military_all_disciplinarian_bad_1	Добрі слова не виграють битв.	true
character_trait_levels_colour_text_att_trait_general_military_all_disciplinarian_bad_3	Солдатам потрібна сталь, а не м'які слова.	true
character_trait_levels_colour_text_att_trait_general_military_all_disciplinarian_bad_2	Легкий характер вітається, поки ворожі мечі не оголені.	true
character_trait_levels_onscreen_name_att_trait_general_military_all_military_heritage_1	Військова спадщина	true
character_trait_levels_colour_text_att_trait_agent_status_roman_poor_1	Людина низького походження, але гідна за своєю природою, може належним чином піднятися до слави у світі.	true
character_trait_levels_colour_text_att_trait_general_government_all_admin_good_3	Ця людина настільки ефективна, що люди дивуються, чим він займається цілий день.	true
character_trait_levels_colour_text_att_trait_general_government_all_admin_good_2	Надійна адміністрація – як свіже повітря. ЇЇ відсутність швидко помічається.	true
character_trait_levels_colour_text_att_trait_general_government_all_admin_good_1	Ця людина може об’єднати зусилля багатьох для досягнення практично будь-якої мети.	true
character_trait_levels_onscreen_name_att_trait_general_personality_all_bravery_1	Далекий від страху	true
character_trait_levels_onscreen_name_att_trait_general_military_all_strategist_1	Розуміє війну	true
character_trait_levels_onscreen_name_att_trait_general_military_all_strategist_2	Стратег	true
character_trait_levels_onscreen_name_att_trait_general_personality_all_bravery_3	Абсолютно безстрашний	true
character_trait_levels_onscreen_name_att_trait_general_military_all_strategist_3	Майстер-стратег	true
character_trait_levels_onscreen_name_att_trait_general_personality_all_bravery_2	Відомо хоробрий	true
character_trait_levels_onscreen_name_att_trait_general_personality_all_fervour_3	Без розуму від цього!	true
character_trait_levels_onscreen_name_att_trait_general_personality_all_fervour_2	Смак до битви	true
character_trait_levels_onscreen_name_att_trait_general_personality_all_fervour_1	Різкий	true
character_trait_levels_onscreen_name_att_trait_general_military_army_all_attacker_good_1	Впевнений нападник	true
character_trait_levels_onscreen_name_att_trait_general_military_army_all_attacker_good_2	Гарний нападаючий	true
character_trait_levels_onscreen_name_att_trait_general_military_army_all_attacker_good_3	Кращий атакуючий	true
character_trait_levels_colour_text_att_trait_ollam_ri_wisdom_1	Розум, як океан, древній і незбагненний.	true
character_trait_levels_colour_text_att_trait_ruler_government_all_negotiator_1	Ця людина завжди розуміла такт і дипломатичні тонкощі.	true
character_trait_levels_colour_text_att_trait_ruler_government_all_negotiator_2	Ця людина володіє талантом переконання і розумного компромісу.	true
character_trait_levels_colour_text_att_trait_ruler_government_all_negotiator_3	Такт, тонкість і володіння іноземними мовами роблять цю людину неперевершеним дипломатом.	true
character_trait_levels_colour_text_att_trait_priest_actions_all_betray_1	Деякі люди продали б власну матір в ім'я просування.	true
character_trait_levels_colour_text_att_trait_priest_actions_all_betray_3	Все гарне пішло, не залишилося нічого, крім зради.	true
character_trait_levels_colour_text_att_trait_priest_actions_all_betray_2	Ніколи не слід довіряти тим, хто займається брехнею.	true
character_trait_levels_onscreen_name_att_trait_general_personality_all_honest_1	Заслуговує довіри	true
character_trait_levels_onscreen_name_att_trait_general_personality_all_honest_2	Чесний	true
character_trait_levels_onscreen_name_att_trait_general_personality_all_honest_3	Чесний	true
character_trait_levels_onscreen_name_att_trait_priest_rank_germanic_high_priest_1	Верховна жриця	true
character_trait_levels_colour_text_att_trait_all_physical_all_unhealthy_1	Дитяча хвороба кидає тінь на цю людину.	true
character_trait_levels_colour_text_att_trait_all_physical_all_unhealthy_2	Як сказала мама, здоров'я варто берегти...	true
character_trait_levels_colour_text_att_trait_all_physical_all_unhealthy_3	Навіть взяття в руки меча виснажує цього бідолаху.	true
character_trait_levels_colour_text_att_trait_general_physical_all_blind_1	Цей хлопець втратив зір і поринув у світ темряви.	true
character_trait_levels_colour_text_bel_trait_mission_payload_attrition_immunity_1	Добре забезпечена сила може вижити в найсуворішій пустелі.	true
character_trait_levels_onscreen_name_att_trait_general_government_all_admin_bad_2	Некомпетентний адміністратор	true
character_trait_levels_onscreen_name_att_trait_general_government_all_admin_bad_3	Нерозумний адміністратор	true
character_trait_levels_onscreen_name_att_trait_general_government_all_admin_bad_1	Неефективний адміністратор	true
character_trait_levels_colour_text_att_trait_priest_actions_all_devout_1	Бог, нація, батьки, рід. Суворо в такому порядку.	true
character_trait_levels_colour_text_att_trait_priest_actions_all_devout_2	І його слово принесе вічну смерть тим, хто протистоїть праведним.	true
character_trait_levels_colour_text_att_trait_priest_actions_all_devout_3	Бо демон буде носити дев'ятилезовий меч. Дев'ятилезовий! Не два чи п'ять чи сім, а дев'ять!	true
character_trait_levels_colour_text_att_trait_champion_actions_all_instructor_1	Важкі вчити – легко бити.	true
character_trait_levels_colour_text_att_trait_champion_actions_all_instructor_3	Чоловіки ненавидять його від душі, але вони роблять те, що їм говорять.	true
character_trait_levels_colour_text_att_trait_champion_actions_all_instructor_2	Муштра - це поклоніння! Поклоніння богам війни!	true
character_trait_levels_colour_text_att_trait_general_ability_all_recon_1	Я просто знаю, де ворог.	true
character_trait_levels_colour_text_att_trait_general_ability_all_recon_3	Я просто знаю, де ворог.	true
character_trait_levels_colour_text_att_trait_general_ability_all_recon_2	Я просто знаю, де ворог.	true
character_trait_levels_colour_text_att_trait_general_ability_all_recon_5	Я просто знаю, де ворог.	true
character_trait_levels_colour_text_att_trait_general_ability_all_recon_4	Я просто знаю, де ворог.	true
character_trait_levels_colour_text_att_trait_general_physical_all_maimed_arm_1	У ці дні він повинен задовольнятися тим, що веде бій за спинами.	true
character_trait_levels_colour_text_att_trait_general_physical_all_maimed_leg_1	У ці дні він повинен задовольнятися тим, що веде бій за спинами.	true
character_trait_levels_colour_text_att_trait_priest_actions_all_propagandist_2	Змусити людей зрозуміти…	true
character_trait_levels_colour_text_att_trait_priest_actions_all_propagandist_3	Ви кажете «різанина». Я кажу «тривіальна сутичка».	true
character_trait_levels_colour_text_att_trait_priest_actions_all_propagandist_1	Шлях до слів - потужна майстерність.	true
character_trait_levels_colour_text_att_trait_general_personality_all_cowardice_2	Страх заважає цій людині в битві. Страх бою.	true
character_trait_levels_colour_text_att_trait_general_personality_all_cowardice_3	Боязкість цього чоловіка в бою добре відома.	true
character_trait_levels_colour_text_att_trait_general_personality_all_cowardice_1	Ця людина втікає з бою до того, як це буде вкрай необхідно. Або ховається.	true
character_trait_levels_colour_text_att_trait_general_military_navy_all_blockade_defender_good_3	Все, що перегороджує шлях цій людині, буде корягою.	true
character_trait_levels_colour_text_att_trait_general_military_navy_all_blockade_defender_good_2	Вони не стануть на той берег! Нам усім доведеться померти, перш ніж я дозволю це!	true
character_trait_levels_colour_text_att_trait_general_military_navy_all_blockade_defender_good_1	Це лише кілька човнів, і жоден із них не такий швидкісний, як ми. Повір мені.	true
character_trait_levels_onscreen_name_att_trait_general_ability_all_war_5	Бойовий вигук V	true
character_trait_levels_onscreen_name_att_trait_general_ability_all_war_4	Бойовий вигук IV	true
character_trait_levels_onscreen_name_att_trait_eos_dam_repair_1	Головний наглядач	true
character_trait_levels_onscreen_name_att_trait_general_ability_all_war_3	Бойовий вигук III	true
character_trait_levels_onscreen_name_att_trait_general_ability_all_war_2	Бойовий вигук II	true
character_trait_levels_onscreen_name_att_trait_general_ability_all_war_1	Бойовий вигук I	true
character_trait_levels_colour_text_att_trait_general_military_navy_all_blockader_good_1	Я хочу, щоб Ви заповнювали стрілками все, що намагається пробити цю лінію, зрозуміло?	true
character_trait_levels_onscreen_name_att_trait_photius_marker_1	Фотій	true
character_trait_levels_colour_text_att_trait_general_military_navy_all_blockader_good_2	Ця людина — досвідчений морський капітан і майстер морської блокади.	true
character_trait_levels_colour_text_att_trait_general_military_navy_all_blockader_good_3	Усе, що є в порту, точно не вилізе знову.	true
character_trait_levels_colour_text_bel_trait_mission_payload_missionary_1	Правдива віра буде жити до тих пір, поки я маю дихання в моєму тілі.	true
character_trait_levels_colour_text_att_trait_general_military_navy_all_attacker_sea_bad_2	Мати цього чоловіка кращий адмірал.	true
character_trait_levels_colour_text_att_trait_general_military_navy_all_attacker_sea_bad_3	Командування на морі дало цій людині блискучий шолом. Але більше нічого.	true
character_trait_levels_colour_text_att_trait_general_military_navy_all_attacker_sea_bad_1	Цей чоловік невпевнений у воді. І в бою.	true
character_trait_levels_onscreen_name_att_trait_priest_rank_tengri_high_priest_1	Понтифік Великий	true
character_trait_levels_colour_text_att_trait_ioannina_marker_1	Йоаніна	true
character_trait_levels_colour_text_att_trait_ollam_ri_bounty_1	Дотик, як сонце, що витягує життя з землі.	true
character_trait_levels_colour_text_att_trait_champion_actions_all_cruel_1	Іноді достатньо репутації насильника.	true
character_trait_levels_colour_text_att_trait_champion_actions_all_cruel_3	Досить підняти брови, щоб перетворити кишки чоловіків на воду.	true
character_trait_levels_colour_text_att_trait_champion_actions_all_cruel_2	Не бійся, я не зроблю тобі сильно боляче.	true
character_trait_levels_colour_text_att_trait_champion_actions_all_arson_3	Полум'я гарненьке.	true
character_trait_levels_colour_text_att_trait_champion_actions_all_arson_2	Треба вирішувати гострі проблеми.	true
character_trait_levels_colour_text_att_trait_champion_actions_all_arson_1	Як Ви змусите раба «агукати»?	true
character_trait_levels_colour_text_att_trait_general_ability_all_second_5	Це? Це просто подряпина на шкірі! Хто наступний?!	true
character_trait_levels_colour_text_att_trait_general_ability_all_second_4	Це? Це просто подряпина на шкірі! Хто наступний?!	true
character_trait_levels_colour_text_att_trait_general_ability_all_second_1	Це? Це просто подряпина на шкірі! Хто наступний?!	true
character_trait_levels_colour_text_att_trait_general_ability_all_second_3	Це? Це просто подряпина на шкірі! Хто наступний?!	true
character_trait_levels_colour_text_att_trait_general_ability_all_second_2	Це? Це просто подряпина на шкірі! Хто наступний?!	true
character_trait_levels_colour_text_att_trait_general_ability_all_raise_3	Справжній герой ніколи не уникає бою.	true
character_trait_levels_colour_text_att_trait_general_ability_all_raise_2	Справжній герой ніколи не уникає бою.	true
character_trait_levels_colour_text_att_trait_general_ability_all_raise_1	Справжній герой ніколи не уникає бою.	true
character_trait_levels_colour_text_att_trait_general_ability_all_rally_4	Крім хоробрості, ця людина вселяє мужність у своїх послідовників.	true
character_trait_levels_colour_text_att_trait_general_ability_all_rally_5	Крім хоробрості, ця людина вселяє мужність у своїх послідовників.	true
character_trait_levels_colour_text_att_trait_general_ability_all_rally_2	Крім хоробрості, ця людина вселяє мужність у своїх послідовників.	true
character_trait_levels_colour_text_att_trait_general_ability_all_rally_3	Крім хоробрості, ця людина вселяє мужність у своїх послідовників.	true
character_trait_levels_colour_text_att_trait_general_ability_all_raise_5	Справжній герой ніколи не уникає бою.	true
character_trait_levels_colour_text_att_trait_general_ability_all_raise_4	Справжній герой ніколи не уникає бою.	true
character_trait_levels_colour_text_att_trait_general_ability_all_rally_1	Крім хоробрості, ця людина вселяє мужність у своїх послідовників.	true
character_trait_levels_onscreen_name_att_trait_general_physical_all_infertile_2	Безплідний	true
character_trait_levels_onscreen_name_att_trait_general_physical_all_infertile_3	Пустка	true
character_trait_levels_colour_text_att_trait_antonina_marker_1	Антоніна	true
character_trait_levels_onscreen_name_att_trait_general_physical_all_infertile_1	Млявий	true
character_trait_levels_onscreen_name_cha_trait_leader_influence	Впливовий	true
character_trait_levels_colour_text_att_trait_general_military_all_noctophobia_1	У темряві чулися дивні звуки. Ця людина пам'ятає їх усіх.	true
character_trait_levels_colour_text_att_trait_general_military_all_noctophobia_3	Цю людину жахають темні нескінченні години ночі.	true
character_trait_levels_colour_text_att_trait_general_military_all_noctophobia_2	Темрява не друг. Навпаки.	true
character_trait_levels_colour_text_att_trait_general_personality_all_innate_arrogant_1	Я чудовий! Ні, справді, ти не розумієш.	true
character_trait_levels_onscreen_name_att_trait_general_military_army_all_attacker_bad_2	Слабенький нападник	true
character_trait_levels_onscreen_name_att_trait_general_military_army_all_attacker_bad_3	Слабкий нападник	true
character_trait_levels_onscreen_name_att_trait_general_military_army_all_attacker_bad_1	Нерішучий нападник	true
character_trait_levels_onscreen_name_att_trait_spy_actions_all_scout_1	Розвідник	true
character_trait_levels_onscreen_name_att_trait_spy_actions_all_scout_3	Очі Яструба	true
character_trait_levels_onscreen_name_att_trait_spy_actions_all_scout_2	Досвідчений розвідник	true
character_trait_levels_onscreen_name_att_trait_general_physical_all_scar_distinguishing_1	Відмінний рубець	true
character_trait_levels_onscreen_name_att_trait_general_personality_all_innate_humble_1	Невибагливий	true
character_trait_levels_onscreen_name_att_trait_general_personality_all_bereaved_1	З розбитим серцем	true
character_trait_levels_onscreen_name_att_trait_general_personality_all_bereaved_2	Позбавлений	true
character_trait_levels_onscreen_name_att_trait_general_personality_all_bereaved_3	Все втрачено	true
character_trait_levels_onscreen_name_att_trait_agent_status_not_roman_wealthy_1	Можновладець	true
character_trait_levels_colour_text_att_trait_all_physical_all_healthy_1	Міцний хлопець, сильний, як віл!	true
character_trait_levels_colour_text_att_trait_all_physical_all_healthy_3	Цей чоловік благословенний статурою бога!	true
character_trait_levels_colour_text_att_trait_all_physical_all_healthy_2	Хвороба – це те, що трапляється з іншими людьми.	true
character_trait_levels_onscreen_name_att_trait_general_military_navy_all_blockade_defender_bad_2	Некомпетентний захисник порту	true
character_trait_levels_onscreen_name_att_trait_general_military_navy_all_blockade_defender_bad_3	Боїться залишити доки	true
character_trait_levels_onscreen_name_att_trait_general_military_navy_all_blockade_defender_bad_1	Неефективний захисник портів	true
character_trait_levels_onscreen_name_att_trait_all_personality_all_easily_distracted_1	Легко відволікається	true
character_trait_levels_onscreen_name_att_trait_general_military_all_survivor_3	Невразливий	true
character_trait_levels_onscreen_name_att_trait_general_military_army_all_besieger_bad_3	Боїться стін	true
character_trait_levels_onscreen_name_att_trait_general_military_all_survivor_2	Майже невразливий	true
character_trait_levels_onscreen_name_att_trait_general_military_army_all_besieger_bad_2	Збентежений облогою	true
character_trait_levels_onscreen_name_att_trait_general_military_all_survivor_1	Живкий	true
character_trait_levels_onscreen_name_att_trait_general_military_army_all_besieger_bad_1	Темний в облогах	true
character_trait_levels_colour_text_att_trait_general_military_all_noctophilia_3	Народжений опівночі, цей чоловік обурюється приходом світанку...	true
character_trait_levels_colour_text_att_trait_general_military_all_noctophilia_2	Настає ніч і застає його самого, загубленого у мріях у світі, повному тіней.	true
character_trait_levels_colour_text_att_trait_general_military_all_noctophilia_1	Люди лякаються в темряві. Не цей чоловік.	true
character_trait_levels_onscreen_name_att_trait_general_personality_not_eastern_fears_easterners_1	Боїться брутальних східняків	true
character_trait_levels_colour_text_att_trait_spy_actions_all_corrupt_2	Золото просто лежало в моїй сумочці.	true
character_trait_levels_colour_text_att_trait_spy_actions_all_corrupt_3	Правильно і неправильно: дві сторони однієї золотої медалі.	true
character_trait_levels_colour_text_att_trait_spy_actions_all_corrupt_1	Я шукаю переваги. Який чоловік не робить це?	true
character_trait_levels_colour_text_att_trait_agent_personality_all_mad_3	Я маленький горщик гарум, низький і кремезний…	true
character_trait_levels_colour_text_att_trait_agent_personality_all_mad_2	Мені подобаються твої очі. У тебе гарні очі. Дуже гарні очі. так	true
character_trait_levels_colour_text_att_trait_agent_personality_all_mad_1	Це важливо? Дз-ж-ж-ж! Дз-ж-ж-ж! Я сьогодні не зробив достатньо меду! Дз-ж-ж-ж!	true
character_trait_levels_onscreen_name_att_trait_all_personality_all_energetic_3	Життєвий	true
character_trait_levels_onscreen_name_att_trait_all_personality_all_energetic_2	Енергійний	true
character_trait_levels_onscreen_name_att_trait_all_personality_all_energetic_1	Жвавий	true
character_trait_levels_onscreen_name_att_trait_general_government_all_architect_3	Архітектор	true
character_trait_levels_onscreen_name_att_trait_general_government_all_architect_2	Інженер	true
character_trait_levels_onscreen_name_att_trait_general_government_all_architect_1	Будівельник	true
character_trait_levels_onscreen_name_bel_trait_mission_payload_harmony_1	Захисник гармонії	true
character_trait_levels_colour_text_att_trait_agent_physical_all_innate_clumsy_1	Дві ліві руки краще, ніж жодної.	true
character_trait_levels_onscreen_name_att_trait_priest_rank_celtic_high_druid_1	Верховний друїд	true
character_trait_levels_onscreen_name_att_trait_general_personality_not_eastern_hates_easterners_1	Ненавидить східняків	true
character_trait_levels_colour_text_att_trait_general_personality_not_roman_patriotic_1	Його вроджене відчуття добра й зла гарантує, що цей чоловік залишиться вірним до кінця, де б він не був.	true
character_trait_levels_colour_text_att_trait_general_personality_not_roman_patriotic_3	Слухай, вони не такі, як ми, це все, що я кажу. І я справді не впевнена щодо макіяжу очей.	true
character_trait_levels_colour_text_att_trait_general_personality_not_roman_patriotic_2	Кожна хвилина кожного дня присвячена виконанню поставленої справи. Будьте певні, цей чоловік завжди доставить.	true
character_trait_levels_colour_text_att_trait_priest_rank_arian_bishop_1	Ця людина була визнана своєю побожною відданістю Церкві.	true
character_trait_levels_onscreen_name_bel_trait_mission_payload_battle_hardened_narses_1	Відбірний	true
character_trait_levels_onscreen_name_att_trait_general_military_army_all_defender_bad_1	Невпевнений захисник	true
character_trait_levels_onscreen_name_att_trait_general_military_army_all_defender_bad_2	Слабкий захисник	true
character_trait_levels_onscreen_name_att_trait_general_military_army_all_defender_bad_3	Поганий захисник	true
character_trait_levels_onscreen_name_att_trait_general_military_navy_all_blockader_bad_3	Жахливий при блокаді	true
character_trait_levels_onscreen_name_att_trait_general_military_navy_all_blockader_bad_2	Поганенький при блокаді	true
character_trait_levels_onscreen_name_att_trait_general_military_navy_all_blockader_bad_1	Сумнівний при блокаді	true
character_trait_levels_colour_text_att_trait_general_military_army_all_ambusher_good_2	Перше й останнє, що знають цілі, які потрапили в засідку, це те, що вони мертві!	true
character_trait_levels_colour_text_att_trait_general_military_army_all_ambusher_good_3	У цій людині уособлено благородне мистецтво дивувати.	true
character_trait_levels_colour_text_att_trait_general_military_army_all_ambusher_good_1	Ця людина влаштовує засідки важкі та швидкі, і мало хто залишає в живих, щоб розповісти про це.	true
character_trait_levels_colour_text_att_trait_general_personality_not_roman_unpatriotic_1	Цей чоловік має «здоровий інтерес» до космополітичних питань.	true
character_trait_levels_colour_text_att_trait_general_personality_not_roman_unpatriotic_2	Є прояв інтересу, а потім набридає товаришам до напівсмерті.	true
character_trait_levels_colour_text_att_trait_general_personality_not_roman_unpatriotic_3	Те, що цей чоловік вважає привабливим, більшість інших вважає верхом поганого смаку.	true
character_trait_levels_onscreen_name_att_trait_all_personality_all_innate_intelligent_1	Розумний	true
character_trait_levels_onscreen_name_att_trait_general_personality_all_gambling_3	В'язень удачі	true
character_trait_levels_onscreen_name_att_trait_general_personality_all_gambling_2	Завзятий гравець	true
character_trait_levels_onscreen_name_att_trait_general_personality_all_gambling_1	Азартний гравець	true
character_trait_levels_onscreen_name_att_trait_general_military_all_disciplinarian_good_1	Педант	true
character_trait_levels_onscreen_name_att_trait_general_military_all_disciplinarian_good_2	Наглядач	true
character_trait_levels_onscreen_name_att_trait_general_military_all_disciplinarian_good_3	Гнобитель	true
character_trait_levels_onscreen_name_att_trait_agent_physical_all_innate_inbred_1	У сім'ї	true
character_trait_levels_onscreen_name_att_trait_general_personality_not_eastern_likes_easterners_1	Любить східняків	true
character_trait_levels_colour_text_att_trait_agent_physical_all_innate_very_very_inbred_1	Зберігати чистоту кровної лінії не завжди є гарною ідеєю.	true
character_trait_levels_colour_text_att_trait_all_personality_all_melancholic_1	Посміхатися, навіть над чужим нещастям, не є природним для цього старого кислого обличчя.	true
character_trait_levels_colour_text_att_trait_all_personality_all_lazy_1	Навіщо робити сьогодні те, що можна відкласти на наступний тиждень?	true
character_trait_levels_colour_text_att_trait_general_ability_all_fear_4	Ні, ти не переживеш це.	true
character_trait_levels_colour_text_att_trait_general_ability_all_fast_1	Хто хоче жити вічно? В наступ!!!	true
character_trait_levels_colour_text_att_trait_general_ability_all_fear_5	Ні, ти не переживеш це.	true
character_trait_levels_colour_text_att_trait_all_personality_all_lazy_3	Якби він міг знайти когось іншого, хто б за нього переставив кишки, він би це зробив.	true
character_trait_levels_colour_text_att_trait_general_ability_all_fast_2	Хто хоче жити вічно? В наступ!!!	true
character_trait_levels_colour_text_att_trait_all_personality_all_lazy_2	Чому я повинен? Ті раби простоюють.	true
character_trait_levels_colour_text_att_trait_general_ability_all_fast_3	Хто хоче жити вічно? В наступ!!!	true
character_trait_levels_colour_text_att_trait_all_personality_all_lewd_1	Нескінченні викриття збоченості, реальної та вигаданої, з часом набридають.	true
character_trait_levels_colour_text_att_trait_general_ability_all_fast_4	Хто хоче жити вічно? В наступ!!!	true
character_trait_levels_colour_text_att_trait_general_ability_all_fast_5	Хто хоче жити вічно? В наступ!!!	true
character_trait_levels_colour_text_att_trait_general_ability_all_fear_1	Ні, ти не переживеш це.	true
character_trait_levels_colour_text_att_trait_all_personality_all_lewd_3	Навіть при найкоротшій зустрічі з цим мерзенним збоченцем більшість людей біжить до лазні, щоб почистити себе.	true
character_trait_levels_colour_text_att_trait_general_ability_all_fear_2	Ні, ти не переживеш це.	true
character_trait_levels_colour_text_att_trait_all_personality_all_lewd_2	Навіть боги хтивості відвернулися від цього підлого чоловіка.	true
character_trait_levels_colour_text_att_trait_general_ability_all_fear_3	Ні, ти не переживеш це.	true
character_trait_levels_onscreen_name_att_trait_general_personality_all_girls_2	Ненаситний	true
character_trait_levels_onscreen_name_att_trait_general_personality_all_girls_3	Абсолютно ненаситний	true
character_trait_levels_onscreen_name_att_trait_general_personality_all_girls_1	Влюбливий	true
character_trait_levels_colour_text_att_trait_general_military_army_all_besieger_good_3	Вміння облоги цієї людини майже легендарні.	true
character_trait_levels_colour_text_att_trait_general_military_army_all_besieger_good_2	Чудові навички штурму стін роблять цю людину експертом.	true
character_trait_levels_colour_text_att_trait_general_military_army_all_besieger_good_1	У цієї людини є око на слабкість і талант її використовувати.	true
character_trait_levels_colour_text_att_trait_general_government_all_pacifist_2	Я не заберу чуже життя. Я не можу.	true
character_trait_levels_colour_text_att_trait_general_government_all_pacifist_3	Це таке марнотратство життів і для чого?	true
character_trait_levels_colour_text_att_trait_general_government_all_pacifist_1	Війна: чому вона корисна? Абсолютно ні для чого!	true
character_trait_levels_colour_text_att_trait_general_military_army_all_defender_good_2	Досвід цього чоловіка в обороні додає йому впевненості.	true
character_trait_levels_colour_text_att_trait_general_military_army_all_defender_good_3	Чудова захисна майстерність цієї людини часто бере верх над нападниками.	true
character_trait_levels_colour_text_att_trait_general_military_army_all_defender_good_1	У захисті ця людина має чітку голову і сильну руку.	true
character_trait_levels_onscreen_name_att_trait_general_government_all_warmonger_1	Схвалює війну	true
character_trait_levels_onscreen_name_att_trait_general_government_all_warmonger_2	Розпалювач війни	true
character_trait_levels_onscreen_name_att_trait_general_government_all_warmonger_3	Одержимий геноцидом	true
character_trait_levels_colour_text_att_trait_general_physical_all_innate_ugly_1	Моя мама любила мене. я думаю...	true
character_trait_levels_onscreen_name_att_trait_general_government_all_trader_1	Торговець	true
character_trait_levels_onscreen_name_att_trait_general_government_all_trader_3	Магістр торгівлі	true
character_trait_levels_onscreen_name_att_trait_general_government_all_trader_2	Людина бізнесу	true
character_trait_levels_colour_text_att_trait_general_personality_all_bravery_1	Битва — давній друг, бажаний як добре вино.	true
character_trait_levels_colour_text_att_trait_general_military_all_strategist_1	Цей чоловік розуміє основну стратегію і знає, що йому потрібно вчитися більше.	true
character_trait_levels_colour_text_att_trait_general_military_all_strategist_2	Ця людина є експертом зі стратегії та історії війни.	true
character_trait_levels_colour_text_att_trait_general_personality_all_bravery_3	Безстрашний воїн, його люди завжди слідують за ним, незважаючи на ризик.	true
character_trait_levels_colour_text_att_trait_general_military_all_strategist_3	Розуміння цієї людини у військових справах викликає заздрість у всіх.	true
character_trait_levels_colour_text_att_trait_general_personality_all_bravery_2	Мужність цієї людини надихає на багато великих бойових подвигів.	true
character_trait_levels_colour_text_att_trait_general_personality_all_fervour_3	Я люблю запах трупів вранці. Пахне… перемогою!	true
character_trait_levels_colour_text_att_trait_general_personality_all_fervour_2	На них! На них! Тепер не відкладати!	true
character_trait_levels_colour_text_att_trait_general_personality_all_fervour_1	Хоробрість – це добре, але…	true
character_trait_levels_onscreen_name_att_trait_ollam_ri_wisdom_1	Блиск Оллама Рі (Верховного Короля)	true
character_trait_levels_colour_text_att_trait_general_military_army_all_attacker_good_1	Ця людина демонструє ознаки величі під час нападу.	true
character_trait_levels_colour_text_att_trait_general_military_army_all_attacker_good_2	Талан в тактиці надихає людей	true
character_trait_levels_colour_text_att_trait_general_military_army_all_attacker_good_3	Цей чоловік практично неперевершений в атаці.	true
character_trait_levels_onscreen_name_att_trait_ruler_government_all_negotiator_1	Справжній оратор	true
character_trait_levels_onscreen_name_att_trait_ruler_government_all_negotiator_2	Дипломат	true
character_trait_levels_onscreen_name_att_trait_ruler_government_all_negotiator_3	Чудовий переговорник	true
character_trait_levels_onscreen_name_att_trait_general_military_army_all_ambusher_bad_1	Зіпсована доля	true
character_trait_levels_onscreen_name_att_trait_general_military_army_all_ambusher_bad_2	Очевидний	true
character_trait_levels_onscreen_name_att_trait_general_military_army_all_ambusher_bad_3	Необізнаний в засідках	true
character_trait_levels_onscreen_name_att_trait_agent_physical_all_innate_very_inbred_1	Нещасне походження	true
character_trait_levels_colour_text_att_trait_general_personality_not_eastern_fears_easterners_1	Вони лили йому в горло розтоплене золото. Я почав вже відкладати цеглинки, мушу Вам сказати.	true
character_trait_levels_onscreen_name_att_trait_general_military_all_noctophilia_1	Любить темряву	true
character_trait_levels_onscreen_name_att_trait_general_military_all_noctophilia_2	Нічна сова	true
character_trait_levels_onscreen_name_att_trait_general_military_all_noctophilia_3	Обожнювач темряви	true
character_trait_levels_onscreen_name_att_trait_narses_marker_1	Нарсес	true
character_trait_levels_colour_text_att_trait_general_government_all_architect_1	Великі будівлі, що височіють, щось говорять про будівельника.	true
character_trait_levels_colour_text_att_trait_general_government_all_architect_2	Мене запам'ятають як будівельника, а не вбивцю!	true
character_trait_levels_colour_text_att_trait_general_government_all_architect_3	Мій зір триватиме тисячу років!	true
character_trait_levels_onscreen_name_att_trait_champion_actions_all_instructor_1	Знахар	true
character_trait_levels_onscreen_name_att_trait_champion_actions_all_instructor_3	Прискіпливий керівник	true
character_trait_levels_onscreen_name_att_trait_champion_actions_all_instructor_2	Солдафон	true
character_trait_levels_onscreen_name_att_trait_priest_actions_all_propagandist_2	Балакун	true
character_trait_levels_onscreen_name_att_trait_priest_actions_all_propagandist_3	Пропагандист	true
character_trait_levels_onscreen_name_att_trait_priest_actions_all_propagandist_1	Оповідач казок	true
character_trait_levels_onscreen_name_att_trait_general_physical_all_maimed_arm_1	Покалічена рука	true
character_trait_levels_onscreen_name_att_trait_general_physical_all_maimed_leg_1	Покалічена нога	true
character_trait_levels_onscreen_name_att_trait_general_government_all_military_admin_1	Чудова майстерність	true
character_trait_levels_onscreen_name_att_trait_general_government_all_military_admin_2	Адміністративний експерт	true
character_trait_levels_onscreen_name_att_trait_general_government_all_military_admin_3	Військовий секретар	true
character_trait_levels_onscreen_name_att_trait_general_military_all_noctophobia_2	Нічні жахи	true
character_trait_levels_onscreen_name_att_trait_general_military_all_noctophobia_3	Страх темряви	true
character_trait_levels_onscreen_name_att_trait_general_military_all_noctophobia_1	Страх темряви	true
character_trait_levels_colour_text_att_trait_general_ability_all_war_3	Його жага битви невгамовна, незалежно від ціни життя.	true
character_trait_levels_colour_text_att_trait_general_ability_all_war_2	Його жага битви невгамовна, незалежно від ціни життя.	true
character_trait_levels_colour_text_att_trait_general_ability_all_war_1	Його жага битви невгамовна, незалежно від ціни життя.	true
character_trait_levels_colour_text_att_trait_general_ability_all_war_5	Його жага битви невгамовна, незалежно від ціни життя.	true
character_trait_levels_colour_text_att_trait_general_ability_all_war_4	Його жага битви невгамовна, незалежно від ціни життя.	true
character_trait_levels_colour_text_att_trait_general_physical_all_scar_distinguishing_1	О, я не знаю, жінки думають, що це досить привабливо!	true
character_trait_levels_colour_text_att_trait_ruler_personality_all_mad_2	Свої нігті гризти погано, а от чужі...	true
character_trait_levels_colour_text_att_trait_ruler_personality_all_mad_3	Вклоніться переді мною, нікчемні люди Землі, або потерпіть від моєї молі, що роздирає тканину!	true
character_trait_levels_colour_text_att_trait_ruler_personality_all_mad_1	Не бреши мені Мої очі ВИПАДУТЬ, якщо я перестану дивитися вгору.	true
character_trait_levels_colour_text_att_trait_all_personality_all_easily_trapped_1	Цей чоловік не побачив би пастку, якби вона тримала великий знак прямо перед ним.	true
character_trait_levels_onscreen_name_att_trait_ioannina_marker_1	Йоаніна	true
character_trait_levels_onscreen_name_att_trait_ollam_ri_bounty_1	Дотик Оллама Рі (Верховного Короля)	true
character_trait_levels_colour_text_att_trait_general_personality_all_bereaved_3	Ця людина втратила все, що було їй дорого.	true
character_trait_levels_onscreen_name_bel_trait_mission_payload_illegitimate_children_1	Рогоносець	true
character_trait_levels_colour_text_att_trait_general_personality_all_bereaved_2	Його серце розбите. Невиправно так.	true
character_trait_levels_colour_text_att_trait_general_personality_all_bereaved_1	Скорбота панувала в серці цієї людини відтоді, як він втратив усе, що йому було дорого.	true
character_trait_levels_onscreen_name_att_trait_antonina_marker_1	Антоніна	true
character_trait_levels_onscreen_name_att_trait_all_physical_all_healthy_2	Сяє здоров'ям	true
character_trait_levels_onscreen_name_att_trait_all_physical_all_healthy_3	Як бик	true
character_trait_levels_onscreen_name_att_trait_all_physical_all_healthy_1	Здоровий	true
character_trait_levels_colour_text_att_trait_eos_queen_mavia_1	[UNSEEN]	true
character_trait_levels_colour_text_att_trait_general_personality_not_eastern_likes_easterners_1	Зграя прямого спілкування. Милі жінки. Ще краще фалуда…	true
character_trait_levels_colour_text_att_trait_general_status_roman_blood_feud_1	Акти помсти належать римлянам.	true
character_trait_levels_onscreen_name_att_trait_all_personality_all_innate_irresolute_1	Нерішучий	true
character_trait_levels_onscreen_name_att_trait_general_military_navy_all_escort_good_1	Ефективний в морському ескорті	true
character_trait_levels_onscreen_name_att_trait_general_military_navy_all_escort_good_2	Фахівець із супроводу	true
character_trait_levels_onscreen_name_att_trait_general_military_navy_all_escort_good_3	Майстер із супроводу	true
character_trait_levels_onscreen_name_att_trait_all_personality_all_lazy_2	Ледачий	true
character_trait_levels_onscreen_name_att_trait_general_ability_all_fast_3	Швидкий наступ III	true
character_trait_levels_onscreen_name_att_trait_all_personality_all_lazy_3	Лінивий	true
character_trait_levels_onscreen_name_att_trait_general_ability_all_fast_2	Швидкий наступ II	true
character_trait_levels_onscreen_name_att_trait_general_ability_all_fast_1	Швидкий наступ I	true
character_trait_levels_onscreen_name_att_trait_general_ability_all_fear_5	Страх V	true
character_trait_levels_onscreen_name_att_trait_all_personality_all_lazy_1	Маруда	true
character_trait_levels_onscreen_name_att_trait_general_ability_all_fear_4	Страх IV	true
character_trait_levels_onscreen_name_att_trait_all_personality_all_lewd_2	Мерзотний	true
character_trait_levels_onscreen_name_att_trait_general_ability_all_fear_3	Страх III	true
character_trait_levels_onscreen_name_att_trait_all_personality_all_lewd_3	Розпусний поза розумом	true
character_trait_levels_onscreen_name_att_trait_general_ability_all_fear_2	Страх II	true
character_trait_levels_onscreen_name_att_trait_general_ability_all_fast_5	Швидкий наступ V	true
character_trait_levels_onscreen_name_att_trait_general_ability_all_fear_1	Страх I	true
character_trait_levels_onscreen_name_att_trait_all_personality_all_lewd_1	Огидний	true
character_trait_levels_onscreen_name_att_trait_general_ability_all_fast_4	Швидкий наступ IV	true
character_trait_levels_onscreen_name_att_trait_general_personality_all_innate_stupid_1	Дурник	true
character_trait_levels_colour_text_att_trait_general_government_all_warmonger_3	Саме їх існування є загрозою для нас. Треба змести їх усіх зі світу!	true
character_trait_levels_colour_text_att_trait_general_government_all_warmonger_2	Я думаю, ти зрозумієш, юначе, що війна насправді корисна майже для всього!	true
character_trait_levels_colour_text_att_trait_general_government_all_warmonger_1	Ми приймемо бій з ними. До самих своїх воріт.	true
character_trait_levels_onscreen_name_att_trait_all_personality_all_innate_charismatic_1	Харизматичний	true
character_trait_levels_onscreen_name_att_trait_general_physical_all_innate_ugly_1	Неотесаний	true
character_trait_levels_onscreen_name_att_trait_general_personality_civilised_adulterer_3	Ховайся за свою дружину!	true
character_trait_levels_onscreen_name_att_trait_general_personality_civilised_adulterer_2	Джиґун	true
character_trait_levels_onscreen_name_att_trait_general_personality_civilised_adulterer_1	Залицяльник	true
character_trait_levels_colour_text_att_trait_general_personality_not_eastern_hates_easterners_1	Єдиний гарний східняк - це дуже мертвий східняк.	true
character_trait_levels_onscreen_name_att_trait_general_government_all_farmer_1	Фермер	true
character_trait_levels_onscreen_name_att_trait_general_government_all_farmer_2	Власник маєтку	true
character_trait_levels_onscreen_name_att_trait_general_government_all_farmer_3	Земельний магнат	true
character_trait_levels_colour_text_att_trait_agent_status_roman_wealthy_1	А що, якщо я добре пов'язаний кров'ю і шлюбом?	true
character_trait_levels_onscreen_name_att_trait_agent_physical_all_innate_clumsy_1	Незграбний	true
character_trait_levels_onscreen_name_att_trait_champion_actions_all_guerrilla_activity_1	Повстанець	true
character_trait_levels_onscreen_name_att_trait_champion_actions_all_guerrilla_activity_3	Жах у темряві	true
character_trait_levels_onscreen_name_att_trait_champion_actions_all_guerrilla_activity_2	Партизан	true
character_trait_levels_onscreen_name_att_trait_priest_rank_manichaean_leader_1	Лідер	true
character_trait_levels_colour_text_att_trait_general_government_civilised_politician_1	Ця людина любить займатися політикою, і це робить його добре в цьому.	true
character_trait_levels_colour_text_att_trait_general_government_civilised_politician_3	Переконання та щирість — потужна зброя.	true
character_trait_levels_colour_text_att_trait_general_government_civilised_politician_2	Влада приходить до цієї людини природно, і він із задоволенням нею користується.	true
character_trait_levels_onscreen_name_att_trait_priest_rank_arian_bishop_1	Єпископ	true
character_trait_levels_colour_text_att_trait_general_personality_all_gambling_1	Тоді невелика ставка, щоб було цікаво...	true
character_trait_levels_colour_text_att_trait_general_personality_all_gambling_2	Десь виграєш, десь програєш — для цієї людини все одно.	true
character_trait_levels_colour_text_att_trait_general_personality_all_gambling_3	Моя доля скоро зміниться. Повинна!	true
character_trait_levels_onscreen_name_att_trait_general_military_all_disciplinarian_bad_1	Млявий	true
character_trait_levels_onscreen_name_att_trait_general_military_all_disciplinarian_bad_3	Вбивати з добротою	true
character_trait_levels_onscreen_name_att_trait_general_military_all_disciplinarian_bad_2	М'якотілий	true
character_trait_levels_onscreen_name_att_trait_agent_status_roman_poor_1	Нова людина	true
character_trait_levels_onscreen_name_att_trait_general_military_army_all_siege_defender_good_1	Вартовий воріт	true
character_trait_levels_onscreen_name_att_trait_general_military_army_all_siege_defender_good_3	Жоден не пройде!	true
character_trait_levels_onscreen_name_att_trait_general_military_army_all_siege_defender_good_2	Як стовп	true
character_trait_levels_colour_text_att_trait_general_military_all_disciplinarian_good_3	Я сказав: «Стрибай!» Ви жалюгідні маленькі невдячні!	true
character_trait_levels_colour_text_att_trait_general_military_all_disciplinarian_good_2	Зробити вбиральні до заходу сонця, якщо не хочеш копати в темряві?	true
character_trait_levels_colour_text_att_trait_general_military_all_disciplinarian_good_1	Я чув, як кажуть, що єдине, чого варто боятися, це сам страх, що, звичайно, невірно!	true
character_trait_levels_colour_text_att_trait_agent_physical_all_innate_inbred_1	Деяким людям не вистачає звичної кількості бабусь і дідусів.	true
