key	text	tooltip
#Loc;1;text/db/dilemmas.loc		
dilemmas_localised_title_att_subject_religious_zoroastrian_illegal_practice_1	Заборонені обряди	true
dilemmas_localised_title_att_subject_politics_nomad_hostage	Заручник	true
dilemmas_localised_title_att_subject_politics_roman_hostage	Обдарований	true
dilemmas_localised_title_att_subject_domestic_nordic_the_flyting_1	Флайтін - дебати	true
dilemmas_localised_description_att_dilemma_military_none_war_child_1	Проходячи крізь уламки завойованого поселення, один із Ваших полководців чує плач. Це дитина, залишена в руїнах!	true
dilemmas_localised_title_att_subject_religious_none_the_true_cross_1	Істинний Хрест	true
dilemmas_localised_title_att_subject_religious_orthodox_illegal_practice_1	Заборонені обряди	true
dilemmas_localised_title_att_subject_religious_hun_lightning	Блискавка не б'є двічі	true
dilemmas_localised_title_att_eos_religious_event_rebellion_att_fact_himyar_att_rel_judaism	Рабин – відлучення	true
dilemmas_localised_description_cha_dilemma_viking_1_cha_fact_northumbria	Втомлений від Ваших нескінченних набігів, король Нортумбрії шукає нову угоду з вами, за якою Ваші атаки припиняться в обмін на плату. Він пропонує Вам власну ділянку землі у своєму королівстві або золото, якщо Ви приймете пропозицію. Прийняття цієї угоди означатиме мир між Вашими двома народами, але, звичайно, Ви можете прийняти це і зрадити його пізніше! Можливо, він має намір зробити те саме? Однак, якщо Ви цього забажаєте, Ви можете відмовити англійському народу в милосерді, продовжити свою лють і вселити страх у серця його людей. Вибір за вами!	true
dilemmas_localised_description_ollam_ri_picti	Століття гноблення та невизначеності придушили дух кельтського народу, але їхнє славне минуле, збережене в легендах, дає останній проблиск надії поколінню, яке шукає нового початку. Молодий Рі (король) відправляється в стародавнє серце острова, сповнений рішучості відкрити майбутнє для свого народу. Він знайде знання про це, або викує його сам!	true
dilemmas_localised_title_att_bel_request_justinian_photius_1	Прохання Юстиніана: Фотій	true
dilemmas_localised_description_att_subject_religious_none_the_relic_seller_1	Столичний торговець мощами нещодавно тринадцять разів продав гілку, яка топила святого Савву! Він пропонує Вам золото, якщо Ви подивитеся в інший бік.	true
dilemmas_localised_description_slav_dilemma_anteans_1	Хилібідій, як і обіцяв, був приведений до Вас і змушений підтвердити свою позицію – він стверджує, що є римським полководцем досить відомим. Якщо це правда, ми напевно чули б про нього раніше? І все-таки він пропонує заслужити довіру Імперії від нашого імені, якщо ми дозволимо йому повернутися. Сумнівів і тіней багато, але вибір залишається за вами...	true
dilemmas_localised_description_slav_dilemma_anteans_2	Жахлива новина, Господи! Хилібідій, полководець-раб, якого ми нещодавно відправили назад до Риму, виявився лише брехуном! Інший раб у таборі засвідчив під страхом смерті, що цей «Хілібідій» — не що інше, як шахрай. Він на шляху до імперської території, і це буде нелегко, але ми все одно можемо перехопити його, перш ніж він досягне їх.	true
dilemmas_localised_description_att_dilemma_religious_christian_the_manichean_heresy_1	Було скликано Синод, який вирішив, що дуалістичні вірування маніхейців заражали життя інших добрих християн. Папа надіслав листа, в якому говориться, що єретиків-маніхеїв треба вигнати з наших земель.	true
dilemmas_localised_description_att_subject_religious_arian_illegal_practice_1	Цей чоловік проповідував свої аріянські переконання на базарі, порушуючи нав’язані нами закони.	true
dilemmas_localised_description_att_subject_politics_barb_nomad_tribal_loyalty	Плем'я розколюється - дві групи в племені були спіймані, коли доводили одні одним, хто найбільш кровожерливий!	true
dilemmas_localised_title_att_subject_domestic_civil_master_agitator	Сільськогосподарський агітатор	true
dilemmas_localised_title_att_subject_religious_barb_bloodless	Безкровний баран	true
dilemmas_localised_title_att_bel_request_antoninia_rumours_1	Прохання Антоніни: чутки	true
dilemmas_localised_title_cha_dilemma_mercia_1	Залучення талантів	true
dilemmas_localised_title_att_political_action_dilemma_assassinate_wound_suspicious	Підозріла травма	true
dilemmas_localised_description_att_subject_military_nomad_master_swordsmith	Наші наїзники схопили вмілого майстра. Він стверджує, що здатний виготовляти мечі зі смертоносними вигнутими лезами сходу. Що нам з ним робити?	true
dilemmas_localised_description_ybor_level_A_alamanni	У твоїх чудових дворах молодий воїн, Ібор, неспокійно росте. Його серце прагне до дикої природи, сповненої великих випробувань, які заслужили репутацію людини, і він просить Вашого дозволу піти. Хоча його від’їзд завдає Вам болю, Ви знаєте, що він повернеться ще сильнішим, сформованим вибором, який він зробив під час своїх поневірянь. Який подарунок на прощання Ви робите?	true
dilemmas_localised_description_att_subject_religious_manichaeism_pilgrims_1	У Месопотамії, на батьківщині Мані, щороку відбувається велике зібрання, яке вони називають «Свято Бема». Це наші землі, чи варто допускати таке далі?	true
dilemmas_localised_title_att_subject_politics_civil_hostage	Улюбленець	true
dilemmas_localised_title_att_subject_religious_zoroastrian_pilgrims_1	Прочани	true
dilemmas_localised_description_att_subject_religious_hun_lightning	Перед Вами постає чоловік, який все ще димить, він стверджує, що в нього влучила блискавка. Напевно, це ознака того, що Тенгрі прихильно ставиться до нього?	true
dilemmas_localised_title_att_subject_domestic_all_stone_mason	Каменяр	true
dilemmas_localised_title_slav_dilemma_sclaveneans_1	Гуни стають здобиччю	true
dilemmas_localised_description_att_bel_request_justinian_photius_1	Аве, Велізарію! Так часто буває, що людина, яка найбільше відзначилася в битві, виявляє, що програє ту саму боротьбу у себе вдома. Можна подумати про царя Ахава, могутнього у війнах і політиці, настільки підвладного своїй злій дружині Єзавелі, що Бог знищив його та принизив його царство.\\n\\nТож Ви бачите справу, яка здається приватною та поза компетенцією. Справа суверена насправді тісно пов’язана з долею Імперії. Велізарію, ти знаєш, що твоя важливість неперевершена. Тому цілком правильно, що до Вас придивляються більше за усіх інших. Ваша дружина Антоніна вже деякий час скандалить у столиці. Деякі з моїх найцінніших агентів були підірвані її поведінкою, і я чув, що її остання схема спрямована проти її власного сина! Я більше цього терпіти не буду.\\n\\nМені боляче надсилати такий ультиматум людині, яка мені так добре служила, але я впевнений, що цей вчинок принесе Вам користь понад усе. Ти повинен уникати порад своєї дружини. Ось і все.	true
dilemmas_localised_title_att_subject_military_roman_master_hostile_governor	Неприязний губернатор	true
dilemmas_localised_description_att_subject_domestic_none_foreign_migrants_1	Через сусідні війни в наші міста приїжджає багато мігрантів і біженців. Вони приносять на наші землі гроші, а також свою підозрілу релігію та культуру. Деякі з Ваших міністрів просили, щоб їх усунули.	true
dilemmas_localised_description_cha_dilemma_viking_1_cha_fact_mercia	Втомившись від Ваших нескінченних набігів, королю Мерсії в Англії було досить, і він тепер шукає домовленості, за допомогою якої ці напади нарешті покладуть кінець. Він пропонує ділянку землі у своєму власному королівстві або золото, якщо Ви погодитесь. Прийняття цієї угоди означатиме мир між Вашими двома народами, але, звичайно, Ви можете прийняти це і зрадити його пізніше! Можливо, він має намір зробити те саме? Однак, якщо Ви цього забажаєте, Ви можете позбавити англійського народу милосердя, продовжити кидати свою лють і вселити страх у серця його людей. Вибір за вами!	true
dilemmas_localised_description_att_subject_religious_none_the_true_cross_1	У мене для Вас дуже особлива пропозиція. Пропозиція один раз у житті за частинку Істинного Хреста, взятого з Голгофи самим святим Петром.	true
dilemmas_localised_title_att_subject_domestic_barb_nomad_stolen_sword	Викрадений меч	true
dilemmas_localised_title_att_subject_domestic_eastern_the_chovgan_tourney_1	Змагання з човгану	true
dilemmas_localised_title_att_subject_religious_christian_the_black_sheep_1	Чорна вівця - біла ворона	true
dilemmas_localised_description_political_event_assassination	Зрада! Ходять чутки, що цей чоловік планує вбити члена Вашої родини! Доказів мало, але якщо Ви не діятимете, наслідки можуть бути жахливими.	true
dilemmas_localised_title_att_subject_politics_barb_nomad_challenger	Претендент	true
dilemmas_localised_title_att_eos_marib_dam_repair_2	Побічна шкода	true
dilemmas_localised_title_att_eos_marib_dam_repair_3	Побічна шкода	true
dilemmas_localised_title_att_eos_marib_dam_repair_0	Побічна шкода	true
dilemmas_localised_title_att_eos_marib_dam_repair_1	Побічна шкода	true
dilemmas_localised_title_att_subject_domestic_civil_hostile_dispute	Недружня суперечка	true
dilemmas_localised_description_att_subject_religious_arian_pilgrims_1	Аріяни перетинають нашу територію, щоб дістатися до святині.	true
dilemmas_localised_title_att_subject_diplomatic_none_border_dispute_1	Прикордонна суперечка	true
dilemmas_localised_title_att_subject_domestic_none_excess_materials_1	Надлишок матеріалів	true
dilemmas_localised_title_att_eos_sassanid_insult_1	Необережна розмова	true
dilemmas_localised_title_att_eos_sassanid_insult_3	Необережна розмова	true
dilemmas_localised_title_att_eos_sassanid_insult_2	Необережна розмова	true
dilemmas_localised_description_att_bel_request_theodosia_ioannina_1	Мої найщиріші вітання, Велізарію, з новиною про майбутнє заміжжя Вашої доньки! Анастасій — мій улюблений племінник, і я знаю, що він дуже порадує милу Йоаніну. Приємно бачити сім’ї, які досі були так тісно пов’язані узами дружби, патріотизму та вірності, нарешті пов’язані узами священного шлюбу.\\n\\nБезсумнівно, Ваша дружина пояснила незвичайний характер їхніх стосунків у присутність і моя роль у сприянні цьому. Це справді не ідеально, щоб вони жили разом у тілесному союзі до самої церемонії, але це здавалося неминучим, враховуючи любов пари та часті відкладення, на яких наполягала Ваша дружина. Я знаю, що вона розлючена через втрачену «чесноту» своєї доньки, але, на мій погляд, час завершення є вторинним щодо чистого наміру вийти заміж, і, безперечно, Бог, який бачить усі мотиви, побачить це понад усе. Можливо, вона забуває, Велізарію, що її власна чеснота навряд чи була недоторканою, коли Ви обоє вступили у свій благословенний союз. Утримайте її від необдуманих дій, благословіть цей союз, і цю неприємну ситуацію можна обернути тільки на користь.	true
dilemmas_localised_description_att_subject_military_none_war_child_1	Дитина, знайдена серед уламків міста, почала розпитувати про свою спадщину.	true
dilemmas_localised_description_att_bel_request_antoninia_rumours_1	Чоловік, який там вчора був галас! Однак я впевнена, що Вам просто потрібен був час, щоб заспокоїтися, перш ніж Ви могли чітко побачити правду. Я не хочу твоїх вибачень, але ти почуватимешся дуже дурним, коли почуєш, що насправді сталося.\\n\\nМи з Тео закопували скарб у підвалі! Ви так старанно працювали в Карфагені, завойовуючи всю цю здобич, і тепер Юстиніан просто очікує, що Ви її передасте, коли він лише сидів на своєму троні з пишним виглядом. Я приховала кілька приємних шматочків від збирачів, щоб Ви могли зберегти винагороду, на яку справді заслуговуєте. Лише потім ми зрозуміли, наскільки це все виглядало компрометуюче! Як нерозумно! У будь-якому разі, коли ти заспокоїшся, я надішлю тобі гроші, і ми зможемо забути про це.	true
dilemmas_localised_description_att_subject_religious_manichaeism_illegal_practice_1	Цей чоловік був схоплений за порушення санкцій, які ми наклали на маніхейську релігію.	true
dilemmas_localised_description_att_subject_domestic_barb_nomad_enemy_trade	Буває, що жага людини до вина засліплює її розум. Один із таких видатних племен був спійманий на експлуатації місцевих іммігрантів, щоб заплатити за напій, якого він так жадає.	true
dilemmas_localised_description_ollam_ri_B2	Голови братів лежать у пилу біля ніг Рі-корля. Вражені Вашим швидким судженням люди подають Вам нову справу. Чоловік, Брес, є королем репресивного племені, підкупленого під час недавнього конфлікту. В обмін на своє життя він пропонує Вам секрети родючості гарантуючи Вам рясні врожаї та корів, які ніколи не висихають.	true
dilemmas_localised_description_ollam_ri_B1	Як і було обіцяно, троє синів Туїреанна повертаються з закривавленою свинячою шкурою. Проте вони заплатили дорогу ціну – усі троє несуть смертельні рани. Вони стверджують, що шкіра має потужну лікувальну силу, і благають Рі перев'язати нею їхні рани. Натомість вони обіцяють дати відповідь на будь-яке питання під сонцем.	true
dilemmas_localised_description_att_subject_domestic_none_workers_on_strike_1	Вимагаємо кращих умов праці. Ми не раби.	true
dilemmas_localised_title_att_bel_request_justinian_narses_1	Прохання Юстиніана: Нарсес	true
dilemmas_localised_title_att_subject_religious_none_the_holy_site_1	Святе місце	true
dilemmas_localised_description_att_subject_domestic_all_stone_mason	Вам представився іноземець, який претендує на те, щоб бути великим каменярем. Бажаєте взяти його до себе на службу?	true
dilemmas_localised_description_ollam_ri_A2	Горн був правильний! Старий передає блискучого лосося, але перш ніж Рі встигає вкусити, він вражений виглядом чоловіка, який сидів на гілках дерева. Він стверджує, що він Божевільний Шуйбне, король, проклятий жити напівпташиним життям і змушений стрибати з дерева на дерево при найменшому шумі.	true
dilemmas_localised_description_ollam_ri_A3	Смакуючи вкраденим лососем, Рі блукає далі берегом. Там він бачить таємничу молоду жінку, яка пасе своїх коней. Рі в двох розумах. З одного боку, вона може бути келпі, яка доглядає за своїм злим потомством. З іншого боку, вона може бути доброзичливою молодою селянкою.	true
dilemmas_localised_description_ollam_ri_A1	Старий твердо хитає головою – друїд не був відповіддю. Засмучений Рі продовжує свою дорогу, але відразу його відволікає вид великого чорного кота з плямою на грудях. Воно з певною зухвалістю бреде до Рі, вимагаючи його уваги. Що він робить?	true
dilemmas_localised_description_att_subject_religious_zoroastrian_pilgrims_1	Стародавній храм, у якому живе Аташ Адаран, знаходиться в межах наших кордонів, на вершині гори Кхадже. Деякий час туди мандрували зороастрійці. Ваш міністр просить заборонити їм вхід.	true
dilemmas_localised_description_att_dilemma_religious_christian_council_of_carthage_1	418 р. н.е., Карфаген. Священники з усього християнського світу знову зустрілися в Карфагені. Аскет Пелагій проповідує, що від Бога не вимагається очищати нас від гріха і що першорідного гріха ніколи не було. Багато хто стверджує, що це єресь і що Пелагія та його послідовників слід вигнати.	true
dilemmas_localised_description_att_subject_domestic_barb_nomad_stolen_sword	Мечі — це предмет гордості, але такі дорогоцінні речі також можуть викликати невдоволення… Син Вашого брата стверджує, що інший викрав його меч. Обвинувачений це заперечує.	true
dilemmas_localised_title_att_subject_domestic_none_foreign_migrants_1	Іноземні мігранти	true
dilemmas_localised_title_cha_dilemma_viking_1_cha_fact_mercia	Невгамовні воїни	true
dilemmas_localised_title_att_subject_politics_civil_secret_meetings	Таємні зустрічі	true
dilemmas_localised_title_att_subject_religious_catholic_pilgrims_1	Прочани	true
dilemmas_localised_description_cha_dilemma_cordoba_1	Аббасидський халіфат, який контролює велику частину земель від Африки до Леванту, загрожує Вашим берегам. Вони збирають своїх людей для демонстрації сили на берегах північної Африки, погрожуючи перетнути протоки та вторгнутися у Ваші землі. Вони кажуть, що якби Ви заплатили їм данину, вони б прибрали свої мечі. Можливо, маючи в руках Ваші гроші, вони зможуть зібрати сили, щоб справді перемогти Вас і завоювати Ваші землі? Яким би не було Ваше рішення, жителі Піренейського півострова, затамувавши подих, чекають результатів переговорів між вами.	true
dilemmas_localised_title_cha_dilemma_charlemagne_daughter_1	Не першорідний гріх	true
dilemmas_localised_description_att_dilemma_domestic_roman_saint_telemachus_1	Під час ігор у Колізеї в Римі на арену зійшов чоловік на ім’я Телемах. Підійшовши до бійців, він благав їх зупинитися, але був збитий і вбитий. Через цей злочин християнська громада вимагала заборонити ігри.	true
dilemmas_localised_description_att_subject_domestic_none_hidden_treasure_1	Ми знайшли великий скарб золота, захований у печері під час видобутку. Що нам з цим робити?	true
dilemmas_localised_description_att_subject_domestic_none_excess_materials_1	Господи, завдяки успіху недавнього будівельного проекту залишилося багато матеріалів. Що нам з ними робити?	true
dilemmas_localised_title_att_subject_religious_manichaeism_illegal_practice_1	Заборонені обряди	true
dilemmas_localised_description_att_subject_domestic_civil_idiot_magistrate	Один із Ваших суддів прийшов сказати Вам, що він втратив свою посаду. Що ти хочеш зробити?	true
dilemmas_localised_title_att_bel_request_theodosia_ioannina_1	Прохання Феодори: Йоаніна	true
dilemmas_localised_title_att_subject_religious_germanic_pilgrims_1	Прочани	true
dilemmas_localised_title_att_subject_religious_hellenic_pilgrims_1	Прочани	true
dilemmas_localised_description_political_event_marriage_male	Один із Ваших підданих нещодавно закохався і бажає одружитися на своїй нареченій. Чи можна дозволити їхньому союзу продовжуватись?	true
dilemmas_localised_description_att_subject_diplomatic_none_border_dispute_1	Уздовж кордонів нашої країни селянин сусідньої держави претендує на землю, що належить одному з наших, як на свою.	true
dilemmas_localised_title_ollam_ri_B	Цикл про Оллам Рі (Верховного Короля)	true
dilemmas_localised_title_ollam_ri_A	Цикл про Оллам Рі (Верховного Короля)	true
dilemmas_localised_description_att_subject_military_none_the_gift_of_speed_1	Місцевий дворянин, шукаючи прихильності, дає нам чудових лошат, щоб ми могли робити з ними, як хочемо.	true
dilemmas_localised_title_ollam_ri_B1	Цикл про Оллам Рі (Верховного Короля)	true
dilemmas_localised_title_ollam_ri_B2	Цикл про Оллам Рі (Верховного Короля)	true
dilemmas_localised_description_cha_dilemma_mercia_2_2	Алкуїн, як і слід було очікувати, розгніваний Вашим рішенням затримати його та фактично згорнути його академічну кар’єру. Ви очікували цього, але не його рішення піти, незважаючи на Ваше рішення про протилежне. Наближається ще одне роздоріжжя, мілорде, і разом з ним приходить інше рішення.	true
dilemmas_localised_title_att_subject_domestic_barb_nomad_enemy_trade	Торгівля з ворогом	true
dilemmas_localised_description_att_subject_domestic_none_withholding_taxes_1	Мій пане, як один із Ваших збирачів податків, я мушу повідомити, що деякі громадяни утримувалися від сплати Ваших справедливих податків.	true
dilemmas_localised_title_att_political_action_dilemma_diminish_popularity_followup_merciful	Милосердя	true
dilemmas_localised_description_att_subject_diplomatic_none_turncoat_1	Прибув втікач, який стверджує, що він агент суперницької держави. Він попросив притулку, але його колишні роботодавці вимагають його повернення. Він запропонував нам цінні державні таємниці, якщо ми захистимо його…	true
dilemmas_localised_description_att_subject_religious_zoroastrian_illegal_practice_1	Ми спіймали цю людину, яка вклонялася вічному вогню у себе вдома. Це суперечить законам країни.	true
dilemmas_localised_title_ollam_ri_A1	Цикл про Оллам Рі (Верховного Короля)	true
dilemmas_localised_title_ollam_ri_A2	Цикл про Оллам Рі (Верховного Короля)	true
dilemmas_localised_title_ollam_ri_A3	Цикл про Оллам Рі (Верховного Короля)	true
dilemmas_localised_title_att_subject_religious_catholic_illegal_practice_1	Заборонені обряди	true
dilemmas_localised_title_att_political_action_dilemma_diminish_popularity_reversal	Зворот	true
dilemmas_localised_title_att_subject_domestic_civil_idiot_magistrate	Азартний гравець	true
dilemmas_localised_description_att_subject_religious_barb_bloodless	Баран, повішений у священній жертві богам, абсолютно безкровний! З істоти не можна вичавити жодної краплі. Ми повинні щось зробити, щоб задобрити богів.	true
dilemmas_localised_title_att_subject_religious_manichaeism_pilgrims_1	Прочани	true
dilemmas_localised_title_att_subject_military_nomad_master_swordsmith	Зброяр	true
dilemmas_localised_description_cha_dilemma_mercia_1	Мій пане! Ваша людина, Алкуїн з Йорка, стикається з кризою вірності. До нього звернувся король франків Карл Великий і запросив зайняти місце при його дворі. Алкуїн, як Ви напевно знаєте, є одним із найкращих розумів у царстві та великим благом для Вашого двору. Але можливість в Аахені дуже подобається Алкуїну, який відчуває, що не може відмовитися від можливості працювати з найбільшими мізками у відомому світі. Він просить Вас дозволити йому негайно виїхати до Франції.	true
dilemmas_localised_title_att_subject_domestic_none_hidden_treasure_1	Прихований скарб	true
dilemmas_localised_title_att_subject_religious_hellenic_illegal_practice_1	Заборонені обряди	true
dilemmas_localised_title_att_subject_religious_germanic_illegal_practice_1	Заборонені обряди	true
dilemmas_localised_description_ybor_level_A_burgundi	У твоїх чудових дворах молодий воїн, Ібор, неспокійно росте. Його серце прагне до дикої природи, сповненої великих випробувань, які заслужили репутацію людини, і він просить Вашого дозволу піти. Хоча його від’їзд завдає Вам болю, Ви знаєте, що він повернеться ще сильнішим, сформованим вибором, який він зробив під час своїх поневірянь. Який подарунок ти робиш на прощання?	true
dilemmas_localised_title_political_event_blackmail	Наклеп	true
dilemmas_localised_title_att_subject_religious_christian_the_money_lender_1	Позичальник	true
dilemmas_localised_description_att_subject_politics_civil_challenger	І політики, і публіка закохані в чудового молодого оратора, він явно амбітний і завойовує прихильність натовпу. Хоча він ще не зневажав Вас, але він не підтримує Ваші починання.	true
dilemmas_localised_title_att_subject_military_barb_master_hostile_governor	Неприязний губернатор	true
dilemmas_localised_description_att_subject_domestic_none_the_silk_trader_1	Прибув іноземний торговець із пачками шовку. Кажуть, що він знає про таємний торговий шлях, по якому проходить багато цінних товарів. Його товари заповнюють ринок, знижуючи ціни та прибутки.	true
dilemmas_localised_title_political_event_ministerial_position	Політична вигода	true
dilemmas_localised_description_att_subject_religious_barb_stranger	Поміж нас з’явився незнайомець у капюшоні й плащі. Він стверджує, що знає місце розташування давно втраченого священного місця, яке він покаже Вам за певну ціну.	true
dilemmas_localised_title_att_dilemma_religious_catholic_religious_sanctions_1	Релігійні санкції	true
dilemmas_localised_description_att_dilemma_religious_christian_council_of_ephesus_1	431 р. н.е., Ефес. Єпископи з усього християнського світу зібралися в Ефесі, щоб підтвердити Нікейський символ віри. Однак Несторій, архієпископ Константинопольський, був засуджений своїми колегами за те, що він заперечував те, що Марія була матір’ю Бога, натомість стверджуючи, що вона була лише матір’ю Ісуса. Це суперечить Нікейському віровченню, оскільки відділяє Ісуса від Бога. У результаті Кирило Александрійський вимагає від Папи оголосити несторіанство єретичною точкою зору.	true
dilemmas_localised_title_att_dilemma_religious_hellenic_religious_sanctions_1	Релігійні санкції	true
dilemmas_localised_title_att_eos_religious_event_rebellion_att_fact_axum_att_rel_church_east	Єпископ – відлучення	true
dilemmas_localised_description_att_bel_request_antoninia_thedosius_1	Мій чоловік, я чула, що ти проводив жахливу кампанію проти цих вандалів, тому я вирішила підняти тобі настрій. У всякому разі, я згадала, як ти любиш благодійність, і зробила тобі особливий сюрприз: нового сина! Пам'ятаєш свого бідного хрещеника-сироту Феодосія? Ну, він так дбав про мене, що просто повинен приєднатися до сім’ї. Він настільки чарівний і красивий, що люди практично стоять у черзі, щоб усиновити його. Скажіть, будь ласка, Ви дозволите мені його утримати?\\n\\nО, до речі, я проводила час, розважаючи деяких яскравих молодих розумів Константинополя (всі вони вживають такі чарівно довгі слова – Ви коли-небудь чули) «inveigle»?), і один із них має спосіб підтримувати воду свіжою, що стане абсолютним порятунком у Вашій кампанії в запорошеній старій Африці. Якщо Ви зробите мені послугу, про яку я просила, я буду рада швидко роздобути для Вас його секрети…	true
dilemmas_localised_title_att_political_action_dilemma_seek_office_obstruction	Політична перешкода	true
dilemmas_localised_description_att_subject_religious_christian_candidate_for_bishop	Несу звістку від Святої Церкви. Чоловік, визнаний своїм благочестям та відданістю, має бути висвячений на єпископа. Ви згодні?	true
dilemmas_localised_title_ollam_ri_votadini	Цикл про Оллам Рі (Верховного Короля)	true
dilemmas_localised_description_att_subject_politics_rome_corruption	Коли натовп говорить, керівництво має слухати. Люди закликають до чистоти своїх політиків: кінець підкладці їхніх кишень ціною слави Риму.	true
dilemmas_localised_description_att_subject_domestic_roman_the_chariot_races_1	Знову гонки. Знову змагаються домінуючі зелені та сині, але присутні й візники червоно-білих команд. Якщо його високість захоче зробити дружню ставку, я впевнений, що ми могли б потроїти його інвестиції…	true
dilemmas_localised_title_att_dilemma_religious_orthodox_religious_sanctions_1	Релігійні санкції	true
dilemmas_localised_title_att_subject_religious_zoroastrian_brazier	Пекучі переконання	true
dilemmas_localised_title_att_dilemma_religious_arian_religious_sanctions_1	Релігійні санкції	true
dilemmas_localised_title_att_political_action_dilemma_embezzlement_suspicious	Виникли підозри	true
dilemmas_localised_description_att_political_action_dilemma_secure_loyalty_mutilation	У цьому випадку забезпечити вірність виявляється досить складно. На жаль, і хоч це неприємно, але можуть знадобитися більш радикальні заходи...	true
dilemmas_localised_title_att_subject_domestic_none_the_silk_trader_1	Торговець шовком	true
dilemmas_localised_description_ollam_ri_A1ii	Три дні кіт і Рі-король стояли, заплющивши очі й не кліпаючи. Невеликий натовп зібрався, щоб подивитися на битву волі, і їхні крики наповнюють його вуха. Дехто наполягає, що це Кат Ші, і закликає його тікати, а інші підганяє його словами підбадьорення.	true
dilemmas_localised_description_att_eos_religious_event_rebellion_att_fact_axum_att_rel_church_east	Ми довго терпіли Вашу прихильність до цієї чужої та нечестивої релігії. На початку свого правління Ви запевняли нас, що нам дозволять процвітати без загрози Вашим переконанням, але тепер нам ясно, що це були порожні слова і що Ваша справжня мета — викорінення нашої віри та всіх, хто в неї вірить . Нам надто пізно намагатися повернути хвилю назад, але ми вимагаємо засобів, щоб захистити себе. Дай нам золотий дар, щоб ми жили по совісті і не боялися труднощів. Я смиренно звертаюся з цим проханням, але знайте: мої послідовники — люди у відчаї, і я боюся, що якщо їм відмовити, проллється кров. Вибирайте мудріше, ніж робили досі, мілорде.	true
dilemmas_localised_title_att_subject_religious_barb_stranger	Чужинець	true
dilemmas_localised_description_att_subject_domestic_roman_a_little_flutter_2	Наступного місяця цей ветеран проведе багато боїв на арені. Його протистоять набагато молодшому бійцеві. Хочете зробити ставку? 500 талантів має бути достатньо.	true
dilemmas_localised_description_att_subject_domestic_roman_a_little_flutter_1	Перспективний молодий гладіатор, який, як очікується, зробить собі ім'я, протистоїть жорсткому супернику. Бажаєте зробити ставку? 500 талантів має бути достатньо.	true
dilemmas_localised_title_att_dilemma_religious_germanic_religious_sanctions_1	Релігійні санкції	true
dilemmas_localised_description_att_political_action_dilemma_embezzlement_suspicious	Хоча розкрадання було успішним, люди помітили зниклі гроші, зокрема зниклі коштовності. Коли вони запитають, що Ви їм скажете?	true
dilemmas_localised_description_att_political_action_dilemma_assassinate_suspicious	Хоча вбивство було успішним, спосіб смерті був не таким непомітним, як Ви сподівалися. Люди ставлять складні питання, на які Вам доведеться відповісти.	true
dilemmas_localised_title_att_dilemma_religious_tengri_religious_sanctions_1	Релігійні санкції	true
dilemmas_localised_description_att_political_action_dilemma_adoption_added_incentive	Гроші, здається, є об’єктом бажання більше, ніж вірність Вам. Цей чоловік просить більше, щоб належним чином гарантувати плавний перехід. Невдача, звичайно, але є варіанти...	true
dilemmas_localised_description_cha_dilemma_saxon_1	Карл Великий чекає Вашої відповіді. Його настанова чітка – або приймеш християнство, або помреш. Рішення тільки за Вами, але результат буде далекосяжним.	true
dilemmas_localised_description_att_dilemma_religious_orthodox_religious_sanctions_1	Зараз грецькі християни становлять значний відсоток нашої громади. Який у них статус?	true
dilemmas_localised_title_att_subject_military_none_the_spy_1	Шпигун	true
dilemmas_localised_description_att_dilemma_domestic_none_plentiful_harvest_1	Урожай цього року був особливо рясним. Що нам робити з надлишком?	true
dilemmas_localised_title_cha_dilemma_lombard_pope_demands_1	Ломбардська обіцянка	true
dilemmas_localised_title_cha_dilemma_lombard_pope_demands_3	Ломбардська обіцянка	true
dilemmas_localised_title_cha_dilemma_lombard_pope_demands_2	Ломбардська обіцянка	true
dilemmas_localised_title_att_dilemma_religious_celtic_religious_sanctions_1	Релігійні санкції	true
dilemmas_localised_description_att_subject_diplomatic_none_tribute_1	Вітаю. Я приніс подарунок від свого народу, щоб ми могли покращити стосунки.	true
dilemmas_localised_description_ybor_level_B_2	З брошкою на грудях Ібор бачить світ із крижаною ясністю, дивуючись знайомому лісу, наче це був абсолютно новий пейзаж. Раптом на його шляху спалахує вогняний язик, викликаючи пекло, яке загороджує йому шлях. Кілька селян із сусіднього села злякано здригаються, незважаючи на загрозу їхнім посівам.	true
dilemmas_localised_description_ybor_level_C_2	Рятуючи життя жриці від бандитів, Ібор довів, що є проявом Годана, бога, який тримає життя і смерть на одній могутній долоні. Жриця вважає своїм священним обов'язком керувати Ібором і посилювати його руйнівні та цілющі сили містичними засобами. Однак, на відміну від Годана, Ібор повинен вибрати лише один шлях. Яка це буде?	true
dilemmas_localised_description_ybor_level_C_3	Ібор виходить із вогню неушкодженим, захищений своєю вірою в Годана. Селяни, свідки цього чудесного акту, поширюють історію далеко й широко, і незабаром його оточують прохачі, які вимагають його втручання. Чума впала на сусіднє село, і місцевий мудрий чоловік підтвердив, що лише Ібор може принести визволення.	true
dilemmas_localised_description_ybor_level_B_1	Меч на його стегні, Ібор крокує в пишні ліси з виглядом юнацької непереможності. Невдовзі його рух зупиняють крики людей і брязкіт сталі — бандити проривають собі шлях крізь натовп мандрівників. Крізь пил і кров він бачить відомого поета, який намагається захистити жрицю Годана. Кого він рятує?	true
dilemmas_localised_description_ybor_level_C_1	В обмін на своє життя поет дарує Ібору срібний язик, що дозволяє йому сплести мерехтливу мережу слів навколо найжорсткішого серця. Незабаром він очолює групу шукачів пригод, приваблених чутками про його доблесть. Але слава породжує заздрість - брати Амбрі та Ассі накидаються на нього на чолі незліченного війська, блискучого сталлю та злобою.	true
dilemmas_localised_description_ybor_level_C_4	Після того, як вогонь погашено, селяни благають Ібора повернутися з ними до двору їхнього короля. Вони розповідають зібраним історію про Вашу доблесть і командування. Король визнає шляхетність Ібора і пропонує йому посаду радника. Священник Годана, так само вражений, підлизується до нього за священство, пропонуючи надати божої сили словам, які він вимовляє.	true
dilemmas_localised_title_att_subject_religious_barb_stones	Кам'яні люди	true
dilemmas_localised_description_att_dilemma_religious_germanic_religious_sanctions_1	Багато язичників, послідовників германських богів, наповнюють наші землі. Чи заслуговують вони на рівні права?	true
dilemmas_localised_title_att_subject_domestic_roman_slave_murderer	Вбивця	true
dilemmas_localised_title_att_subject_domestic_nomadic_the_kassai_contest_1	Змагання Касаї	true
dilemmas_localised_title_att_subject_military_none_drunk_on_watch_1	П'яний на варті	true
dilemmas_localised_description_att_political_action_dilemma_secure_loyalty_bribery	Вірність приходить з багатьох місць. Від мозку, від серця і від гаманця. Ця людина вимагає більше грошей, щоб забезпечити свою відданість. що ти кажеш	true
dilemmas_localised_description_att_subject_nomadic_tribal_strife_1	У нашому суспільстві є люди з багатьох племен, і іноді старі образи випливають на поверхню. Дві з цих груп посварилися і перебувають у протистоянні одна з одною. Якщо цю справу не вирішити найближчим часом, це може призвести до розколу в ордах.	true
dilemmas_localised_description_att_political_action_dilemma_gather_support_opposition	Опозиційна партія зірвала Ваші спроби отримати необхідну підтримку. Ми можемо продовжувати, але Ви повинні вирішити, як.	true
dilemmas_localised_title_cha_dilemma_pope_attacked_1	Око за око	true
dilemmas_localised_title_att_political_action_dilemma_assassinate_suspicious	Підозріла смерть	true
dilemmas_localised_description_political_event_ministerial_position	Ця людина, жадібна влади, зайняла посаду без Вашого схвалення. Можливо, він підходить для цього завдання, але чи можете Ви дозволити собі дозволити його амбіціям загрожувати владі Вашої родини?	true
dilemmas_localised_description_att_subject_military_none_the_spy_1	Ми затримали старого, який шпигував за нашими військами. Він уже визнав свою провину, що з ним робити?	true
dilemmas_localised_title_cha_dilemma_saxon_1	Верденський вердикт	true
dilemmas_localised_title_cha_dilemma_verden	Верденський вердикт	true
dilemmas_localised_description_att_political_action_dilemma_seek_office_obstruction	Коли піднімаєшся до вершини крутими схилами, пам'ятай правило - "Або ти когось вполюєш, або тебе вполюють". Вашого кандидата заблокували Ваші опоненти. Що Ви будете робити?	true
dilemmas_localised_title_att_eos_religious_event_rebellion_att_fact_himyar_att_rel_semitic_paganism	Верховний проповідник Алмаки – відлучення	true
dilemmas_localised_title_att_subject_domestic_civil_married_slaves	Весілля рабів	true
dilemmas_localised_title_att_subject_politics_rome_corruption	Прислухаючись до натовпу	true
dilemmas_localised_title_att_subject_religious_christian_candidate_for_bishop	Кандидат на єпископа	true
dilemmas_localised_title_att_dilemma_religious_christian_council_of_ephesus_1	Ефеський собор	true
dilemmas_localised_title_att_subject_domestic_nomad_sword_of_attila	Меч влади	true
dilemmas_localised_title_att_political_action_dilemma_secure_loyalty_bribery	Змащення коліс	true
dilemmas_localised_title_att_subject_nomadic_tribal_strife_1	Племінні чвари	true
dilemmas_localised_description_cha_dilemma_pope_attacked_1	У серці Папської області ворушиться інтрига. Закривавлений і зневірений Папа Лев III прибув до Вашого двору, шукаючи Вашого захисту — як єдиного судді, якому вірить християнський світ. Рим завжди страждав від гірких розбіжностей між суперниками, тепер, здається, сім’я та союзники старого папи Адріана зробили виключення з Лео. Після того, як їхні звинувачення в подружній зраді та лжесвідченнях не були почуті, їхні агенти затримали його, коли він наважився вийти з міста, намагаючись вирвати йому очі та язик, щоб зробити його непридатним до посади. Тепер він приходить до Вас, сповнений надії через Ваші минулі дії, спрямовані на захист його святого служіння в минулі часи. Він натякає, що Ваша допомога в цьому питанні продемонструє Вашу гідність прийняти найбажаніший титул з усіх – титул імператора Священної Римської імперії. Однак його опоненти пропонують значну винагороду тому, хто поверне Лео, щоб постати перед судом у Ромі…	true
dilemmas_localised_description_att_dilemma_religious_catholic_religious_sanctions_1	Кількість латинських християн у наших провінціях дуже велика. Що з ними робити?	true
dilemmas_localised_title_att_subject_domestic_barb_temple_sacrilege	Святотатство в храмі	true
dilemmas_localised_title_att_subject_religious_christian_pontifex_maximus_1	Понтифік Великий	true
dilemmas_localised_description_att_dilemma_religious_hellenic_religious_sanctions_1	Багато язичників, послідовників старих римських богів, наповнюють наші землі. Чи заслуговують вони на рівні права?	true
dilemmas_localised_title_att_dilemma_religious_christian_conference_of_carthage_1	Карфагенський собор	true
dilemmas_localised_title_att_subject_politics_barb_nomad_secret_meetings	Таємні зустрічі	true
dilemmas_localised_description_political_event_adoption	Інша родина хоче прийняти одного з Ваших синів як свого! Чи можете Ви дозволити собі відпустити свого хлопчика?	true
dilemmas_localised_title_att_dilemma_religious_zoroastrian_religious_sanctions_1	Релігійні санкції	true
dilemmas_localised_description_att_eos_tanukhids_settle	Як і обіцяли, тепер, коли ми створили постійну базу, наші союзники запропонували надати свої землі та громадян у наше розпорядження. Цією новою східною імперією ми маємо керувати! Але, можливо, ми занадто поспішаємо? З цими новими землями ми успадкуємо їхні старі проблеми, їхні зобов’язання та їхні вимоги. Може, краще бути вільним від усього цього, вільним, як вітер, що формує дюни…? Ви можете вирішити. Мені приємно винагородити Вас таким чином. Вибирайте долю Танухідів! Веди нас вперед як імперію піску!	true
dilemmas_localised_title_att_subject_religious_zoroastrian_corpse	Питання життя і смерті	true
dilemmas_localised_description_att_subject_domestic_civil_married_slaves	Двоє з Ваших домашніх рабів прийшли, щоб отримати Ваш дозвіл на шлюб, які Ваші дії?	true
dilemmas_localised_title_att_political_action_dilemma_secure_loyalty_mutilation	Відчайдушні заходи	true
dilemmas_localised_description_att_subject_religious_hun_shaman	Перед Вами постає шаман, який стверджує, що бачив видіння, у якому небо потемніло від Вашого наступу. Він каже, що ти завершиш кінець всіх днів.	true
dilemmas_localised_description_political_event_assassination_success_discovered	Ви проігнорували попередження, і пролилася благородна кров. Усі докази вказують на причетність цього чоловіка. Що ти з ним робитимеш?	true
dilemmas_localised_description_att_dilemma_religious_zoroastrian_religious_sanctions_1	Зараз зороастрійці становлять значний відсоток нашої спільноти. Який у них статус?	true
dilemmas_localised_title_att_subject_domestic_roman_the_chariot_races_1	Гонки на колісницях	true
dilemmas_localised_title_att_political_action_dilemma_adoption_added_incentive	Варто Вашого часу?	true
dilemmas_localised_title_att_subject_diplomatic_none_tribute_1	Данина	true
dilemmas_localised_title_att_dilemma_domestic_none_plentiful_harvest_1	Щедрий урожай	true
dilemmas_localised_description_att_subject_politics_barb_nomad_secret_meetings	Ваші вірні слуги повідомили Вам, що Ваші суперники зустрічаються в тіні. Єдина спільна причина, яка могла б їх об'єднати, це ненависть до Вас.	true
dilemmas_localised_description_att_subject_religious_barb_stones	Перед Вами постає виснажений і наляканий чоловік, щоб сказати, що земля під стародавніми камінням тремтить. Чи можуть мертві воїни наших ворогів ожити?	true
dilemmas_localised_description_political_event_assassination_failure_discovered	Змова провалилася, і справжнє обличчя вбивці було розкрито. Його ціль поранена, але жива. Тхід за Вами, він визначить, долю вбивці…	true
dilemmas_localised_description_att_subject_domestic_nomadic_the_kassai_contest_1	Один із наших дворян бере участь у місцевому заході Кассаї і просить Вас спонсорувати його участь. Перемога в події передбачає великий приз і честь.	true
dilemmas_localised_description_att_subject_domestic_roman_slave_murderer	Вільновідпущеник, який колись був Вашим рабом, убив римського громадянина і шукає Вашої допомоги, що Ви збираєтеся робити?	true
dilemmas_localised_title_att_political_action_dilemma_embezzlement_caught	Спійманий на місці злочину	true
dilemmas_localised_description_att_political_action_dilemma_marriage_impediment	Сором! Хтось заперечив проти запланованого шлюбу! Цей драматичний поворот подій має бути виправлений. Як Ви бажаєте продовжити?	true
dilemmas_localised_title_att_subject_diplomatic_none_the_feast_1	Свято	true
dilemmas_localised_description_cha_dilemma_verden	Наші люди стурбовані тим, що їм доводиться охороняти таких поганців. Тепер Ви повинні вирішити, що робити з цими полоненими. Ваш вибір вирішить не тільки їхню долю, а й вплине на думку Ваших людей.	true
dilemmas_localised_description_att_eos_religious_event_rebellion_att_fact_himyar_att_rel_semitic_paganism	Ми довго терпіли Вашу прихильність до цієї чужої та нечестивої релігії. На початку свого правління Ви запевняли нас, що нам дозволять процвітати без загрози Вашим переконанням, але тепер нам ясно, що це були порожні слова і що Ваша справжня мета — викорінення нашої віри та всіх, хто в неї вірить . Нам надто пізно намагатися повернути хвилю назад, але ми вимагаємо засобів, щоб захистити себе. Дай нам золотий дар, щоб ми жили по совісті і не боялися труднощів. Я смиренно звертаюся з цим проханням, але знайте: мої послідовники — люди у відчаї, і я боюся, що якщо їм відмовити, проллється кров. Вибирайте мудріше, ніж робили досі, мілорде.	true
dilemmas_localised_title_ollam_ri_ebdani	Цикл про Оллам Рі (Верховного Короля)	true
dilemmas_localised_description_att_subject_religious_zoroastrian_brazier	Служка дозволив згаснути святій жаровні. Що робити з хлопчиком?	true
dilemmas_localised_description_att_dilemma_religious_arian_religious_sanctions_1	На наших землях живе велика кількість аріян. Чи їм слід надати ті самі права, що й правдивим віруючим?	true
dilemmas_localised_description_att_subject_military_none_the_lanista_1	Вулицями столиці знайшли старого ланіста, який блукав. Він виявив бажання служити імперії.	true
dilemmas_localised_title_att_dilemma_religious_manichaeism_religious_sanctions_1	Релігійні санкції	true
dilemmas_localised_description_att_subject_domestic_barb_temple_sacrilege	Якогось дурня спіймали, коли він псував храм Юпітера. До таких питань не слід ставитися легковажно.	true
dilemmas_localised_title_att_subject_domestic_barb_nomad_hostile_dispute	Недружня суперечка	true
dilemmas_localised_description_att_subject_religious_christian_pontifex_maximus_1	Нашого єпископа, як священнослужителя високого рангу, було обрано кандидатом на папський престол.	true
dilemmas_localised_title_att_subject_religious_none_the_golden_tongued_1	Золотий Язик	true
dilemmas_localised_title_political_event_assassination_success_discovered	Змова на вбивство!	true
dilemmas_localised_description_att_subject_domestic_nomad_sword_of_attila	Перед Вами прийшов фермер і розповів про меч, який він знайшов, коли один із його отари порізав собі щиколотку об могутнє лезо. Він стверджує, що меч — це подарунок, призначений тільки Вам.	true
dilemmas_localised_description_cha_dilemma_pope_help_1	Тридцять два роки тому Ваш батько, король франків Піпін, на прохання Папи, якому тоді загрожували, повів армію проти лангобардів і змусив їх здатися. Роблячи це, він передав багато їхніх захоплених земель Папі Римському, акт, відомий як «Пожертвування Піпіна». Папа Адріан тепер закликав лангобардів виконати цю обіцянку і поступитися Равенною Папській області, але нинішній король лангобардів відмовився це зробити. У результаті Папа відправив посланця до Вашого двору з благанням виконати обіцянку, яку колись дав Ваш батько. Ломбардський король Дезидерій також надіслав посланця, вказавши, що Папа поширює незгоду в провінціях своїх підданих герцогств.\\nВиберіть, яку сторону Ви хочете підтримати в цьому питанні, але майте на увазі, що Ваше рішення може мати тривалий вплив.	true
dilemmas_localised_title_att_political_action_dilemma_marriage_impediment	Справедлива причина чи перешкода	true
dilemmas_localised_title_political_event_marriage_female	Втеча з коханим	true
dilemmas_localised_title_ollam_ri_A1ii	Цикл про Оллам Рі (Верховного Короля)	true
dilemmas_localised_description_att_political_action_dilemma_embezzlement_caught	Розкрадання є злочином лише тоді, коли Вас спіймають. На жаль, цей хлопець зробив, і тепер люди вимагають справедливості. Як ти будеш діяти?	true
dilemmas_localised_title_att_subject_domestic_roman_a_little_flutter_2	Трохи потріпатися	true
dilemmas_localised_title_att_subject_domestic_roman_a_little_flutter_1	Трохи потріпатися	true
dilemmas_localised_description_att_political_action_dilemma_assassinate_caught	Вбивцю знайшли з ножем у руках, під час замаху вбивства. Ніхто не вірив, що все це був жарт, тож тепер Ви повинні винести суд.	true
dilemmas_localised_title_political_event_assassination_failure_discovered	Змова на вбивство	true
dilemmas_localised_title_political_event_adoption	Спроба усиновлення	true
dilemmas_localised_description_att_dilemma_religious_christian_conference_of_carthage_1	411 р. н.е., Карфаген. Берберські християни дотримуються законів донатизму, вважаючи, що вони є єдиною істинною Церквою, а всі інші християни приймають фальшиві таїнства. Марцеллін, який головує, запитує, чи повинні ми терпіти таке в Імперії?	true
dilemmas_localised_description_ollam_ri_ebdani	Століття гноблення та невизначеності придушили дух кельтського народу, але їхнє славне минуле, збережене в легендах, дає останній проблиск надії поколінню, яке шукає нового початку. Молодий Рі (король) відправляється в стародавнє серце острова, сповнений рішучості відкрити майбутнє для свого народу. Він знайде знання про це, або викує його сам!	true
dilemmas_localised_description_att_subject_military_none_drunk_on_watch_1	Цей чоловік був п’яний, коли мав бути на вахті. Здається, головною причиною є поповнення нашиш елітних військ цими дурнями!	true
dilemmas_localised_title_ybor_level_C_3	Переказ про Ібора	true
dilemmas_localised_title_ybor_level_B_2	Переказ про Ібора	true
dilemmas_localised_title_ybor_level_C_2	Переказ про Ібора	true
dilemmas_localised_title_ybor_level_B_1	Переказ про Ібора	true
dilemmas_localised_title_ybor_level_C_1	Переказ про Ібора	true
dilemmas_localised_title_ybor_level_C_4	Переказ про Ібора	true
dilemmas_localised_description_att_subject_diplomatic_none_the_feast_1	Мілорде, ми повинні влаштувати казковий бенкет, запросивши всіх великих і добрих людей дивуватися нашій пишноті, і триватиме дев’яносто днів і ночей. Кого нам запросити?	true
dilemmas_localised_title_att_eos_tanukhids_settle	Авдієнція у Мавії – Коронація	true
dilemmas_localised_title_att_subject_politics_civil_challenger	Претендент	true
dilemmas_localised_description_att_subject_military_barb_master_hostile_governor	Місцевий вождь Вас ненавидить. Він проклинає Ваші амбіції, Вашу військову міць і глузує з Вашої мужності. Він дає зрозуміти всім, що він повинен стати на Ваше місце.	true
dilemmas_localised_description_att_subject_religious_none_the_golden_tongued_1	Місцевому священнику особливо вдалося навернути населення цього села. Він міг би стати в пригоді нам деінде.	true
dilemmas_localised_title_att_political_action_dilemma_gather_support_opposition	Вороги на високих посадах	true
dilemmas_localised_description_att_dilemma_religious_manichaeism_religious_sanctions_1	Зараз маніхеї становлять значний відсоток нашої спільноти. Який у них статус?	true
dilemmas_localised_title_att_subject_military_none_the_lanista_1	Ланіста	true
dilemmas_localised_description_att_subject_domestic_barb_nomad_hostile_dispute	Ваш розбещений син бився з видатним членом ворогуючого племені. У результаті напруга зросла. Старійшини сподіваються, що Ви вирішите справу.	true
dilemmas_localised_title_att_political_action_dilemma_assassinate_caught	Схоплений за руку	true
dilemmas_localised_description_att_dilemma_religious_tengri_religious_sanctions_1	Зараз тенгристи становлять значний відсоток нашої спільноти. Який у них статус?	true
dilemmas_localised_title_cha_dilemma_pope_help_1	Обіцянка франків	true
dilemmas_localised_title_att_bel_request_antoninia_thedosius_1	Прохання Антоніни: Феодосій	true
dilemmas_localised_title_att_subject_religious_hun_shaman	Погані передвістя в небі	true
dilemmas_localised_description_political_event_marriage_female	Одну з Ваших дочок спокусив залицяльник і вона планує втекти. Чи варто їй дозволити слідувати своєму серцю?	true
dilemmas_localised_description_cha_dilemma_lombard_pope_demands_1	Понад тридцять років тому, на прохання папи Стефана II, тодішній франкський король - Піпін, батько Карла Великого - перетнув Альпи і розбив лангобардів під проводом короля Айстульфа. Вважаючи, що Айстульф готується захопити Рим після його недавніх завоювань у Равеннському екзархаті, Папа відчув загрозу і звернувся до Піпіна за підтримкою. Після перемоги Піпін пообіцяв віддати всі землі, раніше завойовані лангобардами, в акті, який став відомий як «Пожертвування Піпіна». Тепер, через багато років, Папа Адріан I вимагає повернення регіону Равенна в рамках умов цієї історичної обіцянки. Ви самі вирішуєте, чи дотримуватися цієї старої угоди, але знайте, що Ваше рішення, ймовірно, матиме довготривалі наслідки незалежно від результату.	true
dilemmas_localised_description_cha_dilemma_lombard_pope_demands_2	Розлючений Вашою відмовою, Папа шукає підтримки у франків, які в першу чергу уклали угоду. Таким чином, він послав посланця до двору Карла Великого, благаючи його підтримати в цій справі. Ви також повинні швидко вибрати курс дій і відправити посланця, щоб уникнути війни.	true
dilemmas_localised_description_cha_dilemma_lombard_pope_demands_3	Ви отримали листа від Карла Великого, в якому пояснюється, що його підтримка Папи та Церкви не підлягає обговоренню. Таким чином, він вимагав від Вас виконання будь-яких папських вимог щодо території згідно з умовами Пожертвування Пепіна. Невиконання вимог Папи щодо Равенни призведе до війни між Вашими двома народами.	true
dilemmas_localised_description_att_dilemma_religious_celtic_religious_sanctions_1	Багато язичників, послідовників кельтських богів, наповнюють наші землі. Чи заслуговують вони на рівні права?	true
dilemmas_localised_description_att_subject_religious_zoroastrian_corpse	Один із Ваших підданих закопав труп своєї дружини в стінах свого будинку. Спілкування з мертвими - це огида, що нам робити з цією людиною?	true
dilemmas_localised_description_ollam_ri_votadini	Століття гноблення та невизначеності придушили дух кельтського народу, але їхнє славне минуле, збережене в легендах, дає останній проблиск надії поколінню, яке шукає нового початку. Молодий Рі (король) відправляється в стародавнє серце острова, сповнений рішучості відкрити майбутнє для свого народу. Він знайде знання про це, або викує його сам!	true
dilemmas_localised_description_att_subject_domestic_civil_hostile_dispute	Вулиці заповнені балаканиною на Ваш рахунок. Ваш двоюрідний брат був залучений в агресивну суперечку в громадському місці. Вуличні артисти вже пліткують з Вас.	true
dilemmas_localised_title_att_subject_religious_arian_pilgrims_1	Прочани	true
dilemmas_localised_title_att_subject_military_none_the_gift_of_speed_1	Дар швидкості	true
dilemmas_localised_title_att_subject_domestic_none_withholding_taxes_1	Несплата податків	true
dilemmas_localised_description_att_subject_politics_barb_nomad_challenger	Один із молодших воїнів хвалився перед усіма, що його методи найкращі, що він убив більше, ніж Ви могли б, і він народить більше дітей. Він молодий лев, що кидає виклик лідеру прайду…	true
dilemmas_localised_description_att_eos_marib_dam_repair_3	Надходили повідомлення про те, що велика гребля Маріб демонструє ознаки слабкості, і багато хто каже, що зараз з’являються тріщини. Нам слід діяти зараз, якщо ми хочемо запобігти ескалації збитків - навіть спроби незначного ремонту можуть зменшити потенційні збитки та зменшити ризик повені.	true
dilemmas_localised_description_att_eos_marib_dam_repair_2	Надходили повідомлення про те, що велика гребля Маріб демонструє ознаки слабкості, і багато хто каже, що зараз з’являються тріщини. Нам слід діяти зараз, якщо ми хочемо запобігти ескалації збитків - навіть спроби незначного ремонту можуть зменшити потенційні збитки та зменшити ризик повені.	true
dilemmas_localised_description_att_eos_marib_dam_repair_1	Почали надходити повідомлення про те, що велика гребля Маріб починає виявляти ознаки слабкості, і багато хто каже, що на ній з'являються тріщини. Ми повинні діяти зараз і розпочати ремонтні роботи завчасно, якщо ми хочемо запобігти ескалації пошкоджень, навіть спроба незначного ремонту може зменшити потенційну шкоду та зменшити ризик повені.	true
dilemmas_localised_description_att_eos_marib_dam_repair_0	Надходили повідомлення про те, що велика гребля Маріб демонструє ознаки слабкості, і багато хто каже, що зараз з’являються тріщини. Нам слід діяти зараз, якщо ми хочемо запобігти ескалації збитків - навіть спроби незначного ремонту можуть зменшити потенційні збитки та зменшити ризик повені.	true
dilemmas_localised_title_att_subject_religious_tengri_pilgrims_1	Прочани	true
dilemmas_localised_description_att_bel_request_theodosia_amalasuntha_1	Вітаю, Велізарію. Пишу тобі за рекомендацією твоєї доброї дружини, яка є другом моєї юності. Ви, безперечно, знаєте, що я суворо обмежую свою участь у політиці, щоб дозволити мені зосередитися на благодійній діяльності. Той факт, що я пишу Вам, демонструє надзвичайну серйозність ситуації.\\n\\nМій чоловік, Імператор, хороша людина, але час від часу потрібна ласкава рука, щоб виправити його. Ви, безперечно, знаєте, що Амаласунта, королева остготів, була ув'язнена її власним народом. Юстиніан вирішив звільнити її, але я боюся, що його мотиви нечисті. Жінка – змія – вона обвилася навколо серця мого чоловіка. Уявляєте, яка ганьба? Славетний римський імператор під великою рукою варварської повії?\\n\\nЯ знаю, що імператор наказав її звільнити. Якщо Ви дійсно бажаєте служити йому та Імперії, Ви подбаєте про провал місії. Я пом’якшу гнів свого чоловіка і відшкодую тобі набагато краще, ніж він. Ваша дружина запевняє мене, що я можу розраховувати на Вашу обачність у цьому питанні...	true
dilemmas_localised_title_att_bel_request_theodosia_pope_1	Прохання Феодори: Папа	true
dilemmas_localised_description_att_subject_religious_tengri_illegal_practice_1	Цю людину схопили за порушення санкцій, які ми наклали на релігію Тенгрі.	true
dilemmas_localised_description_att_subject_religious_catholic_illegal_practice_1	Ми спіймали цього чоловіка, який намагався організувати латинське християнське богослужіння. Тут такі речі заборонені.	true
dilemmas_localised_description_att_political_action_dilemma_seek_bride_success	Ця наречена здається підходящою! Чи прийме її обранець вибір, який Ви зробили для нього?	true
dilemmas_localised_description_att_subject_military_roman_master_hostile_governor	Місцевий губернатор вороже ставиться до Ваших цілей. Він голосно проголошує своїм підданим і всім, хто його слухає, що він повинен керувати легіонами.	true
dilemmas_localised_description_att_political_action_dilemma_diminish_popularity_reversal	Завдяки вражаючому подвигу плутанини чутки поширилися, як Ви просили. Однак слід повертається до Вашого агента, а не до цілі. Як Ви хочете впоратися з цими причіпками?	true
dilemmas_localised_description_att_subject_religious_hellenic_illegal_practice_1	Було помічено, що ця людина порушує санкції, які ми наклали на поклоніння старим богам.	true
dilemmas_localised_description_att_subject_politics_civil_hostage	Римський хлопець, узятий у заручники, довів свою цінність і став би чудовим доповненням до суду. Що ти хочеш з ним робити?	true
dilemmas_localised_description_att_subject_religious_germanic_illegal_practice_1	Цього чоловіка схопили за порушення санкцій, які ми наклали на практику язичницьких германських релігій.	true
dilemmas_localised_description_slav_dilemma_sclaveneans_1	Як і слід було очікувати, лорде, гуни тут, і вони не мають наміру влаштовувати люб’язності. Вони оголили зуби на війну, але й ми теж. Питання в тому, як з ними боротися? Ми могли б оборонятися і змусити їх безкорисно накидатися на нас, але їх багато, і вони можуть зазнати успіху лише завдяки великій кількості. Крім того, ми могли б атакувати першими, вдаряючи блискавично із швидкістю. Обидва варіанти мають переваги, але остаточне рішення залишається за вами.	true
dilemmas_localised_description_ybor_level_A_langobardi	У твоїх чудових дворах молодий воїн, Ібор, неспокійно росте. Його серце прагне до дикої природи, сповненої великих випробувань, які заслужили репутацію людини, і він просить Вашого дозволу піти. Хоча його від’їзд завдає Вам болю, Ви знаєте, що він повернеться ще сильнішим, сформованим вибором, який він зробив під час своїх поневірянь. Який подарунок ти робиш на прощання?	true
dilemmas_localised_title_ybor_level_A_burgundi	Переказ про Ібора	true
dilemmas_localised_description_political_event_blackmail	Недобросовісний суперник розпустив негідні чутки про члена Вашої родини! Віддайте наказ, і вони замовкнуть…	true
dilemmas_localised_description_att_subject_domestic_eastern_the_chovgan_tourney_1	Ходять чутки, що на майбутніх Човганських іграх один із наших полководців виступатиме в маскуванні. Хоча здобутий престиж буде великим, він може отримати травму під час участі.	true
dilemmas_localised_title_att_subject_religious_arian_illegal_practice_1	Заборонені обряди	true
dilemmas_localised_title_att_subject_politics_barb_nomad_tribal_loyalty	Вірність племені	true
dilemmas_localised_title_att_subject_domestic_none_workers_on_strike_1	Робітники страйкують	true
dilemmas_localised_title_slav_dilemma_anteans_1	Вівця в римському шкурі	true
dilemmas_localised_title_slav_dilemma_anteans_2	Вівця в римському шкурі	true
dilemmas_localised_title_att_dilemma_religious_christian_the_manichean_heresy_1	Маніхейська єресь	true
dilemmas_localised_title_ollam_ri_A1i	Цикл про Оллам Рі (Верховного Короля)	true
dilemmas_localised_description_slav_dilemma_venedians_1	Невгамовні гуни тут, як і було передбачено. Усіх, хто не виконав їхні вимоги, спіткала жахлива доля. Вони роблять мирні спроби, але не неправильно розуміють правду, що криється за їхніми посмішками — вони хочуть віддати належне. Ми могли б заплатити їм, скільки вони хочуть, і це виграє нам час, але вони неминуче повернуться і вимагатимуть більше. Хто знає, скільки вони попросять наступного разу? Або ми могли б кинути виклик і їм, і долі, і відмовитися від їхніх вимог. Або це може розпалити їх гнів, або наша наполегливість може заслужити їхню повагу. Вибір за Вами, мілорде, але майте на увазі, що гуни не люблять чекати...	true
dilemmas_localised_description_slav_dilemma_venedians_3	Як і очікувалося, гуни повернулися. Не задовольняючись «мізером», який ми дали минулого разу, вони повертаються, щоб вимагати більше наших засобів до існування, більше плодів нашої важко заробленої праці. Їхні вимоги суворі, як завжди, а вогонь в їхніх очах говорить про те, що їхня переконаність не викликає сумнівів. Ми могли б капітулювати і заплатити, або ми могли б стояти рішуче й кинути їм виклик. Гуни не прощають, але ми могли б залишити свій слід в історії їхньою поразкою...	true
dilemmas_localised_description_slav_dilemma_venedians_2	Як і очікувалося, гуни повернулися. Не задовольняючись «мізером», який ми дали минулого разу, вони повертаються, щоб вимагати більше наших засобів до існування, більше плодів нашої важко заробленої праці. Їхні вимоги суворі, як завжди, а вогонь в їхніх очах говорить про те, що їхня переконаність не викликає сумнівів. Ми могли б капітулювати і заплатити, або ми могли б стояти рішуче й кинути їм виклик. Гуни не прощають, але ми могли б залишити свій слід в історії їхньою поразкою...	true
dilemmas_localised_description_slav_dilemma_venedians_4	Як і очікувалося, гуни повернулися. Не задовольняючись «мізером», який ми дали минулого разу, вони повертаються, щоб вимагати більше наших засобів до існування, більше плодів нашої важко заробленої праці. Їхні вимоги суворі, як завжди, а вогонь в їхніх очах говорить про те, що їхня переконаність не викликає сумнівів. Ми могли б капітулювати і заплатити, або ми могли б стояти рішуче й кинути їм виклик. Гуни не прощають, але ми могли б залишити свій слід в історії їхньою поразкою...	true
dilemmas_localised_title_att_dilemma_religious_christian_council_of_carthage_1	Карфагенський собор	true
dilemmas_localised_title_att_subject_religious_tengri_illegal_practice_1	Заборонені обряди	true
dilemmas_localised_title_att_political_action_dilemma_seek_bride_success	Гідна пара	true
dilemmas_localised_title_cha_dilemma_cordoba_1	Аббасидський халіфат	true
dilemmas_localised_description_att_subject_religious_catholic_pilgrims_1	Сотні латинських християн-прочан прямують до Храму Гробу Господнього, на горі Голгофа, що знаходиться на наших землях. Якщо це не контролювати, це може призвести до повномасштабної міграції, ми повинні запобігти подальшому прочанству.	true
dilemmas_localised_title_att_bel_request_theodosia_amalasuntha_1	Прохання Феодори: Амаласунта	true
dilemmas_localised_description_att_subject_religious_tengri_pilgrims_1	Несучи з собою свої намети та коней, послідовники Тенгрі стікаються до річки Галіс, одного з їхніх святих місць. Якби ми забажали, ми могли б не дати їм повернутися.	true
dilemmas_localised_description_att_subject_domestic_civil_master_agitator	Амбітний політик планує завдати лиха за Ваш рахунок. Він бажає, щоб Ви впоралися з боргами, накопиченими деякими місцевими селянами, і має велику підтримку від людей.	true
dilemmas_localised_title_att_subject_domestic_none_the_festival_1	Фестиваль	true
dilemmas_localised_title_att_dilemma_domestic_roman_saint_telemachus_1	Святий Телемах	true
dilemmas_localised_title_ollam_ri_picti	Цикл про Оллам Рі (Верховного Короля)	true
dilemmas_localised_title_ybor_level_A_langobardi	Переказ про Ібора	true
dilemmas_localised_description_att_subject_politics_nomad_hostage	Хлопчик, якого ми взяли в заручники, перейняв наш спосіб життя, він відмінно їздить на коні та відмінно володіє луком і стрілами. Що ти хочеш з ним робити?	true
dilemmas_localised_description_att_subject_religious_germanic_pilgrims_1	Послідовники Бальдра збираються в сусідньому лісі сотнями. Певно, що там відбуватимуться мерзенні язичницькі ритуали. Ми повинні зупинити їх?	true
dilemmas_localised_description_att_subject_religious_hellenic_pilgrims_1	Місце храму Аполлона, зруйнованого імператором Феодосієм, донині приваблює послідовників Аполлона.	true
dilemmas_localised_description_att_subject_politics_roman_hostage	Перський хлопчик, узятий у заручники, довів, що він справжній римлянин і чудовий у всьому, що він робить. Як має розвиватися хлопець в майбутньому?	true
dilemmas_localised_description_att_dilemma_religious_zoroastrian_the_manichean_heresy_1	Мобеди були стурбовані зростанням маніхейства на наших землях. Вони зустрілися, щоб вирішити долю цього тривожного культу.	true
dilemmas_localised_title_att_subject_diplomatic_none_diplomatic_dispute_1	Дипломатична суперечка	true
dilemmas_localised_title_att_eos_religious_event_rebellion_att_fact_axum_att_rel_semitic_paganism	Верховний проповідник Алмаки – відлучення	true
dilemmas_localised_title_political_event_marriage_male	Гідна пара?	true
dilemmas_localised_description_att_subject_religious_celtic_illegal_practice_1	Ми знайшли цю жінку, яка випивала в невеликому храмі, який вона побудувала для свого бога Суцелла, зображення якого ми заборонили.	true
dilemmas_localised_description_att_dilemma_religious_christian_the_council_of_toledo_1	400 р. н.е., Толедо, Іспанія. Зібрання дев'ятнадцяти єпископів підтвердили Нікейський символ віри. Однак питання Прісцилліана є предметом суперечок. Незважаючи на те, що їхній лідер помер, його єретична секта продовжує залучати послідовників. Чи варто терпіти цю секту?	true
dilemmas_localised_title_cha_dilemma_carloman_succession	Спадкоємство Карломана	true
dilemmas_localised_title_slav_dilemma_venedians_1	Між Скелею та Ордою	true
dilemmas_localised_title_slav_dilemma_venedians_3	Між Скелею та Ордою	true
dilemmas_localised_title_slav_dilemma_venedians_2	Між Скелею та Ордою	true
dilemmas_localised_title_slav_dilemma_venedians_4	Між Скелею та Ордою	true
dilemmas_localised_title_att_subject_religious_celtic_pilgrims_1	Прочани	true
dilemmas_localised_description_att_subject_domestic_none_the_festival_1	Минуло чимало часу, як ми святкували, і я впевнений, що це підніме людям настрій. Кому чи чому його присвятити?	true
dilemmas_localised_description_att_subject_religious_christian_the_black_sheep_1	Було виявлено, що жінка, сестра популярного місцевого диякона, таємно поклоняється язичницьким богам. Як стверджує канон, ніхто не може бути священником, якщо вся його родина не є християнською...	true
dilemmas_localised_description_ollam_ri_A1i	Господар кота бачить, як Рі пропонує йому блюдце з молоком. Вражена його добротою, вона розповідає йому про голову відрубаного короля в сусідньому селі. Голова постійно просить води з далекого струмка, щоб врятувати свою роззявлену шию. Вона пропонує Рі золотий кубок і вказує напрямок до струмка.	true
dilemmas_localised_description_att_subject_religious_christian_the_money_lender_1	Виявили, що диякон місцевої церкви позичав гроші та брав відсотки. Згідно з канонами Карфагена, жоден член духовенства не може отримувати прибуток від лихварства. Що з ним робити?	true
dilemmas_localised_description_att_subject_military_none_mercenary_commander_1	Ватажок найманців, що проходить, шукає роботи. Він пропонує нам свої мечі та вірність, якщо ми готові заплатити наперед…	true
dilemmas_localised_title_cha_dilemma_mercia_2_2	Залучення талантів	true
dilemmas_localised_description_att_subject_diplomatic_none_diplomatic_dispute_1	На жаль, я не зміг перешкодити одному з наших гостей зробити дурницю. Він тяжко образив наш добрий народ. Щойно ми отримали на нього офіційну скаргу.	true
dilemmas_localised_title_political_event_assassination	Змова на вбивство	true
dilemmas_localised_description_ollam_ri_B	Рі-король стикається з трьома синами Туїреанна, закривавленими й оточеними селянами. Їх звинувачують у вбивстві Сіана, місцевого короля. Вони благали про пощаду, стверджуючи, що він прийняв вигляд свині і його невпізнати. Якщо він відпустить їх, вони стверджують, що вони доведуть свою невинність, забравши його шкуру та продемонструвавши її магічні сили.	true
dilemmas_localised_description_ollam_ri_A	Старий чоловік сидить на березі. Якщо цю загадку буде розгадано, він обіцяє дати Знання Рі Лосося, прояв усіх правд у Всесвіті: «Я був зброєю воїна. Тепер сміливий молодий слуга вкриває мене золотом, сріблом і крученим дротом. Іноді чоловіки мене цілують - іноді я голосом кличу близьких товаришів на бій».	true
dilemmas_localised_description_att_eos_religious_event_rebellion_att_fact_axum_att_rel_semitic_paganism	Ми довго терпіли Вашу прихильність до цієї чужої та нечестивої релігії. На початку свого правління Ви запевняли нас, що нам дозволять процвітати без загрози Вашим переконанням, але тепер нам ясно, що це були порожні слова і що Ваша справжня мета — викорінення нашої віри та всіх, хто в неї вірить . Нам надто пізно намагатися повернути хвилю назад, але ми вимагаємо засобів, щоб захистити себе. Дай нам золотий дар, щоб ми жили по совісті і не боялися труднощів. Я смиренно звертаюся з цим проханням, але знайте: мої послідовники — люди у відчаї, і я боюся, що якщо їм відмовити, проллється кров. Вибирайте мудріше, ніж робили досі, мілорде.	true
dilemmas_localised_description_att_eos_sassanid_insult_1	Сасанідський король, Ваш сюзерен, запросив Вас пообідати у величному літньому палаці, який він наказав Вам побудувати недалеко від Хіри. Його язик, розв’язаний від вина, Шаханшах починає неспровокований напад на характер Вашого народу:\\n«Я не бачу нічого хорошого в арабах – матеріально та духовно – у них немає сили чи влади, їх місце серед звірів позбавлених хороших речей, які пропонує життя: їхня їжа - це м'ясо верблюда, яке навіть леви відмовляються їсти через його поганий смак. "	true
dilemmas_localised_description_att_eos_sassanid_insult_2	Шаханшах перебільшено закочує очі й, хитаючись, підводиться на ноги.\\n«Якби мій підданий був настільки ж сповнений мудрості, як і він гордості! Якщо Ви, араби, годуєте гостя, вони вважають це чеснотою, і про це їхні поети співають: вони нікчемні, бідні й жалюгідні, але вони такі горді й зарозумілі. Вони не скаржаться на голод, бідність і нещастя і ставлять себе вище за всі інші нації – то чим же Ви так пишаєтеся?»	true
dilemmas_localised_description_att_eos_sassanid_insult_3	Ваша згода не заспокоювала шаханшаха, але, схоже, лише посилила його глузування.\\n«Де гордість, якою араби так славляться? Напевно, у Вас є слово на захист Вашого народу чи докір. Можливо, тепер, коли ти скуштував спосіб життя мого народу, ти втратив свою прихильність до підлості та заперечення свого попереднього існування. Мені буде ще більше приємно зламати їхній дух, що ти віддаєш перевагу звичаям Сасанідів над звичаями свого народу, і я буду дивитися на тебе з великою прихильністю.	true
dilemmas_localised_title_att_subject_military_none_war_child_1	Дитина війни	true
dilemmas_localised_description_att_political_action_dilemma_diminish_popularity_followup_merciful	Ваша мета, тепер публічно зганьблена, перебуває у досить складній ситуації. Якщо Ви втрутитесь, вони, ймовірно, будуть вдячні…	true
dilemmas_localised_title_att_subject_diplomatic_none_turncoat_1	Відступник	true
dilemmas_localised_title_att_dilemma_religious_zoroastrian_the_manichean_heresy_1	Маніхейська єресь	true
dilemmas_localised_description_att_subject_religious_orthodox_illegal_practice_1	Навіть незважаючи на санкції, накладені на грецьких християн, цю людину визнали їх порушником.	true
dilemmas_localised_description_att_subject_religious_celtic_pilgrims_1	Велике кам'яне коло стоїть на пагорбі біля моря. Це вже давно місце кельтського ритуалу. Ми повинні не дати варварам поклонятися там.	true
dilemmas_localised_description_att_subject_domestic_nordic_the_flyting_1	Цієї ж ночі у великій залі будуть сварки, оскільки наші дворяни змагатимуться в флитінгу (дебатах). Бажаєте взяти участь? Якщо ні, один із наших полководців запропонував Вас представляти.	true
dilemmas_localised_description_att_bel_request_theodosia_pope_1	Велізарію, судячи з усього, ти належиш до благословенної когорти людей, чиї земні вчинки перевищують лише численні послуги, які вони здійснюють нашому Господу. Люди, які, як і Ви, цінують наступне життя над своїм теперішнім становищем, завжди радіють новим можливостям для побудови Царства Небесного на цій розбитій землі.\\n\\nТоді радій Велізарію, звинуваченням, яке я приношу тобі сьогодні . Папа, встановлений готами, Сільверій, зіпсований і духом, і розумом. У нього були знайдені листи на підтримку остготських повстанців, і, хоча ходять чутки щодо їх законності, я не сумніваюся в їх правдивості. Багато разів я намагався привести його до спілкування з духівництвом у Константинополі, але виявив, що він навмисно вносить розбіжності. Як Папа Римський він приведе тисячі до прокляття єресі — гріха, який переважує будь-яке тимчасове порушення!\\n\\nІмператор говорить про делікатність і примирення і не буде діяти, але я знаю, що в його серці він жадає, щоб хтось піклувався цієї проблеми для нього – ти будеш його Святим воїном?	true
dilemmas_localised_title_att_dilemma_military_none_war_child_1	Дитина війни	true
dilemmas_localised_title_att_subject_religious_celtic_illegal_practice_1	Заборонені обряди	true
dilemmas_localised_title_cha_dilemma_viking_1_cha_fact_northumbria	Невгамовні воїни	true
dilemmas_localised_title_att_dilemma_religious_christian_the_council_of_toledo_1	Толедський собор	true
dilemmas_localised_description_cha_dilemma_carloman_succession	Напруга навколо царства відчутна - настав час для Вас визначитися з Вашим курсом дій у справі спадкоємства Карломана. Цей момент можна було б запам’ятати назавжди як той, коли вирішилася доля всіх франків. Якщо Ви справді вірите, що Ви законний претендент на всі землі Карломана, то зараз саме час завдати удару. Це вимагатиме військових дій, щоб подолати тих, хто йому вірний, але, враховуючи нестабільний стан справ у його землях, це може завдати вирішального удару та швидко припинити будь-який конфлікт. Однак, якщо Ви вирішите підтримати сина Карломана як претендента на його землі, тоді між Вашими народами можна побудувати довготривалі позитивні стосунки. Можливо, два Франкські королівства, міцно об’єднанаються, так само добре, як одне ціле? Зроби свій вибір, Карл Великий, твоє майбутнє чекає!	true
dilemmas_localised_description_cha_dilemma_charlemagne_daughter_1	Нерозсудливість юності виявляється, Карле Великий, і тепер батько повинен заплатити за гріхи дитини. Ваша дочка, яку Ви бездоганно вважали жертвою необґрунтованих чуток, виявила, що ці чутки правдиві. Ваше виявлення її з місцевим хлопцем викликало обурення. Її ім’я у всіх на вустах, і Ваша репутація під загрозою. Ви можете втихомирити це бурмотіння одним із двох способів – докоривши їй або докоривши розповсюджувачам чуток.	true
dilemmas_localised_description_att_eos_religious_event_rebellion_att_fact_himyar_att_rel_judaism	Ми довго терпіли Вашу прихильність до цієї чужої та нечестивої релігії. На початку свого правління Ви запевняли нас, що нам дозволять процвітати без загрози Вашим переконанням, але тепер нам ясно, що це були порожні слова і що Ваша справжня мета — викорінення нашої віри та всіх, хто в неї вірить . Нам надто пізно намагатися повернути хвилю назад, але ми вимагаємо засобів, щоб захистити себе. Дай нам золотий дар, щоб ми жили по совісті і не боялися труднощів. Я смиренно звертаюся з цим проханням, але знайте: мої послідовники — люди у відчаї, і я боюся, що якщо їм відмовити, проллється кров. Вибирайте мудріше, ніж робили досі, мілорде.	true
dilemmas_localised_title_att_subject_religious_none_the_relic_seller_1	Продавець реліквій	true
dilemmas_localised_description_att_bel_request_justinian_narses_1	Аве, Велізарію! У моїх вухах і вдень, і вночі звучить чутка про Ваші успіхи – здавалося б, Ви своїми руками виганяєте остготів з Італії, як вони кажуть! Мушу зізнатися, що мене розчаровує зосередження на особистих діях доблесті, а не на відновленні… Але незважаючи на це, я щасливий, незважаючи на це.\\n\\nНасправді, щоб пришвидшити нашу справу та підняти цей неприродно важкий тягар з твоїх плечей Я послав Нарсеса тобі на допомогу. Він тактично проникливий і, що найголовніше, лояльний. Він не прагне особистої слави, і йому можна повністю довіряти. Будь ласка, не сприймайте його призначення як приниження – після Ваших нещодавніх успіхів це не може бути й мови – а натомість як винагороду. Він буде найбільш корисним. Я наполягаю на тому, щоб Ви самі випробували його мужність у запалі бою.	true
dilemmas_localised_description_att_subject_religious_none_the_holy_site_1	Коли я прокинувся сьогодні вранці, навколо скелі на моїх полях стояв великий натовп людей. Вони стверджують, що святий Віт колись відпочивав там по дорозі до Риму. Вони псують мій урожай!	true
dilemmas_localised_title_att_subject_military_none_mercenary_commander_1	Ватажок найманців	true
dilemmas_localised_description_att_subject_politics_civil_secret_meetings	Ходять чутки, що в тіні та забутих місцях зустрічаються Ваші політичні суперники. Хто знає, що обговорюється на цих таємних збіговиськах? Будемо сподіватися, що це не Ви...	true
dilemmas_localised_title_ybor_level_A_alamanni	Переказ про Ібора	true
dilemmas_localised_description_att_political_action_dilemma_assassinate_wound_suspicious	Вбивство не вдалось, Ваша ціль залишилася важко пораненою, але живою. Звичайно, люди ставлять складні запитання, на які Ви повинні відповісти.	true
