key	text	tooltip
#Loc;1;text/db/quotes.loc		
quotes_quote_onscreen_2422	Я зробив цей безлад.	true
quotes_quote_onscreen_2522	Мати командування означає мати всю владу, яка Вам коли-небудь знадобиться. Мати всю міць, яка Вам коли-небудь знадобиться, означає тримати світ у своїй долоні.	true
quotes_quote_onscreen_2622	Літо, жнива, війна.	true
quotes_quote_onscreen_2722	Благородна і мужня музика бадьорить дух, зміцнює людину, що вагається, спонукає до великих і гідних справ.	true
quotes_quote_onscreen_2922	Наближалася війна, і її треба було б вести в Італії, захищаючи стіни Риму і проти світу зі зброєю в руках.	true
quotes_quote_onscreen_3922	Найбільше нещастя в лихій долі - те, що Ви колись були щасливими.	true
quotes_quote_onscreen_2223	Ми не повинні будувати свої надії на вірі в те, що вони припустяться помилок, а на нашому власному ретельному передбаченні.	true
quotes_quote_onscreen_2323	Краще обережний командувач, ніж необачний.	true
quotes_quote_onscreen_2723	Найбільше мені служить той, хто найкраще служить своїй країні.	true
quotes_quote_onscreen_3123	У момент дії пам'ятайте про цінність тиші та порядку.	true
quotes_quote_onscreen_3223	Жорстокість війни сприяє миру.	true
quotes_quote_onscreen_2420	Ніхто не вільний, хто не панує над собою.	true
quotes_quote_onscreen_2520	Влада не має меж.	true
quotes_quote_onscreen_2720	Ой, боги, які мерзотники командують нашими військами? Понесли на війну деревину землі.	true
quotes_quote_onscreen_3420	Відважна людина — це жити зі славою або померти у славі.	true
quotes_quote_onscreen_3620	Для римлян буде те, що вони бажають мені.	true
quotes_quote_onscreen_3820	У всьому має бути гостра приправа правди.	true
quotes_quote_onscreen_2321	Поспішайте обережно.	true
quotes_quote_onscreen_3421	Усе жорстоке й безсоромне стікається звідусіль до Риму.	true
quotes_quote_onscreen_3621	Два варвари виступили перед Аттилою і заспівали пісні, які вони склали, оспівуючи його перемоги та великі подвиги на війні.	true
quotes_quote_onscreen_2426	Боягузи вмирають багато разів перед справжньою смертю.	true
quotes_quote_onscreen_3026	Я віддаю перевагу безмовним знанням перед неосвіченою балакучістю.	true
quotes_quote_onscreen_3326	Маленький камінь стримує велику хвилю.	true
quotes_quote_onscreen_3426	Це частина людської природи - ненавидіти людину, якій Ви завдали болю.	true
quotes_quote_onscreen_3027	Хай буде легкою Вам земля… щоб собакам було легше Вас викопати.	true
quotes_quote_onscreen_2824	Переможений сумує, переможець знищений.	true
quotes_quote_onscreen_3524	Горе мені. Я думаю, що я стаю богом.	true
quotes_quote_onscreen_3624	Кажуть, що його армія налічувала п’ятсот тисяч чоловік. Він був чоловіком, народженим у світі, щоб потрясти народи, лихом усіх країн...	true
quotes_quote_onscreen_3724	Життя людини забарвлене кольором її уяви.	true
quotes_quote_onscreen_2425	Що Ви робите товариші? Я Ваш, а Ви мої.	true
quotes_quote_onscreen_2728	Тим, хто тікає, не приходить ні сила, ні слава.	true
quotes_quote_onscreen_2429	Досвід - учитель всього.	true
quotes_quote_onscreen_2929	Ніколи одна й та ж сама душа не була вправною у протистоянні підкорятися і наказувати…	true
quotes_quote_onscreen_2232	Пам’ятайте, яке велике це місто, що Ви атакуєте, і яку славу Ви принесете своїм предкам і собі добру чи злу залежно від результату.	true
quotes_quote_onscreen_2532	Імператор повинен померти стоячи.	true
quotes_quote_onscreen_2632	Від поганої ворони погане яйце.	true
quotes_quote_onscreen_3132	Війна солодка для тих, хто її ніколи не відчував.	true
quotes_quote_onscreen_3232	Пробачте одну провину, і Ви заохотите до вчинення багатьох.	true
quotes_quote_onscreen_3932	І саме тому, що Ви не розумієте кінця та сутність речей, Ви думаєте, що нечестиві та злочинці мають силу та щастя.	true
quotes_quote_onscreen_2333	Квінтілій Вар, поверни мої легіони!	true
quotes_quote_onscreen_2533	Для імперського міста немає нічого невідповідного, що є доцільним.	true
quotes_quote_onscreen_3033	Чоловік, який втече, знову буде битися.	true
quotes_quote_onscreen_2730	Чоловіки швидше втомлюються від сну, кохання, співів і танців, ніж від війни.	true
quotes_quote_onscreen_2830	Мати боягуза не плаче.	true
quotes_quote_onscreen_3530	Війни, жахливі війни!	true
quotes_quote_onscreen_3630	Римляни, Ви досягли свого бажання - Ви зробили Аттилу нашим ворогом. Ми будемо переслідувати його, куди б він нас не завів.	true
quotes_quote_onscreen_2731	Саме лезо спонукає до насильства.	true
quotes_quote_onscreen_3731	Мистецтво життя більше схоже на боротьбу, ніж на танці. Головне твердо стояти і бути готовим до раптової атаки.	true
quotes_quote_onscreen_3831	Обличчя - дзеркало розуму, а очі безмовно виказують таємниці серця.	true
quotes_quote_onscreen_3931	Людина височіє над рештою творіння, поки вона усвідомлює свою власну природу, а коли вона забуває про це, вона опускається нижче за звірів.	true
quotes_quote_onscreen_3436	Боги на боці сильнішого.	true
quotes_quote_onscreen_2737	Славна смерть того, хто за свою країну впаде.	true
quotes_quote_onscreen_2837	Зброя зберігає мир.	true
quotes_quote_onscreen_3537	Помилка сприяє приховуванню.	true
quotes_quote_onscreen_3837	Справа в тому, що моя рідна земля — здобич варварства, що в ній людям єдиний Бог — живіт, що вони живуть тільки теперішнім, і чим багатша людина, тим вона святіша.	true
quotes_quote_onscreen_2234	Вдершись до іншої країни, люди завжди повинні бути рішучі, але і страх повинен сприяти їхній обережності - таким чином вони будуть водночас найхоробріші у нападі і стійкі в захисті.	true
quotes_quote_onscreen_2334	І у вічність, брате, вітай і прощай.	true
quotes_quote_onscreen_2734	Так закінчується кривава справа дня.	true
quotes_quote_onscreen_2934	Поки стоїть Колізей, стоятиме Рим. Коли впаде Колізей, упаде Рим. А коли впаде Рим – то впаде і Світ.	true
quotes_quote_onscreen_3134	Володарі держави єдині, хто повинен мати привілей брехати.	true
quotes_quote_onscreen_3334	З усього, що дихає і повзає по землі, наша мати-земля не породжує нічого слабшого за людину.	true
quotes_quote_onscreen_2435	Як правило, людей більше хвилює те, що вони не бачать, ніж те, що вони бачать.	true
quotes_quote_onscreen_2635	Клянуся, як тільки дозволить вік... Я використаю вогонь і сталь, щоб зупинити долю Риму.	true
quotes_quote_onscreen_3335	Слава Цезарю! Вітають Вас ті, хто готові померти!	true
quotes_quote_onscreen_3535	Нехай всі будуть присутні і чекають пальми першості, нагороди перемоги.	true
quotes_quote_onscreen_3138	Треба подбати про те, щоб наші ауксиларії, бувши сильнішими за наших громадян, не могли занадто розростатися і не перетворюватися на диких звірів.	true
quotes_quote_onscreen_3938	Людина влаштована так, що підноситься величі лише тоді, коли пізнає себе.	true
quotes_quote_onscreen_2339	Хто сильний, будь милосердним, щоб ближні поважали, а не боялися.	true
quotes_quote_onscreen_2539	Сміливості можна навчити так само, як дитину вчать говорити.	true
quotes_quote_onscreen_3639	Я не вважаю жодну війну небезпечною, крім тієї, чия причина слабка; не боїться зла той, кому посміхнулася Велич.	true
quotes_quote_onscreen_3739	Ніде людина не може знайти тихішого чи більш безтурботного притулку, ніж у власній душі.	true
quotes_quote_onscreen_2702	Великі справи зазвичай здійснюються з великим ризиком.	true
quotes_quote_onscreen_2303	Ніхто не любить людину, якої боїться.	true
quotes_quote_onscreen_2803	Жереб кинуто.	true
quotes_quote_onscreen_3303	Сьогодні ми вмираємо не лише за наших друзів і родину, але й за наших богів, наших прабатьків і людей до них, тому моліться до них, щоб вони зробили нас переможцями.	true
quotes_quote_onscreen_3503	Війна – це не стільки зброя, скільки гроші.	true
quotes_quote_onscreen_3603	Ще одна така перемога, і ми будемо знищені.	true
quotes_quote_onscreen_3803	Нехай Ваші справи не суперечать Вашим словам, щоб, коли Ви говорите в церкві, хтось не сказав вам: «Чому Ви не виконуєш того, що проповідуєте?»	true
quotes_quote_onscreen_2800	На війні важливі події виникають через незначні причини.	true
quotes_quote_onscreen_3000	Несправедливий мир краще, ніж справедлива війна.	true
quotes_quote_onscreen_3100	Зачекайте на цей наймудріший з усіх порадників, час.	true
quotes_quote_onscreen_3500	Доля сприяє сміливим.	true
quotes_quote_onscreen_2401	Юнаки, послухайте старого, якого старі слухали, коли він був молодим.	true
quotes_quote_onscreen_2501	Секрет усіху перемог полягає в організації неочевидного.	true
quotes_quote_onscreen_3801	Почніть зараз бути тим, ким Ви будете в майбутньому.	true
quotes_quote_onscreen_2206	Труп ворога завжди пахне солодко.	true
quotes_quote_onscreen_2406	Кожна людина є архітектором своєї долі.	true
quotes_quote_onscreen_2506	Утриматися від наслідування - найкраща помста.	true
quotes_quote_onscreen_3206	Жоден звір не є більш диким, ніж людина, коли володіє силою, що відповідає його люті.	true
quotes_quote_onscreen_3406	Будьте розважливі в дружбі, але коли ти дружиш, продовжуй так і постійно.	true
quotes_quote_onscreen_3906	Ощадливість — мати всіх чеснот.	true
quotes_quote_onscreen_2607	Солодке милосердя — справжній знак благородства.	true
quotes_quote_onscreen_3107	Ніколи не варто довіряти союзу з могутніми.	true
quotes_quote_onscreen_2404	Якщо я впорався добре, гучно плескайте в долоні!	true
quotes_quote_onscreen_3104	Перемагає той, хто витримує.	true
quotes_quote_onscreen_3304	Ненавиджу людину, яка в глибині серця ховає одне, а говорить інше.	true
quotes_quote_onscreen_3504	Самоконтроль є головним елементом самоповаги, а самоповага є головним елементом мужності.	true
quotes_quote_onscreen_3704	Престол — це славна гробниця.	true
quotes_quote_onscreen_3804	Кожен день ми змінюємося, кожен день ми вмираємо, але ми вважаємо себе вічними.	true
quotes_quote_onscreen_3904	Як військові справи забезпечуються безпекою законів, так і закони зберігаються силою зброї.	true
quotes_quote_onscreen_3405	Чесна людина завжди дитина.	true
quotes_quote_onscreen_2208	Війна прихильна не до сміливих, а до боягузливих.	true
quotes_quote_onscreen_2308	Я думаю, що вбитих мало хвилює, сплять вони чи воскреснуть знову.	true
quotes_quote_onscreen_2908	Для вмілого полководця важлива удача.	true
quotes_quote_onscreen_3608	Там, де я пройшов, ніколи не зросте трава.	true
quotes_quote_onscreen_3908	Краще нехай злочинці залишаться безкарними, ніж засудять невинних.	true
quotes_quote_onscreen_2509	Прихований талант не приносить користі.	true
quotes_quote_onscreen_3009	Будь-яка людина може помилятися, але тільки ідіот наполягає на своїй помилці.	true
quotes_quote_onscreen_3409	Навчіться слухатися, перш ніж наказувати.	true
quotes_quote_onscreen_3509	Сильні робили, що могли, а слабкі страждали, що мусили.	true
quotes_quote_onscreen_2312	Голос людей небезпечний, коли сповнений гніву.	true
quotes_quote_onscreen_2612	Після закінчення війни укладайте союзи.	true
quotes_quote_onscreen_3212	Гарний полководець не тільки бачить шлях до перемоги, він також знає, коли перемога неможлива.	true
quotes_quote_onscreen_2213	Це найшляхетніша і найбезпечніша річ для великого війська, яка живиться одним духом.	true
quotes_quote_onscreen_2313	На війні першою жертвою є правда.	true
quotes_quote_onscreen_2713	У сприятливих регіонах народжуються слабкі люди.	true
quotes_quote_onscreen_2813	У цьому місті повно жорстоких п’яниць, які не можуть заснути, поки когось не поб’ють.	true
quotes_quote_onscreen_3113	Розум іноді слід відволікати, щоб він міг краще повернутися до мислення.	true
quotes_quote_onscreen_3813	Навіть звірі та птахи не потрапляють двічі в ті самі пастки.	true
quotes_quote_onscreen_3913	Те, що є спільне для всіх - це повітря, вода, море та береги.	true
quotes_quote_onscreen_2210	Необхідність - мати винаходів.	true
quotes_quote_onscreen_2710	Поспішність у кожній справі приносить невдачі.	true
quotes_quote_onscreen_3010	Перш ніж почати, ретельно сплануйте.	true
quotes_quote_onscreen_3110	Людям, яке б високе становище вони не займали, слід боятися простих.	true
quotes_quote_onscreen_3510	Для славних чоловіків вся земля гробниця.	true
quotes_quote_onscreen_3710	Коли я вперше прийняв доручення підкорити Африку, я покладався набагато менше на чисельність чи хоробрість моїх військ, ніж на дружнє ставлення місцевих жителів і їх безсмертну ненависть до вандалів.	true
quotes_quote_onscreen_2411	Не завжди говори те, що знаєш, але завжди знай те, що говориш.	true
quotes_quote_onscreen_2511	Що за художник помирає зі мною!	true
quotes_quote_onscreen_2811	Навіть ти Брут?	true
quotes_quote_onscreen_3516	Хто першим викував смертоносний клинок? З міцної сталі була зроблена його дика душа.	true
quotes_quote_onscreen_2217	Розпочавши поспіхом війну - воюватимемо довше через непідготовленість.	true
quotes_quote_onscreen_3317	Єдина найкраща ознака — боротися за свою країну.	true
quotes_quote_onscreen_3417	Швидкі рішення – це небезпечні рішення.	true
quotes_quote_onscreen_3517	З моменту свого скромного початку Рим виріс і зараз приголомшений власною величчю.	true
quotes_quote_onscreen_3717	Думка - це основне, що приносить шкоду або користь у світі. Нас гублять наші хибні думки.	true
quotes_quote_onscreen_2414	Не робити зла — це добре, а не мати наміру ще краще.	true
quotes_quote_onscreen_2814	Це стіни Спарти.	true
quotes_quote_onscreen_3014	Слава слідує за чеснотою, ніби вона її тінь.	true
quotes_quote_onscreen_3114	Агресія без виклику - це агресія, що вивільнилася.	true
quotes_quote_onscreen_3314	Безліч володарів — це погано. Хай буде один володар, один цар.	true
quotes_quote_onscreen_2315	Якщо людина не вдарить першою, вона першою отримає удар.	true
quotes_quote_onscreen_2515	Обов’язок доброго пастиря – стригти своїх овець, а не здирати з них шкіру.	true
quotes_quote_onscreen_2915	Результат менш відповідає очікуванням на війні, ніж у будь-якому іншому випадку.	true
quotes_quote_onscreen_3215	На війні ми завжди повинні залишати місце для випадкових подій і нещасних випадків, які неможливо передбачити.	true
quotes_quote_onscreen_3915	Зараз - це час, що минає, і створює з часу, що залишається - вічність.	true
quotes_quote_onscreen_2618	Розділяй і володарюй.	true
quotes_quote_onscreen_2718	Навіть найсміливіший не може боротися понад свої сили.	true
quotes_quote_onscreen_2918	Горе переможеним.	true
quotes_quote_onscreen_3518	Намагайтеся виглядати неважливим - ворог може пожалкує боєприпасів.	true
quotes_quote_onscreen_3618	Золото для моїх друзів і залізо для моїх ворогів.	true
quotes_quote_onscreen_3918	Ніщо не є жалюгідним, якщо Ви так не думаєте, а з іншого боку, ніщо не приносить щастя, якщо Ви ним не задоволені.	true
quotes_quote_onscreen_3019	Мені не соромно зізнатися, що я не знаю того, чого не знаю.	true
quotes_quote_onscreen_3162	Переможені, ми перемагаємо.	true
quotes_quote_onscreen_3262	Рани кохання може загоїти лише той, хто їх завдав.	true
quotes_quote_onscreen_3562	Страх є доказом виродженого розуму.	true
quotes_quote_onscreen_3762	Не прагніть зрозуміти, щоб повірити, а вірте, щоб Ви могли зрозуміти.	true
quotes_quote_onscreen_2463	Цінність людини не вище її амбіцій.	true
quotes_quote_onscreen_2663	Вони мають надлишок золота та срібла, і це робить війну, як і інші речі, гладкими.	true
quotes_quote_onscreen_2963	Я вмираю, Єгипет, вмираю.	true
quotes_quote_onscreen_2360	Небезпека блищить, як сонячне світло, в очах сміливої людини.	true
quotes_quote_onscreen_2660	Коли є взаємний страх, чоловіки двічі подумають, перш ніж вчинити агресію один проти одного.	true
quotes_quote_onscreen_3060	Зручно, що боги є, і, як зручно, що ми віримо в них.	true
quotes_quote_onscreen_3560	Коли гілочка згинається, дерево нахиляється.	true
quotes_quote_onscreen_2461	Гнів не може бути ганебним.	true
quotes_quote_onscreen_3461	Поганий мир гірший за війну.	true
quotes_quote_onscreen_2566	Бідолашний Брут, воюючи, забуває про любов до інших людей.	true
quotes_quote_onscreen_3066	Час, пожирач усього.	true
quotes_quote_onscreen_3166	У цих питаннях єдина впевненість полягає в тому, що немає нічого певного.	true
quotes_quote_onscreen_3366	Володіти собою - це найвища сила.	true
quotes_quote_onscreen_3466	Бажання безпеки протистоїть будь-яким великим і шляхетним починанням.	true
quotes_quote_onscreen_3666	Бо не кількістю людей і не силою тіла, а хоробрістю душі вирішується війна.	true
quotes_quote_onscreen_2167	Повертайтеся із щитом або на щиті.	true
quotes_quote_onscreen_2367	Бог війни ненавидить тих, хто вагається.	true
quotes_quote_onscreen_2767	Користуйтеся днем.	true
quotes_quote_onscreen_2264	Війна повна хибних тривог.	true
quotes_quote_onscreen_2564	Остерігайтеся березневих ід.	true
quotes_quote_onscreen_2865	Поганий план, який неможливо змінити.	true
quotes_quote_onscreen_2965	Кожна мить часу – це укол вічності.	true
quotes_quote_onscreen_3168	В Африці завжди є щось нове.	true
quotes_quote_onscreen_3768	Терпіння є супутником мудрості.	true
quotes_quote_onscreen_3569	Вовка ніколи не хвилює, скільки овець може бути.	true
quotes_quote_onscreen_2272	Ми воюємо, щоб жити в мирі.	true
quotes_quote_onscreen_2472	Обмежтеся сьогоденням.	true
quotes_quote_onscreen_3172	Коли крах неминучий, маленькі гризуни тікають.	true
quotes_quote_onscreen_2673	Нікого не веде до війни через незнання, і нікого, хто думає, що він щось отримає від неї, страх не стримує.	true
quotes_quote_onscreen_2873	Пам'ятайте, що Ви помрете.	true
quotes_quote_onscreen_3473	Хоробрість — це презирство до смерті й болю.	true
quotes_quote_onscreen_3873	Бідність – мати злочинів.	true
quotes_quote_onscreen_2970	Час — бурхливий потік; щойно річ з'являється, як її змітають, а її місце займає інша.	true
quotes_quote_onscreen_3270	Мало людей народжуються сміливими. Багато хто стає таким завдяки навчанню та сильній дисципліні.	true
quotes_quote_onscreen_3570	Пристрасть і сварка схиляють розум.	true
quotes_quote_onscreen_2371	Велика армія завжди безладна.	true
quotes_quote_onscreen_2971	Ні з ким не трапляється нічого такого, чого б він не міг пережити.	true
quotes_quote_onscreen_3271	Нелегко подолати полководця, який може правильно оцінити свої сили та сили ворога.	true
quotes_quote_onscreen_3371	Хто має багато, той прагне більшого.	true
quotes_quote_onscreen_2876	Закони мовчать під час війни	true
quotes_quote_onscreen_2976	Людство створене заради одне одного. Тому або наставляй їх, або терпи.	true
quotes_quote_onscreen_3076	Вчитися потрібно навіть у ворога.	true
quotes_quote_onscreen_3776	Усі ті з Вас, хто радіє миру, тепер настав час судити правду.	true
quotes_quote_onscreen_2777	Гнів - це короткочасне божевілля.	true
quotes_quote_onscreen_2174	Нехай навіть ненавидять, головне, щоб боялися.	true
quotes_quote_onscreen_2574	Борг амбіцій сплачено.	true
quotes_quote_onscreen_3574	Коли одна сторона виступає проти ворога з божественним даром зміцнення моралі, тоді їхні супротивники, як правило, не можуть протистояти їй.	true
quotes_quote_onscreen_3674	Справедливість — це постійне і вічне бажання віддавати кожному належне.	true
quotes_quote_onscreen_2275	Мудрий говорить, бо є що сказати, а дурень говорить, бо хоче щось сказати.	true
quotes_quote_onscreen_3175	Найкращий план — отримати прибуток на чужій дурості.	true
quotes_quote_onscreen_3375	Причина страху - незнання.	true
quotes_quote_onscreen_3475	Великі імперії не тримаються боязкістю.	true
quotes_quote_onscreen_2378	Ніщо не є настільки укріпленим, щоб його не можна було завоювати грошима.	true
quotes_quote_onscreen_2578	Кричи: "Хаос!" і випускай псів війни.	true
quotes_quote_onscreen_2778	Сенатори не повинні терпіти зловживань або ненормативної лексики, але належною та законною відповіддю буде, якщо сенатор використає її першим.	true
quotes_quote_onscreen_2978	Ми без вагань сумлінно виконуємо послуги для тих, хто, сподіваємося, допоможе нам у майбутньому.	true
quotes_quote_onscreen_3278	Що може зробити воїн, який атакує, коли задихався?	true
quotes_quote_onscreen_2679	У мирний час діти ховають своїх батьків, у воєнний - батьки ховають дітей.	true
quotes_quote_onscreen_3579	Добровільна слухняність завжди перемагає вимушену покору.	true
quotes_quote_onscreen_2342	О щасливий Рим, народжений під час мого консульства!	true
quotes_quote_onscreen_2642	Боги не дали людині гострішого стимулу до перемоги, ніж презирство до смерті.	true
quotes_quote_onscreen_2942	Для сміливих чоловіків нагороди, які пропонує війна, — це свобода і слава.	true
quotes_quote_onscreen_3342	Бувши в Римі, живіть, як живуть римляни, бувши деінде, живіть так, як живуть там.	true
quotes_quote_onscreen_3743	Несправедливий закон - це не закон.	true
quotes_quote_onscreen_3843	Нікому не хочеться говорити з неохочим слухачем. Стріла ніколи не застряє в камені: часто вона відбивається у того, хто її посилає.	true
quotes_quote_onscreen_2840	Смілива людина може впасти, але не піддатися.	true
quotes_quote_onscreen_3240	Ми повинні забезпечити в мирний час те, що нам потрібно на війні.	true
quotes_quote_onscreen_3540	Вони здатні, тому що думають, що здатні.	true
quotes_quote_onscreen_2241	Дайте мені точку опори, і я зрушу світ.	true
quotes_quote_onscreen_2441	Якщо Вам доводиться порушувати закон, робіть це, щоб захопити владу: у всіх інших випадках дотримуйтесь його.	true
quotes_quote_onscreen_2841	На війні не можна помилитися двічі.	true
quotes_quote_onscreen_3041	Маленька країна не може змагатися з великою; деякі не можуть боротися з багатьма; слабкий не може змагатися з сильним.	true
quotes_quote_onscreen_3941	Будь яка фортуна - це добре. Вона винагороджує і дисциплінує або виправляє і карає, а тому є або корисною або справедливою.	true
quotes_quote_onscreen_3046	В поході розділені, в битві зосереджені.	true
quotes_quote_onscreen_3146	Тільки мертві бачили кінець війни.	true
quotes_quote_onscreen_3446	Навіть найсміливіших лякають раптові жахи.	true
quotes_quote_onscreen_3646	Захищатися союзом - боягузтва. Бачите, ще до нашої атаки вони охоплені жахом.	true
quotes_quote_onscreen_2647	Ми або знайдемо шлях, або зробимо його.	true
quotes_quote_onscreen_3047	Їжа богів.	true
quotes_quote_onscreen_2244	Не торкайтесь моїх креслень!	true
quotes_quote_onscreen_2544	Ми даємо Вам війну, і  ми будемо боротися з в ній до кінця.	true
quotes_quote_onscreen_2744	У Римі ти сумуєш за селом. В селі прагнеш далеких міст у зірках.	true
quotes_quote_onscreen_2844	Перемога любить розсудливість.	true
quotes_quote_onscreen_2345	Сухожилля війни — гроші.	true
quotes_quote_onscreen_3145	Будьте ласкаві, адже кожен, кого Ви зустрічаєте, веде важку боротьбу.	true
quotes_quote_onscreen_3845	Шрами інших повинні навчити нас бути обережними.	true
quotes_quote_onscreen_2748	Лихоліття розкриває геній полководця; доля приховує це.	true
quotes_quote_onscreen_2848	Вчіться так, ніби Ви будете жити вічно, живіть так, ніби Ви помрете завтра.	true
quotes_quote_onscreen_3148	Мудрі люди говорять, тому що їм є що сказати; дурні, хочуть щось сказати.	true
quotes_quote_onscreen_3348	Я переконаний, що життя - це 10% того, що зі мною відбувається, і 90% того, як я на це реагую.	true
quotes_quote_onscreen_2449	Легше знайти людей, які добровільно пішли б на смерть, ніж тих, хто готовий терпіти біль.	true
quotes_quote_onscreen_2549	Дайте мені війну, кажу я. Вона спокійна, як день ніч. Вона блискавична, бадьора, голосна і рухлива.	true
quotes_quote_onscreen_2649	Є лише одна прикмета — воювати за свою країну.	true
quotes_quote_onscreen_3149	Невігластво, корінь і основа всякого зла.	true
quotes_quote_onscreen_3349	Якщо людина не знає, до якого порту вона пливе, жоден вітер не допоможе.	true
quotes_quote_onscreen_2752	Війни – це страх матерів.	true
quotes_quote_onscreen_3752	Бог вирішив, що краще робити добро зі зла, ніж знищити зло назавжди.	true
quotes_quote_onscreen_2453	Я боюся не цих ситих довговолосих чоловіків, а блідих і голодних на вигляд.	true
quotes_quote_onscreen_2753	Солодко і благородно померти за батьківщину.	true
quotes_quote_onscreen_3153	Відважні приносять більше прибутку своїй країні, ніж найкращі, найрозумніші оратори.	true
quotes_quote_onscreen_3253	Поганий план, який неможливо змінити.	true
quotes_quote_onscreen_3353	Доля війни завжди сумнівна.	true
quotes_quote_onscreen_3653	Нехай Ваша мужність підніметься і Ваша власна лють вирветься! Гуни, тепер застосуйте свою хитрість і свою зброю!	true
quotes_quote_onscreen_2950	Ти знаєш, як здобути перемогу, Ганнібале, ти не вмієш нею скористатися.	true
quotes_quote_onscreen_3250	Необхідність не знає закону, окрім як перемагати.	true
quotes_quote_onscreen_3550	Вік забирає все, навіть розум.	true
quotes_quote_onscreen_2351	Збройні сили за кордоном не мають великої цінності, якщо вдома немає розумної поради.	true
quotes_quote_onscreen_2751	Мудра людина в мирний час готується до війни.	true
quotes_quote_onscreen_3051	Солдати не люблять бути під орудою того, хто не має шляхетного походження.	true
quotes_quote_onscreen_2856	Отрута в хвості.	true
quotes_quote_onscreen_3356	Найгірше завжди боятися смерті, ніж померти.	true
quotes_quote_onscreen_3456	Власне мистецтво полководця — це справедливість і розважливість.	true
quotes_quote_onscreen_3656	Наскільки злісною була її неприязнь до нього; вона була наче скорпіоном, що ховає своє жало.	true
quotes_quote_onscreen_3856	Якщо ми живемо добре, тоі час також гарний. Які ми, такий і час.	true
quotes_quote_onscreen_2957	Нехай вони дізнаються, що Ви приїхали перш ніж зрозуміють, що Ви їдете.	true
quotes_quote_onscreen_3757	Саме гордість перетворила ангелів на дияволів. Саме покора робить людей ангелами.	true
quotes_quote_onscreen_2254	Ах! Полководці! Їх велика кількість не означає якість!	true
quotes_quote_onscreen_3654	Жоден спис не зашкодить тим, хто впевнений, що живе; а тих, хто точно помре, доля наздожене навіть у спокої.	true
quotes_quote_onscreen_3355	Постійне перебування на небезпеці породжує зневагу до неї.	true
quotes_quote_onscreen_3855	Привілеї небагатьох не утворюють законів для всіх.	true
quotes_quote_onscreen_2358	Закони мовчать під час війни.	true
quotes_quote_onscreen_2758	Який берег не знає нашої крові?	true
quotes_quote_onscreen_3258	Найкраще захищений від небезпек той, хто напоготові, навіть коли здається безпечним.	true
quotes_quote_onscreen_2559	Ви брили, Ви каміння, Ви гірші за безглузді речі! О Ви, черстві серця, Ви жорстокі люди Риму! Ви не знали Помпея?	true
quotes_quote_onscreen_2659	Справжню зневагу до загарбника проявляють у вчинках доблесті на бойовищі.	true
quotes_quote_onscreen_2182	До небезпеки завжди варто бути готовим.	true
quotes_quote_onscreen_2482	Не зневажайте смерть, а вітайте її, бо природа хоче цього, як і всього іншого.	true
quotes_quote_onscreen_3282	Звитяга перевершує кількість.	true
quotes_quote_onscreen_2283	Друг для всіх – нікому не друг.	true
quotes_quote_onscreen_3083	Усе може зіпсуватися, коли розум схильний до зла.	true
quotes_quote_onscreen_3383	Таке різноманіття споруд, що несуть воду з багатьох місць. Порівняйте це, будь ласка, з безглуздими пірамідами, або марними (хоч і декоративними) спорудами греків!	true
quotes_quote_onscreen_3483	Крадіжку, вбивство та ґвалтування вони оманливо називають Імперією. - і навіть там, де вони роблять пустелю, вони називають це миром.	true
quotes_quote_onscreen_3883	Бо школа граматики має першість: це найсправедливіша основа навчання, славна мати красномовства.	true
quotes_quote_onscreen_2780	Як ти, я був. Яким я є, таким і ти будеш.	true
quotes_quote_onscreen_2781	Мудрий капітан не пускає пасажирів на борт, поки вантаж не буде в інтрюмі.	true
quotes_quote_onscreen_2686	Набагато краще завжди мати міцне серце і терпіти свою частку зла, ніж постійно боятися того, що може статися.	true
quotes_quote_onscreen_2886	Усі дороги ведуть до Риму.	true
quotes_quote_onscreen_2387	Що посієш, те й пожнеш.	true
quotes_quote_onscreen_3287	Хто хоче миру, нехай готується до війни.	true
quotes_quote_onscreen_3687	Безпека держави – найвищий закон.	true
quotes_quote_onscreen_2284	Усі люди від природи прагнуть знань.	true
quotes_quote_onscreen_2584	Римляни, земляки, любі мої! Вислухайте мене за справи мої і мовчіть, щоб почути.	true
quotes_quote_onscreen_3184	Здобута річ радує менше, ніж шлях до неї.	true
quotes_quote_onscreen_3684	Слава Богу, за те що вважав мене гідним завершити цю роботу. Соломоне, перевершив тебе!	true
quotes_quote_onscreen_3784	Покаранням кожного безладного розуму є його власний розлад.	true
quotes_quote_onscreen_2985	Будинок, в якому немає книг, подібний до тіла, в якому немає душі	true
quotes_quote_onscreen_3385	Навіть боги підкоряються потребам.	true
quotes_quote_onscreen_2488	Кожен вчинок у своєму житті робіть так, ніби він останній.	true
quotes_quote_onscreen_3588	Смерть нічим не відрізняється від життя.	true
quotes_quote_onscreen_3888	Мало хто керується розумом, і небагато задоволені правильною метою.	true
quotes_quote_onscreen_2189	Спартанці запитують не скільки, а де вони.	true
quotes_quote_onscreen_2489	Людина повинна боятися не смерті, а боятися, що ніколи не почне жити.	true
quotes_quote_onscreen_2589	Оскільки він був доблесним, я шаную його; але оскільки він був честолюбним, я його вбив.	true
quotes_quote_onscreen_3889	Хто боїться смерті, той уже втратив життя.	true
quotes_quote_onscreen_2692	Силі немає місця там, де потрібна майстерність.	true
quotes_quote_onscreen_2393	Тільки сміливі радіють благородній і славній смерті.	true
quotes_quote_onscreen_2893	Рим був побудований не за один день.	true
quotes_quote_onscreen_3493	Ніщо так не засмучувало наші війська, як нестача припасів.	true
quotes_quote_onscreen_2290	Погані люди сповнені каяття.	true
quotes_quote_onscreen_2390	Із цим знаком переможеш.	true
quotes_quote_onscreen_2790	Я краще буду першим у маленькому селі в Галлії, ніж другим у Римі.	true
quotes_quote_onscreen_3190	Великі дощі зазвичай випадають після великих битв.	true
quotes_quote_onscreen_3790	Розум командує тілом, і воно йому підкорюється. Розум керуючи собою зустрічає опір.	true
quotes_quote_onscreen_2791	Війна дає право завойовникам нав'язувати будь-які умови переможеним.	true
quotes_quote_onscreen_2991	Здатність без честі марна.	true
quotes_quote_onscreen_3091	Сльози іноді мають всю вагу мови.	true
quotes_quote_onscreen_3291	Засідка, якщо її виявити та негайно оточити, погасить задумане лихо з лихвою.	true
quotes_quote_onscreen_3391	Безладний натовп - не більше армія, ніж купа будівельних матеріалів - будинок.	true
quotes_quote_onscreen_3791	Хто я без Тебе, як не мандрівник, що йде до власної загибелі?	true
quotes_quote_onscreen_2197	Сміливці — найсильніша оборонна вежа міста.	true
quotes_quote_onscreen_3097	Афінські чоловіки, я не маю багато часу для повчань, але для сміливих кілька слів так само корисні, як багато…	true
quotes_quote_onscreen_3197	Умійте слухати, і Ви отримаєте користь навіть від тих, хто говорить погано.	true
quotes_quote_onscreen_3297	Ворог більше страждає від дезертирства, ніж від бійні.	true
quotes_quote_onscreen_3397	Я знаю одне, що я нічого не знаю.	true
quotes_quote_onscreen_3897	Ті речі, які багатьом колишнім імператорам здавалися такими, що потребують виправлення, але які жоден із них не наважувався втілити в життя, ми вирішили здійснити зараз за допомогою Всемогутнього Бога.	true
quotes_quote_onscreen_2294	Ознакою освіченості є здатність розвивати думку, не приймаючи її.	true
quotes_quote_onscreen_2494	Те, що не добре для бджолиного вулика, не може бути корисним для бджіл.	true
quotes_quote_onscreen_3094	Шанс завжди сильний. Хай гачок твій завжди буде напоготові, навіть там, де найменше очікуєш, буде риба.	true
quotes_quote_onscreen_3594	Приємно, коли море високе і вітер розбиває хвилі, спостерігати з берега за боротьбою іншого.	true
quotes_quote_onscreen_3694	Нехай розтане Рим у Тібрі і впаде широка арка Імперії! Ось мій простір. Королівства глин, наша гнійна земля однаково годує звіра, як людину.	true
quotes_quote_onscreen_2395	Я знайшов Рим містом з цегли, а залишив його містом з мармуру.	true
quotes_quote_onscreen_3095	Я більше боюся наших власних помилок, ніж задумів наших ворогів.	true
quotes_quote_onscreen_3598	Глибокі рани, які завдає громадянське протистояння.	true
quotes_quote_onscreen_2599	Я волів би мати таких людей моїми друзями, ніж ворогами.	true
quotes_quote_onscreen_2799	Прийшов, побачив, переміг.	true
quotes_quote_onscreen_2899	Прийди і візьми!	true
