key	text	tooltip
#Loc;1;text/db/random_localisation_strings.loc		
random_localisation_strings_string_finances_vassal_income_breakdown_faction	%S	true
random_localisation_strings_string_building_construction_requires_main_slot_upgrade	Ви повинні спочатку перебудувати своє місто.	true
random_localisation_strings_string_sea_region_control_status_hostile	Ворожий	true
random_localisation_strings_string_siege_suffering_attrition	Залога вичерпала припасами, і тепер страждає від виснаження	true
random_localisation_strings_string_finances_tribute_income_breakdown_other	Від інших	true
random_localisation_strings_string_cancel_construction_confirmation	Ця будівля зводиться, Ви впевнені, що бажаєте її демонтувати?	true
random_localisation_strings_string_unit_stat_bonus_morale_superior	Чудовий моральний дух	true
random_localisation_strings_string_unit_stat_bonus_armour_improved	Покращена броня	true
random_localisation_strings_string_famous_battle_battle_of	Битва	true
random_localisation_strings_string_round_id_august	Серпень	true
random_localisation_strings_string_round_id_late_july	Кінець липня	true
random_localisation_strings_string_difficulty_level_4	Надто висок.	true
random_localisation_strings_string_difficulty_level_5	Легенд.	true
random_localisation_strings_string_difficulty_level_2	Нормал.	true
random_localisation_strings_string_difficulty_level_3	Висок.	true
random_localisation_strings_string_difficulty_level_1	Низьк.	true
random_localisation_strings_string_siege_turns_to_attrition	Ходи, що залишилися до того, як у залоги закінчиться провіянт:	true
random_localisation_strings_string_character_role_daughter	Дочка	true
random_localisation_strings_string_cannot_build_insufficient_funds	У Вас недостатньо коштів, щоб замовити це будівництво.	true
random_localisation_strings_string_StratHud_Building_Card_Recruit_Selection	Клацніть ЛКМ, щоб побудувати цю споруду, клацніть ПКМ, щоб отримати додаткову інформацію.	true
random_localisation_strings_string_finance_header_liege_lord	Володіння	true
random_localisation_strings_string_character_role_retainer	Наймит	true
random_localisation_strings_string_stats_clan_naval_ranked_games_won	text_rejected	true
random_localisation_strings_string_character_situation_conversion_catholic	Навернення провінції	true
random_localisation_strings_string_click_to_mark_current_selection_for_dismantling	Натисніть, щоб позначити споруду для знесення. Знесення споруди поверне частину коштів у Вашу скарбницю.	true
random_localisation_strings_string_opponent_accepts_surrender_title	Погоджуються здатися:	true
random_localisation_strings_string_replenish_prerequisites_not_met	Ви повинні мати можливість набирати такі типи місцевих загонів та мати достатньо коштів для поповнення цієї армії. Вартість:	true
random_localisation_strings_string_unknown_ship_state	Деякі дані цієї ескадрильї невідомі. Підійшовши ближче, можна отримати більше інформації.	true
random_localisation_strings_string_round_id_late_june	Кінець червня	true
random_localisation_strings_string_StratHudbutton_Construction_Site	Незабудована земля||Тут можна створити нові будівельні майданчики.	true
random_localisation_strings_string_mission_text_text_mis_activity_attain_fame_level_specific	PLACEHOLDER %d	true
random_localisation_strings_string_unit_upgrade_insufficient_funds	У Вашій скарбниці недостатньо коштів для оновлення цього загону.	true
random_localisation_strings_string_trade_node_tooltip_supply_to_other	поставлено до їхньої столиці	true
random_localisation_strings_string_resource_exporting_percentage_zero	Для експорту цих ресурсів потрібен торгівельний шлях.	true
random_localisation_strings_string_AUA_LOCKED_HEAVILY_DAMAGED	text_rejected	true
random_localisation_strings_string_stats_clan_land_ranked_games_lost	text_rejected	true
random_localisation_strings_string_mp_ready_error_invalid_army_index	Вибране військо вже зайняте. Будь ласка, виберіть інше, перш ніж почати.	true
random_localisation_strings_string_character_panel_loyalty_honour_negative	Негативні фактори	true
random_localisation_strings_string_player_stats_decisive_victories	Кількість вирішальних перемог	true
random_localisation_strings_string_fe_unit_card_tooltip_navy	Клацніть ЛКМ, щоб вибрати.\\nДвічі клацніть ЛКМ, щоб видалити.\\nНатисніть ПКМ, щоб отримати інформацію.||Картки загонів можна перетягнути в нове місце, щоб змінити їх порядок у фльоті.	true
random_localisation_strings_string_attacker_direction_south	Південь	true
random_localisation_strings_string_encourage_fleet	Підбадьорення||Деякі провідні човни можуть заохочувати інших в зоні їхнього впливу, збільшуючи їхній напад ближнього бою, вміння перезаряджання та влучність.||Після активації цієї здатності Вам доведеться почекати деякий час, перш ніж використати її знову.	true
random_localisation_strings_string_attacker_direction_north	Північ	true
random_localisation_strings_string_unknown_unit_state	Деякі дані цього загону невідомі. Підійшовши ближче, можна отримати більше інформації. Шпигуни мають більше шансів розпізнати деталі війська.	true
random_localisation_strings_string_round_id_early_may	Початок травня	true
random_localisation_strings_string_invalid_army_setup_local	Щось неправильно з Вашою добіркою військ.	true
random_localisation_strings_string_unit_stat_bonus_charge_superior	Чудовий напад	true
random_localisation_strings_string_trade_route_state_neutral	(Нейтральний)	true
random_localisation_strings_string_building_under_construction_damaged_cannot	Жодна недобудова не постраждала	true
random_localisation_strings_string_mp_ready_error_no_land_defender_for_coastal_battle	Захисник у битві на узбережжі повинен мати принаймні один наземний загін.	true
random_localisation_strings_string_morale_confident	Впевнені	true
random_localisation_strings_string_repair_selection	Ремонтуйте пошкоджені човни в цій вибірці. Вартість:	true
random_localisation_strings_string_sea_region_control_status_neutral	Нейтр.	true
random_localisation_strings_string_stats_clan_most_clan_map_regions_held_simultaneous	text_rejected	true
random_localisation_strings_string_FACTION_FOOD_FACTOR_ARMIES	Ворожі війська у Ваших провінціях	true
random_localisation_strings_string_siege_turns_to_surrender	\\nХодів, що залишилися до здачі:	true
random_localisation_strings_string_player_stats_mp_consecutive_land	Кількість послідовно виграних наземних битв	true
random_localisation_strings_string_diplomacy_button_cannot_hostage	text_rejected	true
random_localisation_strings_string_unit_generic_left_click	Клацніть ЛКМ, щоб вибрати	true
random_localisation_strings_string_no_path_available	Немає доступного шляху від місця збору загону до вербувальника.	true
random_localisation_strings_string_gfx_filtering_ani16x	Анізотр. 16x	true
random_localisation_strings_string_unit_stat_bonus_armour_exceptional	Виняткова броня	true
random_localisation_strings_string_round_id_early_december	Початок грудня	true
random_localisation_strings_string_expedition_cannot_trade	Експедиції не можуть торгувати	true
random_localisation_strings_string_network_error_join_failed	Не вдалося приєднатися до вибраної гри	true
random_localisation_strings_string_bribe_nonhostile_cancel	Скасувати	true
random_localisation_strings_string_network_error_host_failed	Не вдалося створити гру	true
random_localisation_strings_string_must_negotiate_with_master	Ви можете звернутися з цією пропозицією тільки до володаря цієї держави:	true
random_localisation_strings_string_error_twitch_login	Не вдалося ввійти на Twitch.tv. \\n\\nПеревірте правильність свого імені користувача та пароля.	true
random_localisation_strings_string_conversion_factor_events_christian	Останні події	true
random_localisation_strings_string_demo_save_disabled	Збереження тимчасово вимкнено.||Гра зберігатиметься автоматично протягом кампанії.	true
random_localisation_strings_string_cannot_reinforce_at_night	Ці війська не можуть бути підкріпленням під час нічної битви.	true
random_localisation_strings_string_setup_cost_high	text_rejected	true
random_localisation_strings_string_StratHudbutton_Damaged_Building	Пошкоджена будівля||Доки її не буде відремонтовано, зменшується її властивості, і її неможливо покращити. Вона  буде ремонтуватися повільно без додаткових витрат або можна її відремонтувати протягом одного ходу за гроші, натиснувши «Відремонтувати».	true
random_localisation_strings_string_character_role_candidate	Кандидат	true
random_localisation_strings_string_mission_issued_infiltrate	text_rejected	true
random_localisation_strings_string_unit_stat_bonus_morale_improved	Покращений моральний дух	true
random_localisation_strings_string_player_stats_campaign_naval_battles_won	Виграно морських битв в кампанії	true
random_localisation_strings_string_unit_stat_bonus_armour_superior	Чудова броня	true
random_localisation_strings_string_character_role_governor	Губернатор	true
random_localisation_strings_string_settlement_colon	Поселення:	true
random_localisation_strings_string_unit_concerned_recent_casualties	Нещодавно мали жертви	true
random_localisation_strings_string_ability_phase_mask_freeze_fatigue	Відключити втому	true
random_localisation_strings_string_no_slot_available	Немає вільних комірок	true
random_localisation_strings_string_stat_bonus_cavalry	Бонус проти кавалерії	true
random_localisation_strings_string_cancel_demolish_building_once_settled_expedition	Ця експедиція повинна завершити демонтаж цієї будівлі. Клацніть ЛКМ, щоб скасувати знесення.	true
random_localisation_strings_string_unit_stat_bonus_charge_improved	Покращений напад	true
random_localisation_strings_string_the_selected_item_may_not_be_dismantled	Вибраний елемент не можливо демонтувати.	true
random_localisation_strings_string_postbattle_public_order_reduction	Хисткість в провінції	true
random_localisation_strings_string_prebattle_popup_defection_04	Деякі з ворожих військ перейшли на Ваш бік, однак деякі з Ваших також перейшли на бік ворога і тепер будуть битися проти Вас!	true
random_localisation_strings_string_prebattle_popup_defection_02	Деякі з Ваших військ втекли і тепер будуть битися проти Вас!	true
random_localisation_strings_string_prebattle_popup_defection_03	Деякі з ворожих військ втекли і тепер приєднаються до Вас на бойовищі!	true
random_localisation_strings_string_prebattle_popup_defection_01	Дезертирство!	true
random_localisation_strings_string_finances_background_income	Базовий дохід	true
random_localisation_strings_string_fatigue_very_tired	Дуже втомлені	true
random_localisation_strings_string_StratHudbutton_Cannot_Recruit_Missionary1	У Вас уже є максимальна кількість місіонерів	true
random_localisation_strings_string_StratHudbutton_Cannot_Recruit_Missionary2	Ви не в змозі дозволити собі найняти цього агента. Вартість:	true
random_localisation_strings_string_StratHudbutton_Cannot_Recruit_Missionary3	Ви можете найняти лише одного місіонера на провінцію кожного ходу	true
random_localisation_strings_string_resource_long_term	Тривка співпраця	true
random_localisation_strings_string_diplomacy_undiscovered_clan_mon	Невідкрита держава	true
random_localisation_strings_string_victory_conditions_turns_to_hold	Утримуйте протягом %n ходів.	true
random_localisation_strings_string_unit_concerned_frightened_horses	Перелякані коні	true
random_localisation_strings_string_StratHudbutton_Naval_Cancel_Repair	Скасувати ремонт вибраних човнів. Відшкодування:	true
random_localisation_strings_string_MILITARY_FORCE_FOOD_FACTOR_RAIDING	Напад	true
random_localisation_strings_string_prebattle_legendary_cannot_save	Ви не можете зберегтися перед боєм на легендарній складності.	true
random_localisation_strings_string_TechTree_Tech_Available_Function_Tooltip	Клацніть ЛКМ, щоб дослідити цю технологію.	true
random_localisation_strings_string_character_situation_land_attack	Напади на суходолі	true
random_localisation_strings_string_mp_ready_error_no_units	Ви повинні вибрати деякі загони, перш ніж оголосити про готовність.	true
random_localisation_strings_string_mp_coop_partner_defeated	Ваш партнер за спільною грою зазнав поразки, зараз гра закінчиться.	true
random_localisation_strings_string_character_situation_requesting_allegiance	Запит на підданство	true
random_localisation_strings_string_character_situation_sea_defence	Морська оборона	true
random_localisation_strings_string_campaign_type_co_op_short	Спільна гра: коротка	true
random_localisation_strings_string_network_message_vac_player_kicked	залишає гру через помилку автентифікації VAC.	true
random_localisation_strings_string_dlc_purchase_title	Здобуті DLC	true
random_localisation_strings_string_error_legendary_save_load_disabled	Швидке збереження/завантаження вимкнено на легендарній складності	true
random_localisation_strings_string_power_category_1	Жахливий	true
random_localisation_strings_string_power_category_3	Сильний	true
random_localisation_strings_string_power_category_2	Могутній	true
random_localisation_strings_string_power_category_5	Слабкий	true
random_localisation_strings_string_power_category_4	Помірний	true
random_localisation_strings_string_power_category_6	Кволий	true
random_localisation_strings_string_FACTION_FOOD_FACTOR_HORDES	Орди у Ваших провінціях	true
random_localisation_strings_string_trade_agreement_tooltip_export_route_count	Залишилися морські експортні шляхи, у Вас: %d/%d; у них: %d/%d ||Це базується на торгівельних портах у провінції столиці.	true
random_localisation_strings_string_unit_stat_bonus_melee_exceptional	Винятковий ближній бій	true
random_localisation_strings_string_reduced_unit_limit_msg_sp	Ви зменшили максимальну кількість загонів, через що деякі були видалені з Вашої добірки.	true
random_localisation_strings_string_unit_encouraged_settlement_plaza	Ключова позиція	true
random_localisation_strings_string_gfx_ultra	Дуже висок.	true
random_localisation_strings_string_audio_provider_stereo_headphones	Стерео навушники	true
random_localisation_strings_string_town_factor_events	Події	true
random_localisation_strings_string_morale_1	Бунтівні	true
random_localisation_strings_string_morale_0	Повстання	true
random_localisation_strings_string_agent_help_cannot_sabotage_damaged_castle_gates	Ви не можете влаштувати диверсію воріт поселення, які вже пошкоджені.	true
random_localisation_strings_string_ability_change_formation_spacing	Розімкнути стрій||Розімкнутий стрій мінімізує втрати під сильним вогнем, але робить загін більш вразливим у ближньому бою та до наступу ворога.	true
random_localisation_strings_string_limited_unit_type	Кількість цих речей, якими Ви можете володіти, обмежена. Зараз у Вас %d з %d.	true
random_localisation_strings_string_player_is_mp_co_op_ally_and_cannot_attack	Неможливо атакувати Вашого союзника за спільною грою в мережі.	true
random_localisation_strings_string_technology_status_stolen	text_rejected	true
random_localisation_strings_string_fatigue_exhausted	Виснажені	true
random_localisation_strings_string_land_combatant_winning_big	Загін неухильно перемагає	true
random_localisation_strings_string_battle_title_olbia	Битва під Ольвією	true
random_localisation_strings_string_unit_concerned_outnumbered	Чисельність сил ворога	true
random_localisation_strings_string_network_error_join_failed_no_stats	Не вдалося приєднатися до гри: статистика гравця недоступна	true
random_localisation_strings_string_diplomacy_button_need_peace_with_other_allies_to_a	text_rejected	true
random_localisation_strings_string_character_panel_loyalty_honour_positive	Позитивні чинники	true
random_localisation_strings_string_player_stats_campaign_land_battles_lost	Поразок у битвах на землі в кампанії	true
random_localisation_strings_string_pre_battle_siege_equipment_totals_tooltip	Будівництво облогових засобів: %d\\nСтворено облогових засобів: %d	true
random_localisation_strings_string_decline_breaks_alliance_defender	Відмовитися (Ви скасуєте союз із захисником)	true
random_localisation_strings_string_round_id_early_september	Початок вересня	true
random_localisation_strings_string_player_stats_total_mp_naval_battles_won	Всього виграних морських битв в мережевій грі	true
random_localisation_strings_string_building_under_construction_damaged_repair	Натисніть тут, щоб відремонтувати незавершену споруду, щоб будівництво продовжилося.	true
random_localisation_strings_string_battle_victory_minor_close	Важка перемога||Ворог розбитий! Смерть і ганьба їхнім головам, проте ворожий меч міг би відтяти і Вашу голову!	true
random_localisation_strings_string_fe_unit_card_tooltip_minimal_naval	Клацніть ЛКМ, щоб вибрати. \\nНатисніть ПКМ, щоб отримати інформацію.||Картки можна перетягнути в нове місце, щоб змінити їх порядок у фльоті.	true
random_localisation_strings_string_stats_clan_number_of_active_seasons_since_creation	text_rejected	true
random_localisation_strings_string_error_chat_room_invalid	Помилка спілкування||Недійсна кімната спілкування.	true
random_localisation_strings_string_character_type_title_sonandheir	Син і спадкоємець	true
random_localisation_strings_string_unit_generic_right_click	Клацніть ПКМ для отримання додаткової інформації	true
random_localisation_strings_string_fe_recruitment_card_tooltip_category_clamp_reached	Ви не в змозі додати цей загін, оскільки одночасно можна використовувати лише одну облогову машину.	true
random_localisation_strings_string_unit_encouraged_settlement	Захищають місто	true
random_localisation_strings_string_stats_clan_naval_ranked_games_lost	text_rejected	true
random_localisation_strings_string_FACTION_FOOD_FACTOR_EDICTS	Едикти	true
random_localisation_strings_string_unit_concerned_discouraged_by_unit_ability	Послаблені здібності ворога	true
random_localisation_strings_string_stats_clan_current_highest_ranked_4v4_clan_team	text_rejected	true
random_localisation_strings_string_stats_clan_current_highest_ranked_3v3_clan_team	text_rejected	true
random_localisation_strings_string_stats_clan_current_highest_ranked_2v2_clan_team	text_rejected	true
random_localisation_strings_string_FACTION_FOOD_FACTOR_EVENTS	Події	true
random_localisation_strings_string_network_error_incompatible_data	Несумісні дані	true
random_localisation_strings_string_cancel_demolish_building	Цю будівлю буде розібрано, коли в кінці Вашого ходу. Клацніть ЛКМ, щоб скасувати знесення.	true
random_localisation_strings_string_cancel_demolish_building_once_expedition	Ця експедиція повинна завершити демонтаж цієї будівлі. Клацніть ЛКМ, щоб скасувати знесення.	true
random_localisation_strings_string_hudbutton_studying_name	Навчання:	true
random_localisation_strings_string_multiplayer_dialog_expire	Цей діалог закінчиться через:	true
random_localisation_strings_string_technology_status_available_no_facility	text_rejected	true
random_localisation_strings_string_character_role_deceased	Покійн.	true
random_localisation_strings_string_button_cancel_slot_instruction_inactive	Перед використанням цієї кнопки потрібно вибрати елемент.	true
random_localisation_strings_string_battle_time_limit	%d хв	true
random_localisation_strings_string_overwrite_title	Перезаписати файл?	true
random_localisation_strings_string_unit_stat_bonus_accuracy_superior	Чудова влучність	true
random_localisation_strings_string_opponent_refuses_surrender_title	Відмовляються здатися	true
random_localisation_strings_string_agent_help_str_request_allegiance_faction_leader_present	text_rejected	true
random_localisation_strings_string_faction_leader_tooltip_honour_5	text_rejected	true
random_localisation_strings_string_faction_leader_tooltip_honour_4	text_rejected	true
random_localisation_strings_string_faction_leader_tooltip_honour_6	text_rejected	true
random_localisation_strings_string_faction_leader_tooltip_honour_1	text_rejected	true
random_localisation_strings_string_faction_leader_tooltip_honour_3	text_rejected	true
random_localisation_strings_string_faction_leader_tooltip_honour_2	text_rejected	true
random_localisation_strings_string_network_error_host_disconnected	Власник (хост) залишив гру.	true
random_localisation_strings_string_mission_reward_grant_unit	Надає загін:	true
random_localisation_strings_string_gfx_filtering_tri	Трилінійний	true
random_localisation_strings_string_character_situation_entertaining_nobles	Розваги аристократії	true
random_localisation_strings_string_opponent_demands_surrender_title	Вимагають здатися	true
random_localisation_strings_string_wealth_category_4	Середні	true
random_localisation_strings_string_wealth_category_5	Бідні	true
random_localisation_strings_string_REGION_FOOD_FACTOR_RAIDING	Напад	true
random_localisation_strings_string_wealth_category_6	Знедолені	true
random_localisation_strings_string_wealth_category_1	Захоплюючі	true
random_localisation_strings_string_wealth_category_2	Багаті	true
random_localisation_strings_string_wealth_category_3	Заможні	true
random_localisation_strings_string_cannot_recruit_insufficient_funds	У Вас недостатньо коштів, щоб завербувати цей загін.	true
random_localisation_strings_string_player_stats_campaign_naval_battles_lost	Поразок в морських битвах кампанії	true
random_localisation_strings_string_battle_defeat_minor_close	Незначна поразка||Перемога вислизнула з Ваших рук. Ворог здолав Вас ледь не програвши.	true
random_localisation_strings_string_setup_error_title	text_rejected	true
random_localisation_strings_string_stats_clan_current_clan_members	text_rejected	true
random_localisation_strings_string_diplomacy_button_need_alliance_to_request_alliance	Немає союзу який можна розірвати.	true
random_localisation_strings_string_unit_concerned_extended_casualties	Нещодавно мали жертви	true
random_localisation_strings_string_player_stats_most_men_lost	Макс. вояків страчено в бою	true
random_localisation_strings_string_StratHudbutton_Cannot_Embark/Disembark0	Неможливо сісти в човен/зійти на берег	true
random_localisation_strings_string_StratHudbutton_Cannot_Embark/Disembark1	Ця земля недоступна.	true
random_localisation_strings_string_StratHudbutton_Cannot_Embark/Disembark2	Ця фльота занадто далеко від берега чи порту.	true
random_localisation_strings_string_tacmap_inactive_filter_expedition	Недоступно для експедицій	true
random_localisation_strings_string_character_details_rank_5	Поточний ранг: 5 (макс. 6)||Ранг персонажа показує його загальний рівень майстерності, кожна зірка представляє один рівень рангу.||Нові рівні рангу досягаються шляхом набуття досвіду. З кожним новим рівнем Ви зможете вивчати додаткові  вміння.	true
random_localisation_strings_string_character_details_rank_4	Поточний ранг: 4 (макс. 6)||Ранг персонажа показує його загальний рівень майстерності, кожна зірка представляє один рівень рангу.||Нові рівні рангу досягаються шляхом набуття досвіду. З кожним новим рівнем Ви зможете вивчати додаткові  вміння.	true
random_localisation_strings_string_character_details_rank_6	Поточний ранг: 6 (макс. 6)||Ранг персонажа показує його загальний рівень майстерності, кожна зірка представляє один рівень рангу.||Нові рівні рангу досягаються шляхом набуття досвіду. З кожним новим рівнем Ви зможете вивчати додаткові  вміння.	true
random_localisation_strings_string_character_details_rank_1	Поточний ранг: 1 (макс. 6)||Ранг персонажа показує його загальний рівень майстерності, кожна зірка представляє один рівень рангу.||Нові рівні рангу досягаються шляхом набуття досвіду. З кожним новим рівнем Ви зможете вивчати додаткові  вміння.	true
random_localisation_strings_string_character_details_rank_3	Поточний ранг: 3 (макс. 6)||Ранг персонажа показує його загальний рівень майстерності, кожна зірка представляє один рівень рангу.||Нові рівні рангу досягаються шляхом набуття досвіду. З кожним новим рівнем Ви зможете вивчати додаткові  вміння.	true
random_localisation_strings_string_character_details_rank_2	Поточний ранг: 2 (макс. 6)||Ранг персонажа показує його загальний рівень майстерності, кожна зірка представляє один рівень рангу.||Нові рівні рангу досягаються шляхом набуття досвіду. З кожним новим рівнем Ви зможете вивчати додаткові  вміння.	true
random_localisation_strings_string_campaign_type_long	Тривала кампанія	true
random_localisation_strings_string_network_message_confirm_quit_host	Ви дійсно бажаєте вийти? Гра закінчиться для всіх.	true
random_localisation_strings_string_StratHudbutton_Naval_Repair_Not_Required	Для вибраних човнів ремонт не потрібний.	true
random_localisation_strings_string_finance_header_diplomacy	Дипломатія	true
random_localisation_strings_string_mp_ready_error_ai_no_siege_units	Гравці зі штучним інтелектом повинні мати кілька піхотних або артилерійських загонів, здатних атакувати укріплення.	true
random_localisation_strings_string_finances_tribute_income_breakdown_faction	%S (залишилося %d ходів)	true
random_localisation_strings_string_time_hours	год.	true
random_localisation_strings_string_player_stats_enemy_generals_killed	Вбито ворожих полководців	true
random_localisation_strings_string_unit_stat_bonus_charge_exceptional	Винятковий наступ	true
random_localisation_strings_string_conversion_factor_state_religion_christian	text_rejected	true
random_localisation_strings_string_diplomacy_button_need_war_to_request_peace	text_rejected	true
random_localisation_strings_string_battle_victory_major_close	Важка перемога||Ворог майже переміг Вас, але Ви вирвали перемогу! Загиблі вороги тому свідчення!	true
random_localisation_strings_string_MILITARY_FORCE_FOOD_FACTOR_RIVALRY	Суперництво	true
random_localisation_strings_string_round_id_september	Вересень	true
random_localisation_strings_string_TechTree_Tech_Unavailable_Function_Tooltip	Не можливо. Ви не виконали будівельні чи технологічні вимоги.	true
random_localisation_strings_string_campaign_radar_sort_by_speciality	Сортувати за спеціальністю	true
random_localisation_strings_string_stats_clan_clan_total_ranked_game_losses	text_rejected	true
random_localisation_strings_string_StratHudbutton_demolish	Знесення будівлі	true
random_localisation_strings_string_audio_provider_5_1	5.1, роздільн.	true
random_localisation_strings_string_audio_provider_6_1	6.1, роздільн.	true
random_localisation_strings_string_audio_provider_7_1	7.1, роздільн.	true
random_localisation_strings_string_audio_provider_8_1	8.1, роздільн.	true
random_localisation_strings_string_audio_provider_4_0	4.0, роздільн.	true
random_localisation_strings_string_character_situation_land_amphibious_attack	Битви на узбережжі	true
random_localisation_strings_string_player_stats_generals_lost	Втрачено полководців	true
random_localisation_strings_string_unit_concerned_fatigue_very_tired	Дуже втомлені	true
random_localisation_strings_string_auto_save_filename	auto_save	true
random_localisation_strings_string_FACTION_FOOD_FACTOR_RECENT_BATTLES	Спустошення від битв	true
random_localisation_strings_string_cannot_build_tech_required	Перш ніж будувати цю споруду, треба дослідити необхідну технологію.	true
random_localisation_strings_string_effect_bundle_target_local	Провінція:	true
random_localisation_strings_string_round_id_early_november	Початок листопада	true
random_localisation_strings_string_unit_concerned_surprised	Здивовані виявленим ворогом	true
random_localisation_strings_string_player_stat_battles_lost	Поразки у битвах	true
random_localisation_strings_string_technology_tooltip_stealing_functionality	Клацніть ЛКМ, щоб спробувати вкрасти, клацніть ПКМ, щоб отримати додаткову інформацію.	true
random_localisation_strings_string_ability_phase_mask_poison	Отрута	true
random_localisation_strings_string_fe_unit_card_tooltip_no_dupe_naval	Клацніть ЛКМ, щоб вибрати.\\nДвічі клацніть ЛКМ, щоб видалити.||Картки загонів можна перетягнути в нове місце, щоб змінити їх порядок у фльоті.	true
random_localisation_strings_string_predicted_with_units_added	передбачено, якщо вибрані загони це залога	true
random_localisation_strings_string_captive_option_title_kill	Вбити полонених	true
random_localisation_strings_string_victory_conditions_mp_co_op_long	Захопіть і утримуйте %n провінцій разом зі своїм союзником за спільною грою, і один з Вас повинен володіти вказаним провінціями.	true
random_localisation_strings_string_technology_status_available_no_researcher	text_rejected	true
random_localisation_strings_string_fe_unit_card_tooltip_land	Клацніть ЛКМ, щоб вибрати.\\nДвічі клацніть ЛКМ, щоб видалити.\\nНатисніть ПКМ, щоб отримати інформацію.||Картки загонів можна перетягнути в нове місце, щоб змінити їх порядок у війську.	true
random_localisation_strings_string_character_situation_subterfuge_sabotage_building	Саботаж при будівництві	true
random_localisation_strings_string_religion_factor_in_decline	У занепаді	true
random_localisation_strings_string_religion_factor_increasing	Зростає	true
random_localisation_strings_string_unit_stat_bonus_morale_exceptional	Винятковий моральний дух	true
random_localisation_strings_string_agent_help_string_request_allegiance_major_faction	text_rejected	true
random_localisation_strings_string_character_situation_entertaining_generals	Розваги полководців	true
random_localisation_strings_string_gdp_poor_fertility_bonus	Особливість держави	true
random_localisation_strings_string_battle_defeat_major_close	Незначна поразка||Ех! Ворог переміг Вас, але Ваші відважні зусилля далися йому взнаки.	true
random_localisation_strings_string_at_peace	У мирі	true
random_localisation_strings_string_unit_stat_bonus_accuracy_improved	Покращена влучність	true
random_localisation_strings_string_character_situation_land_ambush	Засідки	true
random_localisation_strings_string_morale_shattered	Розбиті	true
random_localisation_strings_string_stat_can_target_buildings	Може пошкодити будівлі	true
random_localisation_strings_string_diplomacy_button_need_peace_to_request_war	text_rejected	true
random_localisation_strings_string_character_situation_subterfuge_field_scout	Розвідка	true
random_localisation_strings_string_dlc_purchase_body	Дякуємо Вам! Перезапустіть Total War: ATTILA, щоб завантажити та відтворити цей пакет DLC.	true
random_localisation_strings_string_fe_unit_card_tooltip_minimal_land	Клацніть ЛКМ, щоб вибрати. \\nЩоб отримати інформацію, клацніть ПКМ.||Картка можна перетягнути в нове місце, щоб змінити порядок у війську.	true
random_localisation_strings_string_round_id_early_february	Початок лютого	true
random_localisation_strings_string_network_error_join_failed_game_not_found	Не вдалося приєднатися до гри: гру не знайдено	true
random_localisation_strings_string_stat_base_value	Базове значення	true
random_localisation_strings_string_character_type_title_son	Син	true
random_localisation_strings_string_player_stats_best_streak	Найкраща серія	true
random_localisation_strings_string_skill_next_level	Наступний рівень:	true
random_localisation_strings_string_morale_impetuous	Бурхливі	true
random_localisation_strings_string_region_specialty_holy_site	text_rejected	true
random_localisation_strings_string_stats_clan_land_ranked_games_won	text_rejected	true
random_localisation_strings_string_win_chance_high	Висок.	true
random_localisation_strings_string_trade_route_state_player	(Ваш)	true
random_localisation_strings_string_StratHudbutton_cannot_repairShip_noport	Не можливо відремонтувати||Ви можете ремонтувати човни лише в порту.	true
random_localisation_strings_string_network_message_player_left_end	вийшов з гри. Гра закінчиться.	true
random_localisation_strings_string_finance_header_military	Огляд війська	true
random_localisation_strings_string_trade_route_tooltip_local_neutral	(спільне з іншими)	true
random_localisation_strings_string_gfx_med	Середн.	true
random_localisation_strings_string_Campaign_button_end_turn_spring	Весна	true
random_localisation_strings_string_nav_not_in_combat	Не в бою	true
random_localisation_strings_string_date_bc	до н.е.	true
random_localisation_strings_string_food_consumption	Споживання	true
random_localisation_strings_string_MILITARY_FORCE_FOOD_FACTOR_UNITS	Сили	true
random_localisation_strings_string_recruitment_tab	Вербування	true
random_localisation_strings_string_network_message_player_dropped_end	залишає гру. Гра закінчиться.	true
random_localisation_strings_string_land_combatant_losing_big	Загін стрімко програє	true
random_localisation_strings_string_warning_graphics_upgrade	Деякі налаштування можуть бути застосовані лише під час наступного запуску кампанії чи битви. Продовжити?	true
random_localisation_strings_string_Enlightenment_Bar	text_rejected	true
random_localisation_strings_string_hudbutton_studying_turns_until_completion	Ходів до завершення:	true
random_localisation_strings_string_cancel_recruitment_confirmation	Цей загін перебуває в процесі набору. Ви впевнені, що бажаєте скасувати його набір?	true
random_localisation_strings_string_trade_route_tooltip_local_enemy	(спільне з ворогом)	true
random_localisation_strings_string_defender	Захисник	true
random_localisation_strings_string_multiplayer_play_battle	Грати в битві	true
random_localisation_strings_string_ability_release_animals	Випустити тварин||Випустіть бойових тварин! Тварин можна звільнити, лише коли Ви підійдете достатньо близько до ворога, і вони атакуватимуть найближчий до них загін.	true
random_localisation_strings_string_stat_base_damage	Базова шкода	true
random_localisation_strings_string_ability_naval_fire_at_will	Почати/припинити вогонь||Якщо припинити стріляти, вибраний човен не стріляти доки Ви знову йому не накажете.	true
random_localisation_strings_string_Naval_Bar	Фльота	true
random_localisation_strings_string_adjecency_points	суміжні точки	true
random_localisation_strings_string_trade_status_tooltip_can	Може торгувати	true
random_localisation_strings_string_queued_building_blocked_by_stance	Орда повинна осісти, щоб завершити будівництво цієї споруди. Клацніть ЛКМ, щоб видалити споруду з черги, клацніть ПКМ, щоб отримати додаткову інформацію.	true
random_localisation_strings_string_undecided	Байдуже	true
random_localisation_strings_string_stats_clan_current_clan_map_rank	text_rejected	true
random_localisation_strings_string_morning	Ранок	true
random_localisation_strings_string_file_load_failed	Не вдалося завантажити	true
random_localisation_strings_string_error_chat_room_connection_failure	Помилка спілкування||Не вдалося підключитися до кімнати спілкування.	true
random_localisation_strings_string_campaign_autoresolver_tooltip_stance_land_balanced	При використанні збалансованої бойової стійки загони не отримають бонусів або покарань.	true
random_localisation_strings_string_character_situation_land_defence	Захист на суходолі	true
random_localisation_strings_string_trade_route_state_shared	(Спільний)	true
random_localisation_strings_string_army_trapped_in_enemy_ZOC	Це військо знаходиться в зоні контролю ворога і не може рухатися. Атака ворога - єдиний вихід.	true
random_localisation_strings_string_FACTION_PROVINCE_FOOD_FACTOR_BUILDINGS_IN_REGIONS	Споруди	true
random_localisation_strings_string_event_log_battle_victory_heroic_crushing	Героїчна Перемога	true
random_localisation_strings_string_agent_recruitment_insufficient_dev_points	[[col:red]]У Вас недостатньо надлишку населення, щоб створити нову орду.[[/col]]	true
random_localisation_strings_string_gfx_off	Вимк.	true
random_localisation_strings_string_predicted	Передбачення	true
random_localisation_strings_string_importing	Імпорт	true
random_localisation_strings_string_capital	Столиця держави	true
random_localisation_strings_string_exporting	Експорт	true
random_localisation_strings_string_date_ad	н.е.	true
random_localisation_strings_string_delayed	Затримується	true
random_localisation_strings_string_StratHudButton_Cannot_Recruit_Unit11	Немає очок вербування	true
random_localisation_strings_string_StratHudbutton_Cannot_Recruit_Unit10	Ви не маєте необхідного ресурсу для вербування цього загону.	true
random_localisation_strings_string_level_level_level_level	Рівень	true
random_localisation_strings_string_demo_battle_unavailable	Ця опція обмежена ключовими битвами в демоверсії. Виберіть самочинну битву.	true
random_localisation_strings_string_commerce_raiding	Рейдерство на торгівельних шляхах:	true
random_localisation_strings_string_unit_encouraged_inspired_by_unit_ability	Натхненні здібностями	true
random_localisation_strings_string_player_stats_battles_drawn	Битв без переможців	true
random_localisation_strings_string_Cannot_reinforce_artillery	Облогові машини не можуть вступати в бій як підкріплення	true
random_localisation_strings_string_mission_issued_research_technology	Досліджувати технологію:	true
random_localisation_strings_string_increasing	Поліпшується	true
random_localisation_strings_string_maximum_permitted_amount_of_this_unit_type_reached	Досягнуто максимально дозволеної кількості цього типу загонів	true
random_localisation_strings_string_trade_agreement_tooltip_sea_routes	Морський торгівельний шлях з’єднає дві Ваші столиці.	true
random_localisation_strings_string_trade_lost	Не експортується. Вдоскональте свої порти, щоб заробити більше коштів, експортуючи ці товари.	true
random_localisation_strings_string_trade_post	Торговий пост	true
random_localisation_strings_string_Unit_Card_Generic_Function	Клацніть ЛКМ, щоб вибрати, клацніть ПКМ, щоб отримати додаткову інформацію	true
random_localisation_strings_string_postbattle_money_gained	Зароблено грошей	true
random_localisation_strings_string_network_error_internal_controller_disconnection	Відімкнуто від мережевої служби	true
random_localisation_strings_string_agent_help_string_bribe_capital	text_rejected	true
random_localisation_strings_string_Cancelled	Скасувати	true
random_localisation_strings_string_gunners	text_rejected	true
random_localisation_strings_string_unit_card_lost_general_disbanded	Полководця вбито, а його загін розформовано.	true
random_localisation_strings_string_error_chat_command_failed	Недійсна команда спілкування	true
random_localisation_strings_string_trade_agreement_tooltip_embargoed	Ембарго перешкоджає торгівельній угоді	true
random_localisation_strings_string_December	text_rejected	true
random_localisation_strings_string_siege_tab	Облога	true
random_localisation_strings_string_skills_num_points	очки до	true
random_localisation_strings_string_blockaded	В блокаді	true
random_localisation_strings_string_character_situation_cunning_bribe	Хабарництво	true
random_localisation_strings_string_prebattle_reinforcing_army	Посилення війська	true
random_localisation_strings_string_technology_status_being_researched	text_rejected	true
random_localisation_strings_string_network_error_host	Не вдалося створити гру	true
random_localisation_strings_string_agent_help_string_high_opposing_religion	text_rejected	true
random_localisation_strings_string_unit_encouraged_inspired	Підбадьоренні загоном поряд	true
random_localisation_strings_string_agent_help_string_high_security_building	Ця будівля дуже захищена, що ускладнює диверсії.	true
random_localisation_strings_string_network_message_no_clients_left	Гравець вийшов з гри	true
random_localisation_strings_string_multiplayer_autoresolve	Автоматичне вирішення	true
random_localisation_strings_string_desolate	Безлюдно	true
random_localisation_strings_string_battle_invalid_ship_docking_point	Інший човен вже прямує до цього пункту призначення. Доведеться шукати альтернативне місце для сходження на берег.	true
random_localisation_strings_string_October	text_rejected	true
random_localisation_strings_string_Scupper	Затопити човен||Затопити невикористані човни, щоб заощадити витрати на утримання.	true
random_localisation_strings_string_building_construction_blocked_by_character	Неможливо розширити. Ви повинні переконатися, що у Вас є будівля в попередній комірці, вона не зруйнована, і переконайтеся, що поблизу немає персонажів, які блокують розширення.	true
random_localisation_strings_string_end_migration_tooltip_expedition	Якщо Ви окупуєте це поселення, Ваша експедиція завершиться.	true
random_localisation_strings_string_mp_ready_error_battle_type_desync	Вибраний тип битви не відповідає вибраній карті.	true
random_localisation_strings_string_mission_reward_prestige	Пошана	true
random_localisation_strings_string_mission_reward_naval_experience	Досвід для всіх морських загонів	true
random_localisation_strings_string_attacker_direction_east	Схід	true
random_localisation_strings_string_attacker_direction_west	Захід	true
random_localisation_strings_string_character_situation_zeal_demoralise_army	Деморалізація війська	true
random_localisation_strings_string_unit_replacement_string	заміняє	true
random_localisation_strings_string_food_production	Виробництво	true
random_localisation_strings_string_campaign_type_one_vs_one	Віч-на-віч	true
random_localisation_strings_string_destroy_transported_title	Розформування загонів	true
random_localisation_strings_string_Classic	Наземна битва	true
random_localisation_strings_string_finance_header_recruitment	Вербування	true
random_localisation_strings_string_player_stat_miles_covered_campaign	Милі, що здолали Ваші армії та фльоти	true
random_localisation_strings_string_agent_recruitment_click_to_recruit	Натисніть, щоб завербувати цього агента в цьому поселенні.	true
random_localisation_strings_string_diplomacy_button_cannot_request_join_war_warring_a	text_rejected	true
random_localisation_strings_string_pre-battle_multiplayer_undecided	Байдуже	true
random_localisation_strings_string_ability_board_ship	Абордувати	true
random_localisation_strings_string_fe_unit_card_tooltip_no_dupe_land	Клацніть ЛКМ, щоб вибрати.\\nДвічі клацніть ЛКМ, щоб видалити.||Картки загонів можна перетягнути в нове місце, щоб змінити їх порядок у війську.	true
random_localisation_strings_string_resource_importing_from	Імпорт з:	true
random_localisation_strings_string_opponent_accepts_surrender_body	Захисники склали зброю на Вашу вимогу!	true
random_localisation_strings_string_agent_help_string_family_member	Ціль добре захищена, тому буде важко вбити.	true
random_localisation_strings_string_neutral	Нейтр.	true
random_localisation_strings_string_Married	text_rejected	true
random_localisation_strings_string_imperium	Імперіум	true
random_localisation_strings_string_damaged	Пошкоджено	true
random_localisation_strings_string_retreat	Відступити	true
random_localisation_strings_string_marines	text_rejected	true
random_localisation_strings_string_manoeuverability_medium	Середн.	true
random_localisation_strings_string_stats_clan_current_highest_ranked_solo_clan_mbr_na	text_rejected	true
random_localisation_strings_string_audio_provider_srs_circle_surround	SRS Circle	true
random_localisation_strings_string_mission_reward_enable_unit	Дозволяє вербувати:	true
random_localisation_strings_string_ability_skirmish	Режим перестрілки||У режимі перестрілки загони будуть триматися на безпечній відстані від ворога. Тактику перестрілки можна застосувати, щоб уповільнити наступ ворога або відвернути певні загони. Загони стрільців вразливі до нападів кавалерії.	true
random_localisation_strings_string_chat_prefix_team	[команді]	true
random_localisation_strings_string_Construction_site	Будівельний майданчик	true
random_localisation_strings_string_trade_route_tooltip_enemy	(ворог)	true
random_localisation_strings_string_afternoon	Післяобідня пора	true
random_localisation_strings_string_abandon_tooltip	Натисніть, щоб залишити це поселення наступного ходу.\\n\\n[[col:green]]Це принесе %d прибутку.[[/col]]\\n\\n[[col:red]]Громадський порядок у Вашій державі погіршиться.[[/col]]	true
random_localisation_strings_string_effect_bundle_from_event	Подія:	true
random_localisation_strings_string_fe_recruitment_card_tooltip_land	Клацніть ЛКМ, щоб вибрати.\\nНатисніть ПКМ, щоб отримати інформацію.\\nДвічі клацніть ЛКМ або перетягніть, щоб додати.	true
random_localisation_strings_string_mp_ready_error_overspend	Неможливо почати, оскільки гравець витратив занадто багато на облаштування свого війська.	true
random_localisation_strings_string_producing	Виробництво	true
random_localisation_strings_string_error_leaderboard_search	text_rejected	true
random_localisation_strings_string_advisor	Радник	true
random_localisation_strings_string_confirm_delete_msg	Буде видалено всі вибрані файли. Продовжити?	true
random_localisation_strings_string_stance_food_stolen	Вкрадені їжі: %n  із спожитої	true
random_localisation_strings_string_action_result_type_success	Успіх	true
random_localisation_strings_string_trade_status_tooltip_value	\\nПоточна вартість:	true
random_localisation_strings_string_win_chance_none	Ні	true
random_localisation_strings_string_REGION_FOOD_FACTOR_RECENT_BATTLE	Спустошення від битв	true
random_localisation_strings_string_StratHudbutton_cannot_enlist_full	Неможливо призначити полководця||У Вас уже є максимальна кількість полководців.	true
random_localisation_strings_string_sanitation	Санітарія	true
random_localisation_strings_string_famous_battle_victory_over	Перемога над:	true
random_localisation_strings_string_campaign_ministers_effectiveness_effect	%+n до рівня керування міністрів	true
random_localisation_strings_string_FACTION_PROVINCE_FOOD_FACTOR_POOR_FERTILITY_BONUS	Особливість держави	true
random_localisation_strings_string_player_stats_campaigns_completed	Кампаній завершено	true
random_localisation_strings_string_mission_issued_make_peace	Укласти мир:	true
random_localisation_strings_string_recruitment_unavailable	Цей загін недоступний з наступних причин:	true
random_localisation_strings_string_trade_node_tooltip_supply_to_you	поставлено до Вашої столиці	true
random_localisation_strings_string_gfx_low	Низьк.	true
random_localisation_strings_string_gfx_custom	На вибір	true
random_localisation_strings_string_right_click_info	Клацніть ПКМ для отримання додаткової інформації.	true
random_localisation_strings_string_ping_none	Немає позначки	true
random_localisation_strings_string_finance_header_expenses	Витрати	true
random_localisation_strings_string_morale_fighting_to_death	Б'ються на смерть	true
random_localisation_strings_string_REGION_FOOD_FACTOR_HORDES	Орди в цьому регіоні	true
random_localisation_strings_string_allied_mencount	Кількість союзників	true
random_localisation_strings_string_captive_option_description_kill	Не залишати нікого в живих! Вбивство кожного з тих, хто вижив, може задовольнити жагу крові, але Ваш ворог і їхні союзники запам'ятають це.\\n\\nПроте ворог Вашого ворога буде вдячний Вам за це.	true
random_localisation_strings_string_finances_commerce_raiding_income	Від нападу на торгівельні шляхи	true
random_localisation_strings_string_region_specialty_philosophical_tradition	text_rejected	true
random_localisation_strings_string_Campaign_button_end_turn_summer	Літо	true
random_localisation_strings_string_tile_upgrade_none	Ні	true
random_localisation_strings_string_town_commercial	Селище (Торгівельний центр)	true
random_localisation_strings_string_campaign_type_co_op_long	Спільна гра: довга	true
random_localisation_strings_string_quick_battle_fail	Не вдалося підключитися до швидкого бою	true
random_localisation_strings_string_region_specialty_horses	text_rejected	true
random_localisation_strings_string_damaged_building	Пошкоджена будівля||Доки її не буде відремонтовано, зменшується її властивості, і її неможливо покращити. Вона  буде ремонтуватися повільно без додаткових витрат або можна її відремонтувати протягом одного ходу за гроші, натиснувши «Відремонтувати».	true
random_localisation_strings_string_FACTION_PROVINCE_FOOD_FACTOR_TECHNOLOGIES	Технології	true
random_localisation_strings_string_FACTION_PROVINCE_FOOD_FACTOR_CHARACTERS	Персонажі	true
random_localisation_strings_string_finances_tribute_income	text_rejected	true
random_localisation_strings_string_formatted_minutes_plural	%d хв	true
random_localisation_strings_string_stats_clan_current_highest_ranked_solo_clan_member	text_rejected	true
random_localisation_strings_string_mission_objectives	Ціль:	true
random_localisation_strings_string_mouse_over	Під вказівником	true
random_localisation_strings_string_victory_conditions_mp_co_op_short	Захопіть і утримуйте %n провінцій разом зі своїм союзником за спільною грою, і один з Вас повинен володіти вказаним провінціями.	true
random_localisation_strings_string_StratHudbutton_Naval_Repair_No_Selection	Виберіть пошкоджені човни, щоб відремонтувати.	true
random_localisation_strings_string_military_force_legacy_name_garrison_army	Військо залоги	true
random_localisation_strings_string_influence	Вплив:	true
random_localisation_strings_string_round_id_january	Січень	true
random_localisation_strings_string_StratHudbutton_cannot_navy_repair_nocash	Неможливо відремонтувати||У Вас недостатньо коштів.||Розформуйте невикористані загони або збільште податки, щоб зібрати кошти.	true
random_localisation_strings_string_military_force_legacy_name_transport_fleet	Вантажна фльота	true
random_localisation_strings_string_quick_save	Швидке збереження	true
random_localisation_strings_string_round_id_december	Грудень	true
random_localisation_strings_string_function_construction_hud	Клацніть ЛКМ, щоб вибрати, клацніть ПКМ, щоб отримати додаткову інформацію.	true
random_localisation_strings_string_recruitment_from	Цей загін може бути набраний з:	true
random_localisation_strings_string_network_error_join_failed_error	Не вдалося приєднатися до гри: невизначена помилка	true
random_localisation_strings_string_save_fail	Не вдалося зберегти	true
random_localisation_strings_string_upload_complete	Завантаження завершено	true
random_localisation_strings_string_army_tab	Огляд війська	true
random_localisation_strings_string_whisper	Особисте повідомлення	true
random_localisation_strings_string_unlimited	Необмеж.	true
random_localisation_strings_string_cancel_recruitment_header	Скасувати вербування	true
random_localisation_strings_string_will_lose_at_end	Якщо час сплине, Ви отримаєте поразку	true
random_localisation_strings_string_Children	Діти:	true
random_localisation_strings_string_fe_recruitment_card_tooltip_naval	Клацніть ЛКМ, щоб вибрати.\\nНатисніть ПКМ, щоб отримати інформацію.\\nДвічі клацніть ЛКМ або перетягніть, щоб додати.	true
random_localisation_strings_string_decreasing	Погіршується	true
random_localisation_strings_string_load_fail	Не вдалося завантажити	true
random_localisation_strings_string_character_situation_cunning_oversee_army	Нагляд за військом	true
random_localisation_strings_string_skills_requires	Необхідно	true
random_localisation_strings_string_ability_dismount	Злізти/сісти верхи||Було б гарною ідеєю зіскочити з коней, якщо Вам потрібно битися із списоносцями.	true
random_localisation_strings_string_region_specialty_smithing	text_rejected	true
random_localisation_strings_string_Campaign_button_end_turn_winter	Зима	true
random_localisation_strings_string_technology_tooltip_stealing_numeric_info	Імовірність успіху:	true
random_localisation_strings_string_dlc_menu_button_offline	Ви повинні бути в мережі, щоб переглядати пакети DLC.	true
random_localisation_strings_string_diplomacy_button_other_clan_no_alliances_to_break	text_rejected	true
random_localisation_strings_string_limited	Обмеж.	true
random_localisation_strings_string_player_stats_ships_lost	Втрачено човнів	true
random_localisation_strings_string_agent_help_string_request_allegiance_own_religion	text_rejected	true
random_localisation_strings_string_infrastructure_tab	Інфраструктура	true
random_localisation_strings_string_land_not_in_combat	Не в бою	true
random_localisation_strings_string_no	Ні	true
random_localisation_strings_string_stance_food_consumption	Спожито їжі: %n з місцевого регіону	true
random_localisation_strings_string_agent_cannot_act_settlement_full	У цьому поселенні вже є максимальна кількість агентів.	true
random_localisation_strings_string_network_message_desynch	Не вдалося завантажити	true
random_localisation_strings_string_January	text_rejected	true
random_localisation_strings_string_recharge_change	Час відновлення здатності	true
random_localisation_strings_string_ability_abandon_artillery_engines	Кинути облогові машини||Ваш загін покине облогові машини.	true
random_localisation_strings_string_famous_battle_defeated_by	Поразка від:	true
random_localisation_strings_string_captive_option_description_enslave	Беріть бажаючих воювати до свого війська, поповнюючи свої лави\\n\\nОднак їхня недосвідченість у Ваших військах вплине на майстерність Вашої війська.	true
random_localisation_strings_string_technology_bonuses_tooltip	Швидкість дослідження:	true
random_localisation_strings_string_technology_status_unavailable_tech	text_rejected	true
random_localisation_strings_string_agent_help_string_incite_rebels	Ви не в змозі підбурювати повстання в бунтівних провінціях.	true
random_localisation_strings_string_unit_concerned_casualties	Є постраждалі	true
random_localisation_strings_string_morale_wavering	Вагаються	true
random_localisation_strings_string_error_clan_search	text_rejected	true
random_localisation_strings_string_round_id_late_september	Кінець вересня	true
random_localisation_strings_string_Campaign_button_end_turn_autumn	Осінь	true
random_localisation_strings_string_November	text_rejected	true
random_localisation_strings_string_expedition_occupy	Оголосити незалежність||Окупація цього поселення є оголошенням Вашої незалежності від Римської імперії!	true
random_localisation_strings_string_researcher_tooltip	Клацніть ЛКМ, щоб вибрати. Після натиснення ЛКМ почнеться дослідження.	true
random_localisation_strings_string_battle_defeat_minor_heroic	Нищівна поразка||Цього дня Ви здобули сором й ганьбу. Перемога ворога беззаперечна.	true
random_localisation_strings_string_recruitment_travel_time	Рекрутований загін приєднається до війська за наступну кількість ходів:	true
random_localisation_strings_string_recruitment_cost	Вартість вербування	true
random_localisation_strings_string_region_specialty_artisans	text_rejected	true
random_localisation_strings_string_event_log_battle_victory_major_decisive	Вирішальна Перемога	true
random_localisation_strings_string_sea_region_control_status_shared	Загальний	true
random_localisation_strings_string_graphics_settings_require_restart	Нові налаштування будуть застосовані після нового входження в гру.	true
random_localisation_strings_string_Fixed_Artillery_Cannot_Reinforce	Стаціонарна артилерія  нерухому, тому не може бути використана для підкріплення.	true
random_localisation_strings_string_trade_agreement_tooltip_neighbour	Наземний торгівельний шлях з’єднає Ваші дві столиці.	true
random_localisation_strings_string_technology_entity_tooltip	text_rejected	true
random_localisation_strings_string_will_win_at_end	Якщо час сплине, святкуйте перемогу	true
random_localisation_strings_string_resource	Ресурс	true
random_localisation_strings_string_February	text_rejected	true
random_localisation_strings_string_state_religion_change_inactive_not_enough_support	Неможливо змінити релігію - недостатня кількість Вашого населення дотримується цієї релігії.\\n\\nПотрібна кількість:	true
random_localisation_strings_string_population_too_low	Замало населення	true
random_localisation_strings_string_units_upgrade_no_upgrade_available	Немає доступного підвищення для цього загону.	true
random_localisation_strings_string_StratHudButton_Cannot_Demolish0	Неможливо знести	true
random_localisation_strings_string_StratHudButton_Cannot_Demolish1	Ви не в змозі зруйнувати поселення та порти, дороги чи спеціальні будівлі початкового рівня.	true
random_localisation_strings_string_unit_concerned_under_friendly_fire	Під дружнім вогнем	true
random_localisation_strings_string_character_role_son	Син	true
random_localisation_strings_string_gfx_aoit_on_intel	Прискор. Intel 	true
random_localisation_strings_string_ping_move	Рухайтесь сюди!	true
random_localisation_strings_string_mission_reward_treasury	Кошти	true
random_localisation_strings_string_September	Вересень	true
random_localisation_strings_string_cannot_recruit_queue_full	Ваша черга вербування заповнена, видаліть інші загони, щоб поставити цей загін в чергу.	true
random_localisation_strings_string_outbreak_chance	Імовірність спалаху	true
random_localisation_strings_string_will_draw_at_end	Якщо час сплине ніхто не отримає перемогу	true
random_localisation_strings_string_attacker	Нападник	true
random_localisation_strings_string_player_stats_best_4v4_placement	Найкращий штурм в наземній битві 4 на 4	true
random_localisation_strings_string_player_stats_best_1v1_placement	Найкращий штурм в наземних битвах 1 на 1	true
random_localisation_strings_string_player_stats_best_2v2_placement	Найкращий штурм в наземній битві 2 на 2	true
random_localisation_strings_string_player_stats_best_3v3_placement	Найкращий штурм в наземній битві 3 на 3	true
random_localisation_strings_string_player_stats_enemy_units_wiped_out	Макс. знищено ворожих загонів	true
random_localisation_strings_string_gfx_downgraded_osx	УВАГА! Графічної пам’яті мало, тому графіка знижується для цього сеансу. Щоб уникнути цього в майбутньому, зменште налаштування якості текстури.	true
random_localisation_strings_string_gfx_filtering_ani2x	Анізотр. 2x	true
random_localisation_strings_string_building_construction_requires_prereq_buildings	Для будівництва цієї споруди, необхідно щоб у головній комірці поселення має бути наступна будівля:[[col:yellow]]	true
random_localisation_strings_string_occupied_building	Зайнята будівля	true
random_localisation_strings_string_stats_clan_current_clan_map_regions_held	text_rejected	true
random_localisation_strings_string_network_message_host_left	Власник (хост) залишив гру.	true
random_localisation_strings_string_tech_category_industrial	text_rejected	true
random_localisation_strings_string_copy_protection_message	text_rejected	true
random_localisation_strings_string_agent_recruitment_no_candidates	[[col:red]]Немає кандидатів на посаду агента.[[/col]]	true
random_localisation_strings_string_agent_help_cannot_sabotage_fully_damaged_building	Ви не можете влаштувати диверсію в зруйнованій споруді.	true
random_localisation_strings_string_mission_penalty	Кара:	true
random_localisation_strings_string_gatehouse	Вежа воріт	true
random_localisation_strings_string_battlemap_regroup_position	Позиція перегрупування	true
random_localisation_strings_string_network_error_join_failed_rejected	Не вдалося приєднатися до гри: відхилено господарем	true
random_localisation_strings_string_gfx_aa_16x16	16x	true
random_localisation_strings_string_trade_agreement_tooltip_no_borders	Порти Вашої рідної провінції завантажені на повну потужність.||Морський шлях із Вашої столиці неможливо встановити.	true
random_localisation_strings_string_agent_help_string_seduce_faction_leader	text_rejected	true
random_localisation_strings_string_unit_concerned_fighting_cavalry	Б'ються з кіннотою	true
random_localisation_strings_string_character_situation_cunning_oversee_town	Нагляд за поселенням	true
random_localisation_strings_string_chat_intro_text	Введіть /help, щоб переглянути перелік команд спілкування для Вашої поточної ігрової області.	true
random_localisation_strings_string_friends	Друзі	true
random_localisation_strings_string_navy_tab	Фльота	true
random_localisation_strings_string_legendary	Легенд.	true
random_localisation_strings_string_c_tooltip_vassal	Данницька чи маріонеткова держава	true
random_localisation_strings_string_resource_tariffs	Мито	true
random_localisation_strings_string_trade_route_tooltip_other_factions	Користувацький	true
random_localisation_strings_string_agents_tab	Агенти	true
random_localisation_strings_string_gfx_filtering_ani4x	Анізотр. 4x	true
random_localisation_strings_string_battle_filter_clan	Кланові битви	true
random_localisation_strings_string_unit_concerned_enemy_controls_land	Ворог контролює землю - треба сходити на берег!	true
random_localisation_strings_string_technology_not_yet_researched_for_this_unit_type	text_rejected	true
random_localisation_strings_string_military_force_legacy_name_garrison_navy	Фльота залоги	true
random_localisation_strings_string_pre-battle_multiplayer_spectate	Споглядати	true
random_localisation_strings_string_building_under_construction_damaged_cancel_repair	Скасування ремонту цієї недобудови залишить її в пошкодженому стані. Будівництво споруди не розпочнеться, доки його не відремонтують.	true
random_localisation_strings_string_REGION_FOOD_FACTOR_EVENTS	Події	true
random_localisation_strings_string_Completed	Завершено	true
random_localisation_strings_string_gfx_shader_3_hi	Модель шейдера 3	true
random_localisation_strings_string_lclick_steal_tech	Клацніть ЛКМ, щоб спробувати викрасти цю технологію	true
random_localisation_strings_string_opponent_refuses_surrender_body	Сили, що обороняються, відмовляються виконувати Вашу вимогу здатися!	true
random_localisation_strings_string_player_stat_battles_won	Битв виграно	true
random_localisation_strings_string_construction_tab	Будівництво	true
random_localisation_strings_string_fatigue	втома	true
random_localisation_strings_string_predicted_income	Прогнозований прибуток	true
random_localisation_strings_string_network_message_content_not_owned	Вас вигнали з гри через те, що господар (хост) вибрав спеціальну мапу DLC, якої у Вас немає.	true
random_localisation_strings_string_town_industrial	text_rejected	true
random_localisation_strings_string_art_active	Клацніть ЛКМ, щоб дослідити цю технологію.	true
random_localisation_strings_string_cpu_player	ЦП %d	true
random_localisation_strings_string_one_minute	1 хв	true
random_localisation_strings_string_character_situation_zeal_convert_character	Навернення персонажа	true
random_localisation_strings_string_gfx_v_high	Надто висок.	true
random_localisation_strings_string_happiness_resistance_fame	text_rejected	true
random_localisation_strings_string_victory_conditions_conquest_best_before	text_rejected	true
random_localisation_strings_string_round_id_february	Лютий	true
random_localisation_strings_string_victory	Перемога	true
random_localisation_strings_string_REGION_FOOD_FACTOR_POOR_FERTILITY_BONUS	Особливість держави	true
random_localisation_strings_string_tile_upgrade_encampment	Табір	true
random_localisation_strings_string_Cannot_build_fort	Ви не в змозі побудувати форт.||Ви повинні перебувати у своїй провінції та мати полководця, який побудує форт.||Вам також потрібно достатньо коштів та достатньо відкритої землі для будівництва.||Ви повинні або зібрати достатньо коштів, або виберіть краще місце для будівництва.	true
random_localisation_strings_string_Historic	Історична битва	true
random_localisation_strings_string_agent_help_string_nemesis	Ця ціль природно стійка до дій Вашого агента.	true
random_localisation_strings_string_region_specialty_naval_tradition	text_rejected	true
random_localisation_strings_string_limited_edition_required	text_rejected	true
random_localisation_strings_string_round_id_october	Жовтень	true
random_localisation_strings_string_unit_encouraged_general_rallying_nearby	Полководець згуртовує війська поруч	true
random_localisation_strings_string_trade_agreement_tooltip_projected_value	Прогнозована вартість:	true
random_localisation_strings_string_land_combatant_winning_slightly	Загін ледь перемагає	true
random_localisation_strings_string_campaign_difficulty_description_1	Для гравців знайомих із стратегіями і настільними іграми, але ж не із Total War.	true
random_localisation_strings_string_campaign_difficulty_description_0	Для тих, хто ніколи не грав в стратегії але бажає.	true
random_localisation_strings_string_campaign_difficulty_description_3	Для досвідчених та освічених гравців	true
random_localisation_strings_string_campaign_difficulty_description_2	Для гравців, що мають досвід гри в Total War.	true
random_localisation_strings_string_campaign_difficulty_description_4	Тільки для самовпевнених, неабияк підкованих і підготовлених гравців. Зберегтися власноруч заборонено. Під час паузи в бою наказам зась!	true
random_localisation_strings_string_player_is_vassal_and_cannot_attack	Ви повинні вибрати кілька піхотних або артилерійських загонів, здатних атакувати укріплення.	true
random_localisation_strings_string_agent_recruitment_no_settlment_selected	Не вибрано поселення для вербування агента.	true
random_localisation_strings_string_event_log_battle_defeat_heroic_crushing	Нищівна поразка	true
random_localisation_strings_string_finance_header_interest	Відсоток	true
random_localisation_strings_string_unit_upgrade_unit_damaged	Цей загін неповний, тому його неможливо покращити.	true
random_localisation_strings_string_player_stats_best_clan_ladder_placement	text_rejected	true
random_localisation_strings_string_ship_card_red_destroyed	Цей човен було знищено в бою.	true
random_localisation_strings_string_FACTION_FOOD_FACTOR_TECHNOLOGIES	Технології	true
random_localisation_strings_string_gfx_filtering_ani8x	Анізотр. 8x	true
random_localisation_strings_string_CAMPAIGN_POLITICS_ACTION_TYPE_ASSASSINATE	Вбивство на замовлення	true
random_localisation_strings_string_unit_encouraged_rallied_by_unit_ability	Згуртовані здібностями	true
random_localisation_strings_string_technology_status_available_to_steal_no_gentlemen	text_rejected	true
random_localisation_strings_string_art_unavailable	Клацніть ЛКМ, щоб встановити цю технологію як мету.||Технології, які необхідні для розблокування, будуть досліджені автоматично.	true
random_localisation_strings_string_unknown	Невідомо	true
random_localisation_strings_string_diplomacy_button_cannot_request_join_war_when_at_w	text_rejected	true
random_localisation_strings_string_network_error_join_failed_password	Не вдалося приєднатися до гри: вказано неправильний пароль	true
random_localisation_strings_string_finance_header_unit_upkeep	Утримання війська	true
random_localisation_strings_string_ship_card_crew_lost_ship_scuppered	text_rejected	true
random_localisation_strings_string_battle_filter_land	Наземні битви	true
random_localisation_strings_string_multiplayer_turn_begin2	Натисніть, щоб почати хід.	true
random_localisation_strings_string_multiplayer_turn_begin1	Хід завершений:	true
random_localisation_strings_string_character_situation_subterfuge_spy_network	Шпигунські мережі	true
random_localisation_strings_string_effect_bundle_time	Сезони, що залишилися	true
random_localisation_strings_string_fe_recruitment_card_tooltip_not_unlocked	Ви не в змозі додати цей загін, оскільки він ще не розблокований.\\nПродовжуйте вигравати битви, щоб розблокувати більше загонів.	true
random_localisation_strings_string_mp_ready_error_no_faction	Держав гравця встановлена	true
random_localisation_strings_string_round_id_november	Листопад	true
random_localisation_strings_string_formatted_memory	%d МБ	true
random_localisation_strings_string_evening	Вечір	true
random_localisation_strings_string_unit_concerned_fatigue_exhausted	Виснаження	true
random_localisation_strings_string_character_experience_progress_bar	Досвід, отриманий на цьому рівні:	true
random_localisation_strings_string_unit_encouraged_charging	Наступ	true
random_localisation_strings_string_your_ally	Ваш союзник:	true
random_localisation_strings_string_opponent_demands_surrender_body	Нападники вимагають, щоб Ви склали зброю!	true
random_localisation_strings_string_town_intellectual	text_rejected	true
random_localisation_strings_string_StratHudbutton_limited_unit_type	Ви можете мати лише обмежену кількість цих предметів. Зараз у Вас %d з %d.	true
random_localisation_strings_string_MILITARY_FORCE_FOOD_FACTOR_EVENTS	Події	true
random_localisation_strings_string_building_insufficent_development_points	У Вас недостатньо надлишку населення.||Зачекайте, доки ця провінція достатньо розростеться, або модернізуйте та переобладнайте місцеві будівлі, щоб збільшити темпи місцевого зростання.	true
random_localisation_strings_string_dlc_menu_button_own_all	Ви володієте всіма доступними пакетами DLC.	true
random_localisation_strings_string_trade_route_state_enemy	(Ворожий)	true
random_localisation_strings_string_StratHud_Unit_Card_Recruit_Queued	Клацніть ЛКМ, щоб видалити загін з черги, клацніть ПКМ, щоб отримати додаткову інформацію.	true
random_localisation_strings_string_player_stats_mp_consecutive_naval	Кількість послідовно виграних морських битв	true
random_localisation_strings_string_MILITARY_FORCE_FOOD_FACTOR_STANCE	Позиція	true
random_localisation_strings_string_round_id_late_may	Кінець травня	true
random_localisation_strings_string_gfx_high	Висок.	true
random_localisation_strings_string_ping_notification	Увага	true
random_localisation_strings_string_gfx_filtering_bi	Білінійна	true
random_localisation_strings_string_unit_concerned_army_destruction	Військо зазнає втрат	true
random_localisation_strings_string_replenish_cancel	Скасувати поповнення обраних загонів. Відшкодування:	true
random_localisation_strings_string_unhappy	Незадоволення	true
random_localisation_strings_string_clan_season_end	Сезон закінчився.	true
random_localisation_strings_string_autosaving	Автозбереження...	true
random_localisation_strings_string_pre-battle_multiplayer_play_battle	Грати в битві	true
random_localisation_strings_string_mp_ready_error_no_ai_units	Перш ніж оголосити про готовність, Ви повинні вибрати загони для армії ШІ.	true
random_localisation_strings_string_SkillTree_Skill_Available_Function_Tooltip	Клацніть ЛКМ, щоб додати очки, клацніть ПКМ, щоб переглянути більше інформації.	true
random_localisation_strings_string_action_result_type_failure	Невдача	true
random_localisation_strings_string_cards_only	Лише картки	true
random_localisation_strings_string_time_days	дн.	true
random_localisation_strings_string_player_stats_campaign_battles_fought_personally	Особисто проведені битви в кампанії	true
random_localisation_strings_string_multiplayer_time_up_title	Час вийшов!	true
random_localisation_strings_string_REGION_FOOD_FACTOR_TECHNOLOGIES	Технології	true
random_localisation_strings_string_campaign_filter_friends	Кампанії друзів	true
random_localisation_strings_string_CAMPAIGN_POLITICS_ACTION_TYPE_GET_INTO_POSITION	Зробити просування	true
random_localisation_strings_string_MILITARY_FORCE_FOOD_FACTOR_TECHNOLOGIES	Технології	true
random_localisation_strings_string_morale_surrendered	Здаються	true
random_localisation_strings_string_cancel_construction_header	Скасувати будівництво	true
random_localisation_strings_string_captive_option_description_release	Продаж військовополонених назад їхнім командувачам принесе Вам гарний прибуток, але вплине на єдність Ваших військ.	true
random_localisation_strings_string_gfx_aa_8x8	8x	true
random_localisation_strings_string_gfx_aa_4x4	4x	true
random_localisation_strings_string_finance_header_commerce_raiding	Рейди	true
random_localisation_strings_string_gfx_aa_2x2	2x	true
random_localisation_strings_string_battle_title_adrianople	Битва під Адріанополем	true
random_localisation_strings_string_will_go_bankrupt	Ви витрачаєте занадто багато коштів, а утримання Ваших збройних сил завдає шкоди Вашій скарбниці. Якщо не підвищити податки або не розформувати зайві загони, банкрутство буде неминучим. Ви впевнені, що бажаєте завершити хід?	true
random_localisation_strings_string_unit_encouraged_winning	Перемагають в поточному бою	true
random_localisation_strings_string_file_io_error_not_found	Файл не знайдено. Вказано недійсне ім'я файлу.	true
random_localisation_strings_string_character_role_politician	Держ. діяч	true
random_localisation_strings_string_FACTION_FOOD_FACTOR_POOR_FERTILITY_BONUS	Особливість держави	true
random_localisation_strings_string_leaderboard_no_entries_returned	Записів не знайдено.	true
random_localisation_strings_string_multiplayer_waiting_load	Очікування, поки інший гравець завершить завантаження...	true
random_localisation_strings_string_CARD_STAT_BEST_4V4_LADDER_PLACEMENT_NAVAL	Найкращий абордаж в морській битві 4 на 4	true
random_localisation_strings_string_gfx_downgraded	УВАГА! Графічної пам’яті мало, тому Ваша графіка знижується. Поставте прапорець «Необмежена відеопам’ять» у параметрах розширеної графіки, щоб замість цього використовувати системну пам’ять для графіки, але уповільнення все одно може відбуватися. Якщо це станеться, зніміть цей прапорець і натомість зменште налаштування якості текстури.	true
random_localisation_strings_string_morale	Моральний дух	true
random_localisation_strings_string_rclick_terminate_steal_click	Клацніть ПКМ, щоб скасувати крадіжку цієї технології	true
random_localisation_strings_string_pre-battle_multiplayer_auto_resolve	Автоматичне вирішення	true
random_localisation_strings_string_building_culture_conversion	Вартість навернення за рахунок місцевої культури	true
random_localisation_strings_string_ping_defend	Захищати тут!	true
random_localisation_strings_string_description	Опис	true
random_localisation_strings_string_naval_recruitment_tab	Вербування фльоти	true
random_localisation_strings_string_unit_encouraged_fortification_breach	Позицію все ще можна захистити	true
random_localisation_strings_string_network_error_incompatible_exe	Несумісна виконавча версія	true
random_localisation_strings_string_character_situation_cunning_counterspy	Контррозвідка	true
random_localisation_strings_string_morale_routing	Дременули	true
random_localisation_strings_string_at_war	Оголошення війни	true
random_localisation_strings_string_destroy_transported_warning	Ви дійсно бажаєте розформувати вибрані загони?	true
random_localisation_strings_string_melee_defence	Захист в ближ. бою	true
random_localisation_strings_string_lists_tooltip2	Клацніть ЛКМ, щоб рухати загін; клацніть ПКМ для отримання додаткової інформації	true
random_localisation_strings_string_episodic_restriction	Тільки для Вступу	true
random_localisation_strings_string_thief_tooltip	Клацніть ЛКМ, щоб вибрати. Після натиснення ЛКМ на позначці технології Ви спробуєте викрасти її.	true
random_localisation_strings_string_finances_tribute_expenditure	Інше	true
random_localisation_strings_string_play_battle	Грати в битві	true
random_localisation_strings_string_unit_card_lost_men_disbanded	Цей загін втратив занадто багато людей і був розформований.	true
random_localisation_strings_string_StratHudbutton_cannot_enlist_nocash	Неможливо призначити полководця||У Вас недостатньо коштів.	true
random_localisation_strings_string_weather_tooltips_fog	Туман||Сильно погіршена видимість.	true
random_localisation_strings_string_network_error_kicked	Власник (хост) вигнав Вас.	true
random_localisation_strings_string_diplomacy_header_player_clan	text_rejected	true
random_localisation_strings_string_network_message_confirm_quit	Ви дійсно бажаєте вийти?	true
random_localisation_strings_string_March	text_rejected	true
random_localisation_strings_string_settlement_spy_info_no_info	Немає шпигунської інформації	true
random_localisation_strings_string_character_situation_seducing	Спокуса	true
random_localisation_strings_string_finance_header_tribute	Данина	true
random_localisation_strings_string_versus	проти	true
random_localisation_strings_string_wealth	Багатство	true
random_localisation_strings_string_player_stat_disembarks	Всього сходжень на берег	true
random_localisation_strings_string_damage	Шкода	true
random_localisation_strings_string_May	text_rejected	true
random_localisation_strings_string_day	День	true
random_localisation_strings_string_unit_upgrade_incorrect_stance	Ви не можете покращити цей загін, доки Ваше військо знаходиться в цій позиції.	true
random_localisation_strings_string_class_middle	Середні класи	true
random_localisation_strings_string_warning_players_without_dlc	Ви збираєтеся вибрати мапу, що містить вміст DLC, який не належить деяким гравцям у лобі. Такими діями Ви позбудетеся їх. Ви бажаєте продовжити?	true
random_localisation_strings_string_player_stats_total_mp_naval_battles_completed	Всього завершених морських битв в мережевій грі	true
random_localisation_strings_string_fe_recruitment_card_tooltip_command_clash_land	Ви не в змозі найняти цей загін, доки у Ваших військах не буде полководця	true
random_localisation_strings_string_ability_defend	Режим оборони||Це переведе Ваші війська до оборони. Режим оборони дозволяє Вашим людям утримувати позицію. Навіть якщо ворожий загін розгромить, Ваші люди залишаться на позиціях і утримають лінію.	true
random_localisation_strings_string_player_stat_men_killed	Всього убитих чи захоплених у полон людей	true
random_localisation_strings_string_round_id_late_march	Кінець березня	true
random_localisation_strings_string_agent_recruitment_insufficient_dev_points_expedition	[[col:red]]Недостатній надлишок населення, щоб зібрати нову експедиційну армію.[[/col]]	true
random_localisation_strings_string_oppressed_by	Почувається пригніченим від	true
random_localisation_strings_string_ship_card_red_general_killed	Капітан цього човна загинув у бою.	true
random_localisation_strings_string_battle_filter_friends	Битви друзів	true
random_localisation_strings_string_manoeuverability_low	Низьк.	true
random_localisation_strings_string_unit_concerned_projectiles_overhead	Снаряди над головою	true
random_localisation_strings_string_road	Дорога	true
random_localisation_strings_string_resource_exporting_percentage	Експорт:	true
random_localisation_strings_string_unit_stat_bonus_accuracy_exceptional	Виняткова влучність	true
random_localisation_strings_string_Naval	Морська битва	true
random_localisation_strings_string_technology_status_being_stolen	text_rejected	true
random_localisation_strings_string_agent_help_string_bribe_faction_leader	text_rejected	true
random_localisation_strings_string_defeat	Поразка	true
random_localisation_strings_string_purchase_dialog_txt	Щоб приєднатися до цієї гри, потрібен додатковий вміст.	true
random_localisation_strings_string_morale_broken	Зламані	true
random_localisation_strings_string_trade_agreement_tooltip_no_sea_routes	Порти їхньої столиці завантажені на повну потужність.||Морський шлях із їхньої столиці неможливо встановити.	true
random_localisation_strings_string_cannot_recruit_general_already_full	Наразі Ви не в змозі найняти полководця.||У Вас уже є максимальна кількість загонів у цих військах.||Щоб призначити полководця, Вам потрібно буде розформувати один із Ваших загонів.	true
random_localisation_strings_string_enemy_forces	Ворожий альянс	true
random_localisation_strings_string_agent_help_string_insufficient_funds	У Вас недостатньо коштів для виконання цієї дії.	true
random_localisation_strings_string_quit_warning	Якщо Ви вийдете зараз, Ви втратите весь не збережений прогрес	true
random_localisation_strings_string_round_id_july	Липень	true
random_localisation_strings_string_CARD_STAT_BEST_1V1_LADDER_PLACEMENT_NAVAL	Найкращий абордаж в морській битві 1 на 1 	true
random_localisation_strings_string_character_situation_conversion	Навернення провінції	true
random_localisation_strings_string_stats_clan_clan_leader	text_rejected	true
random_localisation_strings_string_finance_header_looting	Здобич	true
random_localisation_strings_string_nations_filter_tooltip	Версія гри господаря відрізняється від Вашої, Ви не зможете приєднатися до цієї гри	true
random_localisation_strings_string_allied	Союзники	true
random_localisation_strings_string_event_log_battle_victory_close_phyrric	Піррова перемога	true
random_localisation_strings_string_mission_reward	Нагорода:	true
random_localisation_strings_string_action_result_type_opportune_failure	Втрачена можливість	true
random_localisation_strings_string_error_profile_request	text_rejected	true
random_localisation_strings_string_auto_resolve	Автоматичне вирішення	true
random_localisation_strings_string_bribe_nonhostile_description	Ви намагаєтеся змусити неворожого агента приєднатися до Вашої держави. Це військовий акт.\\nЯк Ви будете діяти?	true
random_localisation_strings_string_load_success	Завантаження виконано	true
random_localisation_strings_string_range	Відстань	true
random_localisation_strings_string_repair_cancel	Скасувати ремонт вибраних човнів. Відшкодування:	true
random_localisation_strings_string_character_details_panel_min	Мінімум	true
random_localisation_strings_string_large	Велик.	true
random_localisation_strings_string_high	Вис.	true
random_localisation_strings_string_cannot_dismantle_ruin	Ви повинні розібрати руїну в попередній комірці, перш ніж цю руїну можна буде розібрати.	true
random_localisation_strings_string_player_disconnected	від’єднався.	true
random_localisation_strings_string_character_situation_cunning_hunt_down	Затримання	true
random_localisation_strings_string_Siege	Облогова битва	true
random_localisation_strings_string_battle_victory_minor_decisive	Вирішальна перемога||Ворог мертвий або тікає, щоб врятувати своє ганебне життя! Ви здобули незрівняну перемогу!	true
random_localisation_strings_string_network_error_desync	У грі сталася десинхронізація, відбувається вихід...	true
random_localisation_strings_string_victory_conditions_tutorial	Захопіть перелічені нижче провінції, щоб виграти кампанію.	true
random_localisation_strings_string_gfx_aa_mlaa	MLAA	true
random_localisation_strings_string_battle_victory_major_decisive	Вирішальна перемога||Немає сумнівів: це велика перемога! Вороги мертві або тікають!	true
random_localisation_strings_string_CARD_STAT_BEST_2V2_LADDER_PLACEMENT_NAVAL	Найкращий абордаж в морській битві 2 на 2 	true
random_localisation_strings_string_attrition_heat	Це область ВИСНАЖЕННЯ. Через сильну спеку війська зазнають тут втрат.	true
random_localisation_strings_string_StratHudbutton_Cannot_Build2	В облозі не можливо будь-що будувати	true
random_localisation_strings_string_StratHudbutton_Cannot_Build3	Ви повинні відремонтувати першу будівлю в ланцюжку, перш ніж будувати іншу.	true
random_localisation_strings_string_StratHudbutton_Cannot_Build0	Неможливо будувати	true
random_localisation_strings_string_StratHudbutton_Cannot_Build1	Ви не в змозі дозволити собі це побудувати. Вартість:	true
random_localisation_strings_string_yes	Так	true
random_localisation_strings_string_mission_description	Опис:	true
random_localisation_strings_string_player_stats_men_lost	Втрачено вояків	true
random_localisation_strings_string_food_percent	Відсоток виробництва	true
random_localisation_strings_string_incompatible_version	Версія гри господаря відрізняється від Вашої, Ви не зможете приєднатися до цієї гри	true
random_localisation_strings_string_Unit_replenishment_per_turn	Поповнює вояків за хід:	true
random_localisation_strings_string_battle_draw	Без переможців||Ви боролися до кінця, але з битви ніхто не вийшов переможцем. Обидві армії з гідністю залишили бойовище.	true
random_localisation_strings_string_trade_agreement_tooltip_no_ports_them	text_rejected	true
random_localisation_strings_string_event_log_battle_draw	Без переможців	true
random_localisation_strings_string_round_id_june	Червень	true
random_localisation_strings_string_mission_issued_end_rebellion	Придушити повстання:	true
random_localisation_strings_string_network_message_not_responding_host	Один або більше гравців не відповідають. Продовжити очікування чи все таки залишити цю гру?	true
random_localisation_strings_string_morale_amok	Несамовиті	true
random_localisation_strings_string_CARD_STAT_BEST_3V3_LADDER_PLACEMENT_NAVAL	Найкращий абордаж в морській битві 3 на 3 	true
random_localisation_strings_string_reinforcement_tooltip	Дружні сили можуть бути посилені з цієї позиції.	true
random_localisation_strings_string_never	Ніколи	true
random_localisation_strings_string_queued_building_blocked_by_stance_expedition	Ця експедиція повинна завершити зводити цю будівлю. Клацніть ЛКМ, щоб видалити будівлю з черги, клацніть ПКМ, щоб отримати додаткову інформацію.	true
random_localisation_strings_string_mp_ready_error_no_opposition	Ви не в змозі почати, оскільки у Вас немає супротивників	true
random_localisation_strings_string_repair_cost	Вартість ремонту:	true
random_localisation_strings_string_unit_encouraged_general_alive	Полководець живий	true
random_localisation_strings_string_network_message_kicked_by_host	Вас викинув господар(хост).	true
random_localisation_strings_string_stats_clan_current_clan_members_active	text_rejected	true
random_localisation_strings_string_finance_header_building_upkeep	Обслуговування споруд	true
random_localisation_strings_string_pre-battle_multiplayer_play_as_ai	Грати як ШІ	true
random_localisation_strings_string_unit_encouraged_army_supported	Підтримують військо	true
random_localisation_strings_string_ground	Земля	true
random_localisation_strings_string_allied_forces	Ваш союз	true
random_localisation_strings_string_ping_attack	Атакувати тут!	true
random_localisation_strings_string_technology_status_unavailable	text_rejected	true
random_localisation_strings_string_resource_not_acquired	Цей ресурс ще не отримано.	true
random_localisation_strings_string_power_ranking	Рейтинг за силою	true
random_localisation_strings_string_game_aborted	Гра перервана	true
random_localisation_strings_string_stat_shield	Рівень щита	true
random_localisation_strings_string_network_error_join_failed_game_full	Не вдалося приєднатися до гри: гра заповнена	true
random_localisation_strings_string_unit_concerned_attacked_by_artillery	Атаковано артилерією	true
random_localisation_strings_string_land_combatant_losing	Загін програє	true
random_localisation_strings_string_declare_war_ally_not_requested_help	Цей союзник не просив Вашої допомоги у цій війні.	true
random_localisation_strings_string_building_under_construction_damaged	Ця незавершена будівля пошкоджена, і все будівництво зупинено. Виберіть її та натисніть кнопку Відновити, щоб виправити це та продовжити будівництво.	true
random_localisation_strings_string_wall_strength	Міцність стіни	true
random_localisation_strings_string_round_id_early_august	Початок серпня	true
random_localisation_strings_string_stats_clan_steam_group_creation_date	text_rejected	true
random_localisation_strings_string_battle_victory_heroic_crushing	Героїчна перемога||Це перемога: славна, героїчна, велична перемога! Ваші вороги вщент розбиті!	true
random_localisation_strings_string_finance_header_vassals	Залежні держави	true
random_localisation_strings_string_gfx_on	Увімк.	true
random_localisation_strings_string_mission_issuer	Створено:	true
random_localisation_strings_string_audio_provider_stereo_speakers	Стереодинаміки	true
random_localisation_strings_string_stat_base_reload_time	Базовий час перезавантаження	true
random_localisation_strings_string_round_id_late_april	Кінець квітня	true
random_localisation_strings_string_fire_damage	Шкода від вогню	true
random_localisation_strings_string_agent_help_string_agent_cap_reached	[[col:red]]Ви вже використовуєте максимальну кількість відповідних персонажів. Збільшуйте свою імперію, щоб мати змогу залучити більше таких персонажів.[[/col]]	true
random_localisation_strings_string_StratHudbutton_cannot_repair_nocash	Неможливо відремонтувати||У Вас недостатньо коштів.||Розформуйте невикористані загони або збільште податки, щоб зібрати кошти.	true
random_localisation_strings_string_player_stat_battles_started	Битв почато	true
random_localisation_strings_string_campaign_autoresolver_tooltip_stance_siege_balanced	При використанні збалансованої бойової стійки загони не отримають бонусів або покарань.	true
random_localisation_strings_string_art_being_researched	Зараз Ви досліджуєте цю технологію.	true
random_localisation_strings_string_function_building_upgrade_hud	Клацніть ЛКМ, щоб покращити, клацніть ПКМ, щоб отримати додаткову інформацію.	true
random_localisation_strings_string_pip_general_tooltip_loyalty_4	Вірність: надійна	true
random_localisation_strings_string_pip_general_tooltip_loyalty_5	Вірність: непохитна	true
random_localisation_strings_string_pip_general_tooltip_loyalty_6	Вірність: непідкупна	true
random_localisation_strings_string_pip_general_tooltip_loyalty_1	Вірність: підступна	true
random_localisation_strings_string_pip_general_tooltip_loyalty_2	Вірність: сумнівна	true
random_localisation_strings_string_pip_general_tooltip_loyalty_3	Вірність: достатня	true
random_localisation_strings_string_will_go_bankrupt_title	Неминуче банкрутство!	true
random_localisation_strings_string_night	Ніч	true
random_localisation_strings_string_unit_concerned_flank_attacked	Атаковані із флангів	true
random_localisation_strings_string_clear_advice_warning	Ви збираєтеся очистити історію порад. Ви впевнені?	true
random_localisation_strings_string_reinforcement_arrows	Стрілки вказують на військові сили, які можуть допомогти цій армії в битві.	true
random_localisation_strings_string_player_stats_total_campaign_battles	Всього битв в кампанії	true
random_localisation_strings_string_multiplayer_default	mp_default	true
random_localisation_strings_string_finance_header_construction	Будівництво	true
random_localisation_strings_string_unit_concerned_general_recently_died	Полководець щойно помер	true
random_localisation_strings_string_attrition_cold	Взимку війська зазнають втрат через виснаження, якщо вони перебувають на ворожій території.	true
random_localisation_strings_string_overwrite_legendary_save_warning_title	Перезаписати існуюче легендарне збереження?	true
random_localisation_strings_string_replenish_some_unable	Неможливо поповнити загони в цій добірці, деякі з них відсутні в цій місцевості.	true
random_localisation_strings_string_horde_icon_tooltip_expedition	Експедиція\\n\\nЦя держава проводить кампанію і не має регіонів.	true
random_localisation_strings_string_clan_points	text_rejected	true
random_localisation_strings_string_heir	Спадкоємець	true
random_localisation_strings_string_player_stats_alliances_made	Укладено союзів	true
random_localisation_strings_string_agent_recruitment_reduced_changed_bodyguard	[[col:red]]Недостатньо коштів, для створення нового загону охоронців. Поточний загін буде недо охоронець буде недоукомплектований.[[/col]]	true
random_localisation_strings_string_faction_not_allowed	text_rejected	true
random_localisation_strings_string_unlock_agent_action_to_embed_in_army	Щоб діяти проти цього війська, Ви повинні розблокувати наступну дію:	true
random_localisation_strings_string_move_options_multiplayer_cannot_declare_war	Ви не в змозі оголосити війну своєму партнеру за спільною грою.	true
random_localisation_strings_string_locked_slot_requires_castle_upgrade	text_rejected	true
random_localisation_strings_string_chat_ping_msg	Позначку розміщено	true
random_localisation_strings_string_finance_header_fleet_upkeep	Утримання фльоти	true
random_localisation_strings_string_stat_mount_hp	ОЗ транспорту	true
random_localisation_strings_string_no_building	немає споруди	true
random_localisation_strings_string_April	text_rejected	true
random_localisation_strings_string_player_stats_total_men_dead	Вояків, убитих в бою (своїх і чужих)	true
random_localisation_strings_string_trade_node_tooltip_base_supply	припаси, які будуть отримані з першого торгівельного човна	true
random_localisation_strings_string_ability_phase_mask_unbreakable	Незламність	true
random_localisation_strings_string_move_options_vassal_cannot_declare_war	text_rejected	true
random_localisation_strings_string_melee_attack	Ближній бій	true
random_localisation_strings_string_destroy_transported_message	Знищення цих загонів призведе до втрати будь-якої сили або персонажів, які вони зараз перевозять.	true
random_localisation_strings_string_low	Низьк.	true
random_localisation_strings_string_unit_concerned_general_dead	Полководець мертвий	true
random_localisation_strings_string_you	Ви	true
random_localisation_strings_string_mission_issued_recruit_unit	Вербувати загін:	true
random_localisation_strings_string_wako_pirates_demand	Необхідна сума:	true
random_localisation_strings_string_June	text_rejected	true
random_localisation_strings_string_none	Ні	true
random_localisation_strings_string_stat_explosion_damage	Шкода від вибуху	true
random_localisation_strings_string_load_campaign	Завантажити кампанію.	true
random_localisation_strings_string_multiplayer_turn_end	Хід завершений.\\n\\nОчікування:	true
random_localisation_strings_string_midday	Полудень	true
random_localisation_strings_string_network_message_vac_you_kicked	Вас вигнали з гри через помилку автентифікації VAC.	true
random_localisation_strings_string_finances_vassal_income_breakdown_other	text_rejected	true
random_localisation_strings_string_round_id_late_august	Кінець серпня	true
random_localisation_strings_string_character_details_panel_max	Максимум	true
random_localisation_strings_string_campaign_autoresolver_tooltip_stance_naval_aggressive	Ваші загони будуть намагатися накинутися на  ворога. Зазвичай це дієво, коли ворог має перевагу у стрільцях. Але втрати будуть більші.	true
random_localisation_strings_string_campaign_autoresolver_tooltip_stance_land_aggressive	Ваші загони будуть намагатися накинутися на  ворога. Зазвичай це дієво, коли ворог має перевагу у стрільцях. Але втрати будуть більші.	true
random_localisation_strings_string_growth_rate	Зростання	true
random_localisation_strings_string_leaderboard_no_response_from_server	text_rejected	true
random_localisation_strings_string_stat_bonus_elephant	Бонус проти слона	true
random_localisation_strings_string_victory_conditions_conquest	text_rejected	true
random_localisation_strings_string_content_locked	Вміст заблоковано	true
random_localisation_strings_string_normal	Нормал.	true
random_localisation_strings_string_network_message_player_dropped	залишає гру.	true
random_localisation_strings_string_July	text_rejected	true
random_localisation_strings_string_ally	Союзник	true
random_localisation_strings_string_early	Рано	true
random_localisation_strings_string_small	Мал.	true
random_localisation_strings_string_upload_failed	Помилка завантаження. Перевірте підключення до Інтернету та повторіть спробу.	true
random_localisation_strings_string_player_stats_units_recruited	Набрані загони	true
random_localisation_strings_string_network_message_you_dropped	Ви втратили зв'язок з грою.	true
random_localisation_strings_string_power_ranking_tooltip	Це рейтинг сили їхньої держави в порівнянні з усіма існуючими державами	true
random_localisation_strings_string_predicted_income_explanation	Це сума коштів, яку Ви повинні заробити в наступному ході. Це не прогноз Вашої скарбниці.	true
random_localisation_strings_string_full	Заповнено	true
random_localisation_strings_string_self	Сам	true
random_localisation_strings_string_clan_demotion	text_rejected	true
random_localisation_strings_string_finance_header_total_income	Всього прибутку	true
random_localisation_strings_string_Economics_Bar	text_rejected	true
random_localisation_strings_string_network_message_player_left	залишив гру.	true
random_localisation_strings_string_battle_defeat_heroic_crushing	Нищівна поразка||Це ганебна поразка! Ви зазнали нищівної втрати Вашого війська.	true
random_localisation_strings_string_marked_for_dismantling	Позначено під знесення	true
random_localisation_strings_string_enemy	Ворог	true
random_localisation_strings_string_action_result_type_guaranteed	Гарантовано	true
random_localisation_strings_string_effect_bundle_tooltip	Поточні ефекти||Успішне виконання місій і певні ігрові події спричинять короткострокові наслідки для Вашого клану чи провінцій.	true
random_localisation_strings_string_multiplayer_waiting_reconnect	Чекаємо на гравців...	true
random_localisation_strings_string_population_surplus_expedition	Надлишок населення||Експедиції потрібні люди, якщо вона хоче зростати. Надлишок населення можна використати для нових експедицій. Розташування та рейди життєво важливі для зростання експедиції.	true
random_localisation_strings_string_all	Все	true
random_localisation_strings_string_round_id_late_january	Кінець січня	true
random_localisation_strings_string_num_breaches	Мінімальна кількість проривів	true
random_localisation_strings_string_factors_governing_relationship	Фактори, що визначають відносини з %S:	true
random_localisation_strings_string_mission_reward_land_experience	Досвід для всіх наземних загонів	true
random_localisation_strings_string_target	Ціль	true
random_localisation_strings_string_FACTION_PROVINCE_FOOD_FACTOR_FERTILITY	Родючість	true
random_localisation_strings_string_reliability	Надійність	true
random_localisation_strings_string_battle_victory_close_phyrric	Піррова перемога||Ви перемагаєте, але якою ціною? Багато хто заплатив найвищу ціну.	true
random_localisation_strings_string_vhard	Надто висок.	true
random_localisation_strings_string_ultra	Ультра	true
random_localisation_strings_string_port	Порт	true
random_localisation_strings_string_singleplayer_default	sp_default	true
random_localisation_strings_string_gfx_extreme	Найліпша якість	true
random_localisation_strings_string_player_stats_enemy_ships_sunk	Потоплено ворожих човнів	true
random_localisation_strings_string_farm	Ферма	true
random_localisation_strings_string_lists_tooltip	Двічі клацніть ЛКМ, щоб рухати загін; клацніть ПКМ для отримання додаткової інформації	true
random_localisation_strings_string_hard	Висок.	true
random_localisation_strings_string_technology_tooltip_researching_numeric_info	Орієнтовний час дослідження:	true
random_localisation_strings_string_town_factor_industry	Торгівля	true
random_localisation_strings_string_cannot_begin_battle_map_downloading	Ви не можете почати бій, поки мапа завантажується.	true
random_localisation_strings_string_technology_status_available_to_steal	text_rejected	true
random_localisation_strings_string_upkeep_cost	Вартість утримання	true
random_localisation_strings_string_sea_region_control_status_controlled	Контрольований	true
random_localisation_strings_string_battle_regroup_position_marker	Позиція перегрупування	true
random_localisation_strings_string_CAMPAIGN_POLITICS_ACTION_TYPE_ASSASSINATE_WIFE	Вбивство дружини	true
random_localisation_strings_string_easy	Низьк.	true
random_localisation_strings_string_instruction_regroup_ability	Клацніть ПКМ на позиції, щоб встановити позначку перегрупування, ще раз натисніть для скасування.	true
random_localisation_strings_string_cost	Вартість:	true
random_localisation_strings_string_test	тест	true
random_localisation_strings_string_settlement_strength	Міцність поселення	true
random_localisation_strings_string_land_combatant_even	Патова ситуація	true
random_localisation_strings_string_network_error_incompatible_map_version	Неправильна версія мапи	true
random_localisation_strings_string_audio_provider_windows_default	Усталене значення	true
random_localisation_strings_string_fatigue_winded	Захекані	true
random_localisation_strings_string_audio_provider_directsound_3d_hardware	DirectSound 3D	true
random_localisation_strings_string_reveal	Розкрити	true
random_localisation_strings_string_player_stats_best_2v2_skill	Найкращий за весь час рейтинг в наземній битві 2 на 2 	true
random_localisation_strings_string_player_stats_best_3v3_skill	Найкращий за весь час рейтинг в наземній битві 3 на 3	true
random_localisation_strings_string_player_stats_best_1v1_skill	Найкращий за весь час рейтинг в наземній битві 1 на 1 	true
random_localisation_strings_string_player_stats_best_4v4_skill	Найкращий за весь час рейтинг в наземній битві 4 на 4	true
random_localisation_strings_string_thousand_abbreviated	тис.	true
random_localisation_strings_string_StratHud_Building_Card_Recruit_Queued	Клацніть ЛКМ, щоб видалити будівлю з черги, клацніть ПКМ, щоб отримати додаткову інформацію.	true
random_localisation_strings_string_happy	Щасливий	true
random_localisation_strings_string_button_advice_tooltip	Натисніть, щоб отримати пораду стосовно цієї панелі	true
random_localisation_strings_string_stat_men_hp	ОЗ вояків	true
random_localisation_strings_string_save_success	Вдало збережено	true
random_localisation_strings_string_exceeds_all_budgets	Перевищення всього бюджету	true
random_localisation_strings_string_battle_victory_minor_heroic	Героїчна перемога||Битва завершена, а голови ворогів пораховано! Це незрівнянна перемога!	true
random_localisation_strings_string_trade_agreement_tooltip_no_route_them	Морський торгівельний шлях із їхньої столиці встановити неможливо.	true
random_localisation_strings_string_stat_bonus_infantry	Бонус проти піхоти	true
random_localisation_strings_string_tile_upgrade_settlement_escalation1	Рівень загострення 1	true
random_localisation_strings_string_tile_upgrade_settlement_escalation2	Рівень загострення 2	true
random_localisation_strings_string_postbattle_town_wealth	Прогнозоване багатство міста	true
random_localisation_strings_string_FACTION_FOOD_FACTOR_CHARACTERS	Персонажі	true
random_localisation_strings_string_victory_conditions_prestige_additional	text_rejected	true
random_localisation_strings_string_cpu	ЦП	true
random_localisation_strings_string_mission_issued_capture_city	Захопити місто:	true
random_localisation_strings_string_character_situation_paying_off	Оплата	true
random_localisation_strings_string_indestructible	Незламний	true
random_localisation_strings_string_technology_status_unavailable_building	text_rejected	true
random_localisation_strings_string_clan_members	text_rejected	true
random_localisation_strings_string_other_factors	Інші чинники	true
random_localisation_strings_string_morale_steady	Стійкі	true
random_localisation_strings_string_event_log_rebellion_peasant	text_rejected	true
random_localisation_strings_string_million_abbreviated	млн.	true
random_localisation_strings_string_repair_not_required	Для вибраних човнів ремонт не потрібний.	true
random_localisation_strings_string_invalid_replay_file	Не вдалося завантажити перегляд битви. Вказано недійсний файл.	true
random_localisation_strings_string_chat_telestration_msg	Повідомлення з малюнком надіслано	true
random_localisation_strings_string_conversion_factor_osmosis_christian	text_rejected	true
random_localisation_strings_string_cannot_show_projectile_stats	\\n\\n(Неможливо відобразити статистику снарядів, якщо вибрано кілька загонів з різними типами снарядів.)	true
random_localisation_strings_string_region_specialty_prime_forest	text_rejected	true
random_localisation_strings_string_unit_concerned_losing	Програють поточний бій	true
random_localisation_strings_string_network_error_join_failed_incompatible	Не вдалося приєднатися до гри: несумісні версії	true
random_localisation_strings_string_fleet_status_transit2	На шляху до:	true
random_localisation_strings_string_fleet_status_transit1	В дорозі	true
random_localisation_strings_string_agent_help_string_bribe_vassal	text_rejected	true
random_localisation_strings_string_diplomacy_panel_hostage_held	Ваш заручник:	true
random_localisation_strings_string_fe_recruitment_card_tooltip_cap_reached_sea	Ви не в змозі додавати більше загонів цього типу, оскільки Ви досягли ліміту в %d на фльоту.	true
random_localisation_strings_string_agent_help_string_coop_action	Ви не в змозі виконати цю дію над іншим гравцем у спільній кампанії.	true
random_localisation_strings_string_town	Місто	true
random_localisation_strings_string_morale_shaken	Пригнічені	true
random_localisation_strings_string_player_stats_total_mp_land_battles_completed	Всього завершених наземних битв в мережевій грі	true
random_localisation_strings_string_network_error_incompatible_mod	Несумісна версія мода	true
random_localisation_strings_string_ruined	Зруйновано	true
random_localisation_strings_string_art_already_researched	Ви вже дослідили цю технологію.	true
random_localisation_strings_string_army_recruitment_limit_reached	Ви набрали максимальну кількість загонів для цієї армії.	true
random_localisation_strings_string_expert	Надто висок.	true
random_localisation_strings_string_raided	Напад	true
random_localisation_strings_string_you_cannot_afford_to_repair_this_item	Ви не в змозі дозволити собі ремонт цього. Вартість:	true
random_localisation_strings_string_guerrilla_cant_deploy	text_rejected	true
random_localisation_strings_string_late	Пізно	true
random_localisation_strings_string_tile_upgrade_settlement_level2	Велик.	true
random_localisation_strings_string_tile_upgrade_settlement_level3	Велике	true
random_localisation_strings_string_tile_upgrade_settlement_level1	Маленьке	true
random_localisation_strings_string_tile_upgrade_settlement_level4	Величезне	true
random_localisation_strings_string_rebel_faction_name_override	Заколотники	true
random_localisation_strings_string_network_message_steam_connection_lost	Підключення до Steam було втрачено.	true
random_localisation_strings_string_ping_standard	Сюди!	true
random_localisation_strings_string_cancel_repair_building	Цю будівлю буде відремонтовано, коли Ваш хід закінчиться. Клацніть ЛКМ, щоб скасувати ремонт.	true
random_localisation_strings_string_fatigue_active	Активні	true
random_localisation_strings_string_seamen	text_rejected	true
random_localisation_strings_string_agent_help_string_high_loyalty	Ціль має дуже високий рівень вірності, тому її буде важче підкупити.	true
random_localisation_strings_string_overwrite_msg	Ви намагаєтеся зберегти гру на існуючий файл, перезаписавши його. Дійсно бажаєте цього?	true
random_localisation_strings_string_bonus	Бонус:	true
random_localisation_strings_string_trade_status_tooltip_already_trading	Торгівля йде	true
random_localisation_strings_string_exit_theatre_tooltip	Вийдіть з перегляду	true
random_localisation_strings_string_attrition_cold_immune	Загони Вашого війська захищені від зимового виснаження.	true
random_localisation_strings_string_network_message_waiting_for_response	Очікування відповіді від гравця в мережі.	true
random_localisation_strings_string_win_chance_moderate	Середній	true
random_localisation_strings_string_character_role_admiral	Адмірал	true
random_localisation_strings_string_player_stats_nations_destroyed	Знищені держави	true
random_localisation_strings_string_rally_ability	Згуртованість вояків	true
random_localisation_strings_string_quit_battle	Ви збираєтеся вийти з цієї битви. Ви цілковито впевнені?	true
random_localisation_strings_string_ability_fire_at_will	Стріляти без наказу||Стріляти без наказу дозволяє загонам вести вогонь у ворогів у радіусі, коли вони вважають за потрібне.	true
random_localisation_strings_string_unit_concerned_general_fled_recently	Полководець недавно втік	true
random_localisation_strings_string_unit_concerned_settlement_destruction	Руйнування поселення	true
random_localisation_strings_string_region_factor_industry	Торгівля	true
random_localisation_strings_string_character_role_general	Полководець	true
random_localisation_strings_string_expedition_occupy_confirmation	Окупація поселення приведе до оголошення Вашої незалежності, а отже, до припинення імперської підтримки цієї експедиції. Усі цілі експедиції та нагороди стануть недосяжними, але якщо Ваша держава досягне успіху, у Вас є шанс відновити Західну імперію.	true
random_localisation_strings_string_always	Завжди	true
random_localisation_strings_string_win_chance_low	Низьк.	true
random_localisation_strings_string_Unit_replenishment_complete_in	Ходів до повного поповнення загону:	true
random_localisation_strings_string_medium	Середн.	true
random_localisation_strings_string_button_cancel_slot_instruction_active	Натисніть цю кнопку, щоб скасувати будь-яку дію з вибраною річчю.	true
random_localisation_strings_string_click_to_show_on_map	Тицьніть для показу на мапі	true
random_localisation_strings_string_player_stats_num_sword_duels	Кількість виграних дуелей на мечах	true
random_localisation_strings_string_CARD_STAT_BEST_1V1_SKILL_NAVAL	Найкращий за весь час рейтинг в морській битві 1 на 1 	true
random_localisation_strings_string_CARD_STAT_BEST_3V3_SKILL_NAVAL	Найкращий за весь час рейтинг в морській битві 3 на 3	true
random_localisation_strings_string_CARD_STAT_BEST_2V2_SKILL_NAVAL	Найкращий за весь час рейтинг в морській битві 2 на 2 	true
random_localisation_strings_string_CARD_STAT_BEST_4V4_SKILL_NAVAL	Найкращий за весь час рейтинг в морській битві 4 на 4	true
random_localisation_strings_string_agent_recruitment_insufficient_money_for_different_bodyguard	[[col:red]]Недостатньо коштів, для створення нового загону охоронців.[[/col]]	true
random_localisation_strings_string_CapturePoint	Битва за ключову позицію	true
random_localisation_strings_string_diplomacy_button_must_be_at_peace_to_protect	text_rejected	true
random_localisation_strings_string_benchmark_dialog_body	Ви бажаєте вийти з поточного тесту?	true
random_localisation_strings_string_network_error_steam_disconnect	Ви були відключені від Steam. Щоб продовжити, перезапустіть Steam.	true
random_localisation_strings_string_unit_concerned_night_battle_unprepared	Непідготовані до нічної битви	true
random_localisation_strings_string_FACTION_PROVINCE_FOOD_FACTOR_BASE_FOOD	Базове харчування	true
random_localisation_strings_string_state_religion_change_inactive_faction_leader_already_changed	Неможливо змінити релігію - лідер Вашої держави вже один раз змінив релігію.	true
random_localisation_strings_string_agent_help_string_enemy_counter_agent	Ворожий агент протидіє Вам, знижуючи шанси на успіх.	true
random_localisation_strings_string_fortification	Укріплення	true
random_localisation_strings_string_attrition_sea	Човни, які тут рухатимуться, постраждають від виснаження	true
random_localisation_strings_string_unit_concerned_fatigue_tired	Втомилися	true
random_localisation_strings_string_gfx_drop_low	Макс. продуктив.	true
random_localisation_strings_string_player_stats_miles_covered_campaign	Кількість миль, пройдених загонами Вашої кампанії (на землі та на морі)	true
random_localisation_strings_string_gate_with_oil	(з олією)	true
random_localisation_strings_string_finance_header_total_upkeep	Всього утримання	true
random_localisation_strings_string_invalid_army_setup_alliance	Гравець має неприпустимий військовий склад	true
random_localisation_strings_string_round_id_late_october	Кінець жовтня	true
random_localisation_strings_string_error_chat_room_failed	Помилка спілкування||Не вдалося створити кімнату спілкування.	true
random_localisation_strings_string_technology_disabled_by	Вимкнено	true
random_localisation_strings_string_pre-battle_multiplayer_retreat	Відступити	true
random_localisation_strings_string_power_ranking_tooltip_player	Це рейтинг сили Вашої держави в порівнянні з усіма існуючими державами	true
random_localisation_strings_string_mp_ready_error_no_ai_faction	Держава ШІ не встановлена	true
random_localisation_strings_string_no_repairs_required	Ремонт не потрібний	true
random_localisation_strings_string_campaign_autoresolver_tooltip_stance_defensive	Ваші загони займуть оборонну позицію. Зазвичай це дієво, коли у Вас є більше стрільців. Це зменшить втрати.	true
random_localisation_strings_string_slaves_percent	Відсоток переселенців	true
random_localisation_strings_string_region_capital	Поселення	true
random_localisation_strings_string_FACTION_PROVINCE_FOOD_FACTOR_EVENTS_IN_REGIONS	Події регіону	true
random_localisation_strings_string_reason	Причина:	true
random_localisation_strings_string_random	Випадково	true
random_localisation_strings_string_finances_other_income	Прибутки з інших джерел.	true
random_localisation_strings_string_weather_tooltips_dry	Сухо||Без негативних наслідків.	true
random_localisation_strings_string_audio_provider_dolby_surround	Dolby Surround	true
random_localisation_strings_string_character_situation_sea_attack	Морські атаки	true
random_localisation_strings_string_enemy_mencount	Чисельність ворогів	true
random_localisation_strings_string_player_stats_regions_conquered	Завойовані провінції	true
random_localisation_strings_string_CAMPAIGN_POLITICS_ACTION_TYPE_MARRIAGE	Весілля	true
random_localisation_strings_string_instruction_inspire_ability	Клацніть ЛКМ на загін, щоб надихнути її, клацніть ПКМ, щоб скасувати цю здібність.	true
random_localisation_strings_string_diplomacy_panel_hostage_given	Їхній заручник виданий:	true
random_localisation_strings_string_under_repair	В ремонті	true
random_localisation_strings_string_military_force_legacy_name_rebel_army	Повстанське військо	true
random_localisation_strings_string_fe_recruitment_card_tooltip_cap_reached_land	Ви не в змозі додавати більше загонів цього типу, оскільки Ви досягли ліміту в %d на армію.	true
random_localisation_strings_string_attrition_heat_immune	Загони Вашого війська захищені від виснаження в пустелі.	true
random_localisation_strings_string_Military_Bar	Огляд війська	true
random_localisation_strings_string_unaffordable	Недостатньо коштів	true
random_localisation_strings_string_player_stats_enemy_men_killed	Вбито ворогів	true
random_localisation_strings_string_diplomacy_button_need_peace_to_ally	text_rejected	true
random_localisation_strings_string_right_click_building_browser	Клацніть ПКМ, щоб переглянути на сторінці будівництва	true
random_localisation_strings_string_wako_pirates_current_treasury	Поточна скарбниця:	true
random_localisation_strings_string_campaign_autoresolver_tooltip_stance_naval_balanced	При використанні збалансованої бойової стійки загони не отримають бонусів або покарань.	true
random_localisation_strings_string_enter_contested_region_warning	У Вашій рідній провінції відбувається революція. Якщо Ви введете війська, майте на увазі, що деякі з них можуть приєднатися до повстанців.\\n\\nПродовжити?	true
random_localisation_strings_string_replenish_not_required	Для вибраних загонів поповнення не потрібно.	true
random_localisation_strings_string_campaign_autoresolver_tooltip_stance_siege_aggressive	Ваші загони будуть намагатися накинутися на  ворога. Зазвичай це дієво, коли ворог має перевагу у стрільцях. Але втрати будуть більші.	true
random_localisation_strings_string_unit_concerned_general_incapacitated	Полководець недієздатний	true
random_localisation_strings_string_campaing_public_order_tooltip_header	Громадський порядок	true
random_localisation_strings_string_conversion_factor_general_christian	text_rejected	true
random_localisation_strings_string_player_stats_ranked_battles_started	Почато рейтингових битв	true
random_localisation_strings_string_diplomacy_button_no_trade_agreement_to_cancel	Немає торгівельної угоди, яку можна було б скасувати.	true
random_localisation_strings_string_network_error_incompatible_missing_map	Мапу не знайдено	true
random_localisation_strings_string_unit_encouraged_on_the_hill	На підвищені	true
random_localisation_strings_string_round_id_may	Травень	true
random_localisation_strings_string_total_numeric	Загалом	true
random_localisation_strings_string_multiplayer_time_up	У Вас закінчився час, і Ваш хід завершився.	true
random_localisation_strings_string_skill_current_level	Поточний рівень:	true
random_localisation_strings_string_Feature_unavailable	Не можливо в цій кампанії	true
random_localisation_strings_string_manoeuverability_high	Вис.	true
random_localisation_strings_string_victory_conditions_deadline	Завершити до кінця Вашого ходу через:	true
random_localisation_strings_string_StratHudbutton_cannot_demolish	Ви не в змозі зруйнувати поселення та порти, дороги чи спеціальні будівлі початкового рівня.	true
random_localisation_strings_string_reduced_unit_limit_msg	Власник (хост) зменшив максимальне число загонів, через що деякі з них було видалено з Вашого війська.	true
random_localisation_strings_string_Middle	text_rejected	true
random_localisation_strings_string_controls_save_key_list	Зберегти перелік швидких клавіш	true
random_localisation_strings_string_character_situation_zeal_inspire_army	Надихати війська	true
random_localisation_strings_string_ally_attacked_ally_attacking	Ваш союзник оголосив війну іншій держави та просить Вас допомогти!	true
random_localisation_strings_string_unit_concerned_melee_contact	Б'ються в рукопашну	true
random_localisation_strings_string_sea_region_control_status_contested	Спірний	true
random_localisation_strings_string_player_stats_ranked_naval_battles_won	Виграно рангових морських битв	true
random_localisation_strings_string_ability_phase_mask_minor_casualties	Заподіяння незначні втрати	true
random_localisation_strings_string_morale_turn_until_rebellion	За поточних справ повстання відбудеться за %n ходів.	true
random_localisation_strings_string_round_id_april	Квітень	true
random_localisation_strings_string_controls_load_key_list	Завантажити перелік швидких клавіш	true
random_localisation_strings_string_finances_vassal_income	Усього від маріонеткових і данницьких держав	true
random_localisation_strings_string_event_log_battle_defeat_minor_close	Незначна поразка	true
random_localisation_strings_string_Unit_is_suffering_attrition	Взимку загони на ворожій території зазнають втрат через виснаження. Поверніть загони з чужини, щоб зупинити подальше виснаження.	true
random_localisation_strings_string_ability_phase_mask_kill_self	Убити себе	true
random_localisation_strings_string_region_specialty_gold_mining	text_rejected	true
random_localisation_strings_string_repair_no_selection	Виберіть пошкоджені човни, щоб відремонтувати.	true
random_localisation_strings_string_effect_bundle_target_global	text_rejected	true
random_localisation_strings_string_network_message_if_not_wait_game_ends	Якщо Ви вирішите не чекати, гра закінчиться для всіх	true
random_localisation_strings_string_round_id_early_june	Початок червня	true
random_localisation_strings_string_esc_menu_legendary_cannot_save	Ви не можете зберігати ігри, граючи на легендарному рівні складності, натомість гра автоматично збережеться під час останнього ходу.	true
random_localisation_strings_string_round_id_early_october	Початок жовтня	true
random_localisation_strings_string_player_stats_ranked_naval_battles_lost	Поразок в рейтингових морських битвах	true
random_localisation_strings_string_Failed	Не вдалося	true
random_localisation_strings_string_ability_loose	Розімкнути стрій||Розімкнутий стрій розсуває шеренги воїнів, що робить їх набагато важчими для ураження снарядами і стрілами, але значно зменшує їх здатність протистояти наступу.	true
random_localisation_strings_string_unit_concerned_damaged_by_artillery	Пошкоджено артилерією	true
random_localisation_strings_string_REGION_FOOD_FACTOR_FERTILITY	Родючість	true
random_localisation_strings_string_CAMPAIGN_POLITICS_ACTION_TYPE_ADOPT	Усиновлення	true
random_localisation_strings_string_prestige_category_6	Кволий	true
random_localisation_strings_string_prestige_category_4	Середній	true
random_localisation_strings_string_prestige_category_5	Слабкий	true
random_localisation_strings_string_prestige_category_2	Величний	true
random_localisation_strings_string_prestige_category_3	Поважний	true
random_localisation_strings_string_prestige_category_1	Піднесений	true
random_localisation_strings_string_quit_game_main	Ви дійсно бажаєте все так залишити і вийти?	true
random_localisation_strings_string_building_insufficent_development_points_number	Вам потрібен %n надлишок населення.||Зачекайте, доки ця провінція достатньо виросте, або вдоскональте і переобладнайте місцеві будівлі, щоб збільшити темпи місцевого зростання.	true
random_localisation_strings_string_town_factor_technology	text_rejected	true
random_localisation_strings_string_ability_phase_mask_cant_move	Не може рухатися	true
random_localisation_strings_string_round_id_early_march	Початок березня	true
random_localisation_strings_string_agent_help_string_low_success_chance	Ваші шанси на успіх надто малі, щоб Ваш агент міг виконати цю дію.	true
random_localisation_strings_string_unit_concerned_enemy_numbers	Чисельність ворогів, що поруч	true
random_localisation_strings_string_uniform_editor_custom	На вибір	true
random_localisation_strings_string_round_id_early_july	Початок липня	true
random_localisation_strings_string_audio_provider_mono	Моно	true
random_localisation_strings_string_player_stats_campaign_land_battles_won	Виграно наземних битв в кампанії	true
random_localisation_strings_string_gfx_shader_3	Модель шейдера 3 (Low)	true
random_localisation_strings_string_gfx_shader_2	Модель шейдера 2	true
random_localisation_strings_string_gfx_shader_5	Модель шейдера 5	true
random_localisation_strings_string_gfx_shader_4	Модель шейдера 4	true
random_localisation_strings_string_CAMPAIGN_POLITICS_ACTION_TYPE_DIVORCE	Розлучення	true
random_localisation_strings_string_player_stat_battles_finished	Битв завершено	true
random_localisation_strings_string_ally_attacked_ally_defending	На Вашого союзника напали і він кличе Вас на допомогу!	true
random_localisation_strings_string_player_stats_most_men_killed	Макс. вояків вбито в бою	true
random_localisation_strings_string_owner_colon	Контролюється:	true
random_localisation_strings_string_FACTION_FOOD_FACTOR_RAIDING	Напад	true
random_localisation_strings_string_ability_phase_mask_major_casualties	Заподіяння великих втрат	true
random_localisation_strings_string_no_host_name	Перш ніж спробувати розмістити гру, введіть правильну назву гри	true
random_localisation_strings_string_FACTION_PROVINCE_FOOD_FACTOR_RECENT_BATTLES	Спустошення від битв	true
random_localisation_strings_string_unit_encouraged_flanks_secure	Фланги захищені	true
random_localisation_strings_string_ally_attacked_ally_attack_ally	Між Вашими союзниками почалася війна!	true
random_localisation_strings_string_StratHudbutton_Cannot_Recruit_Naval2	Ваша фльота уже заповнена. Щоб побудувати цей човен, Вам потрібно буде викинути інший.	true
random_localisation_strings_string_StratHudbutton_Cannot_Recruit_Naval3	Ви не в змозі побудувати тут човен, поки порт заблокований.	true
random_localisation_strings_string_StratHudbutton_Cannot_Recruit_Naval0	Неможливо побудувати човен	true
random_localisation_strings_string_StratHudbutton_Cannot_Recruit_Naval1	Ви не в змозі дозволити собі побудувати цей човен. Вартість:	true
random_localisation_strings_string_StratHudbutton_Cannot_Recruit_Naval6	Будівля вербування для цього загону пошкоджена, і її потрібно спочатку відремонтувати.	true
random_localisation_strings_string_StratHudbutton_Cannot_Recruit_Naval4	Ви не в змозі побудувати тут човен, поки порт пошкоджено.	true
random_localisation_strings_string_no_valid_units	Не знайдено потрібних загонів	true
random_localisation_strings_string_StratHudbutton_Cannot_Recruit_Naval5	Ви не в змозі побудувати тут човен, поки Ваш порт окупований ворогом.	true
random_localisation_strings_string_Recruit_Travel_Turns	Черга вербування||Число зліва показує кількість ходів, необхідних для наймання цього загону.||Число праворуч показує кількість ходів, які потрібні цьому загону, щоб досягти свого полководця-вербувальника.||Полководець може вербувати загони на полі. Набрані загони прийдуть безпосередньо до його розташування.	true
random_localisation_strings_string_diplomacy_button_cannot_wed	text_rejected	true
random_localisation_strings_string_tile_upgrade_settlement_no_escalation	Ніякої ескалації	true
random_localisation_strings_string_left_click_view_tree	Клацніть ЛКМ, щоб оглянути порядок будівництва.	true
random_localisation_strings_string_ability_disembark_from_ship	Зійти на берег||Здійснити сходження на берег загону із човна.	true
random_localisation_strings_string_ancillary_unlocking_next_turn	[[col:yellow]]Наймит або річ почне діяти тільки з наступного ходу.[[/col]]	true
random_localisation_strings_string_character_situation_zeal_incite_unrest	Підбурення	true
random_localisation_strings_string_unit_stat_bonus_melee_superior	Чудовий ближній бій	true
random_localisation_strings_string_unit_concerned_flanks_exposed_multiple	Фланги відкриті	true
random_localisation_strings_string_settlement_under_siege	text_rejected	true
random_localisation_strings_string_hosting_error	Помилка хостингу	true
random_localisation_strings_string_total_value	Загальна вартість	true
random_localisation_strings_string_captive_option_title_release	Взяти викуп і звільнити полонених	true
random_localisation_strings_string_network_error_join_failed_no_response	Не вдалося приєднатися до гри: немає відповіді від господаря(хоста)	true
random_localisation_strings_string_battle_defeat_minor_decisive	Повна поразка||Немає сумнівів: поразка — Ваша доля. Ваші люди розпорошені або мертві.	true
random_localisation_strings_string_diplomacy_button_must_be_at_peace_to_marriage	text_rejected	true
random_localisation_strings_string_battle_defeat_major_decisive	Повна поразка||Воістину: сором і безчестя заплямують пам'ять про цей день. Це жахлива поразка!	true
random_localisation_strings_string_StratHudbutton_Cannot_Enlist_General0	Не можливо призначити полководця	true
random_localisation_strings_string_StratHudbutton_Cannot_Enlist_General1	У Вас уже є максимальна кількість полководців.	true
random_localisation_strings_string_StratHudbutton_Cannot_Enlist_General2	Немає кандидатів, з яких можна було б вибрати полководця.	true
random_localisation_strings_string_StratHudbutton_Cannot_Enlist_General3	Ваша фльота уже заповнена. Щоб призначити адмірала, Ви повинні викинути один із своїх човнів.	true
random_localisation_strings_string_StratHudbutton_Cannot_Enlist_General4	Ваше військо вже повне. Щоб найняти полководця, Ви повинні розформувати один із своїх загонів.	true
random_localisation_strings_string_StratHudbutton_Cannot_Enlist_General5	Ви не в змозі дозволити собі найняти полководця. Вартість:	true
random_localisation_strings_string_player_stats_successful_assassinations	Вдалі вбивства	true
random_localisation_strings_string_mission_issued_blockade_port	Блокувати порт:	true
random_localisation_strings_string_Ship_is_suffering_attrition	Цей човен страждає від виснаження, оскільки він знаходиться у відкритому морі. Рухайте човен за межі зони виснаження, щоб зменшити втрати.	true
random_localisation_strings_string_fatigue_fresh	Свіжі	true
random_localisation_strings_string_character_type_title_brother	Брат	true
random_localisation_strings_string_agent_help_str_request_allegiance_no_support	Вплив у цій провінції надто низький. Збільште вплив до понад 50%	true
random_localisation_strings_string_unit_encouraged_kills	Ворог зазнає втрат	true
random_localisation_strings_string_unit_encouraged_in_column_formation	У колонах	true
random_localisation_strings_string_unit_encouraged_enemy_routing	Ворог дає драпака	true
random_localisation_strings_string_tech_category_military	text_rejected	true
random_localisation_strings_string_province_colon	Провінція:	true
random_localisation_strings_string_error_twitch_stream	Помилка під час трансляції на Twitch.tv. Потокове передавання припиниться.	true
random_localisation_strings_string_megabytes_formatted	%d МБ	true
random_localisation_strings_string_invalid_units	У налаштуваннях знайдено недійсний тип загону	true
random_localisation_strings_string_trade_agreement_tooltip_no_route_you	Порти Вашої рідної провінції завантажені на повну потужність.||Морський шлях із Вашої столиці неможливо встановити.	true
random_localisation_strings_string_finance_header_upkeep	Утримання	true
random_localisation_strings_string_REGION_FOOD_FACTOR_BASE_FOOD	Базове харчування	true
random_localisation_strings_string_captive_option_title_enslave	Долучити до своїх воїнів	true
random_localisation_strings_string_player_stats_ranked_land_battles_won	Виграно рейтингових наземних битв	true
random_localisation_strings_string_left_click_return_list	Клацніть ЛКМ, щоб повернутися до переліку споруд.	true
random_localisation_strings_string_network_error_no_steam	text_rejected	true
random_localisation_strings_string_military_force_legacy_name_prefix_navy	Клас	true
random_localisation_strings_string_action_result_type_critical_success	Критичний успіх	true
random_localisation_strings_string_round_id_early_april	Початок квітня	true
random_localisation_strings_string_REGION_FOOD_FACTOR_BUILDINGS	Споруди	true
random_localisation_strings_string_agent_help_string_cannot_incite_kyoto	text_rejected	true
random_localisation_strings_string_diplomacy_button_cannot_trade_embargo	Немає торгівельних шляхів, проти яких можна було б оголошувати ембарго.	true
random_localisation_strings_string_pip_daimyo_tooltip_honour_1	Гідність: ница	true
random_localisation_strings_string_pip_daimyo_tooltip_honour_2	Гідність: низька	true
random_localisation_strings_string_pip_daimyo_tooltip_honour_3	Гідність: недоведена	true
random_localisation_strings_string_pip_daimyo_tooltip_honour_4	Гідність: цінна	true
random_localisation_strings_string_pip_daimyo_tooltip_honour_5	Гідність: видатна	true
random_localisation_strings_string_pip_daimyo_tooltip_honour_6	Гідність: зразкова	true
random_localisation_strings_string_battle_warning_returning_to_postbattle	Вихід з битви через:	true
random_localisation_strings_string_mp_ready_error_ai_invalid_army_index	Гравцю зі штучним інтелектом призначається військо, яке вже зайняте. Будь ласка, призначте їм інше, перш ніж почати.	true
random_localisation_strings_string_morale_eager	Нетерплячі до бійні	true
random_localisation_strings_string_technology_tooltip_researching_functionality	Клацніть ЛКМ, щоб дослідити, клацніть ПКМ, щоб отримати додаткову інформацію.	true
random_localisation_strings_string_Tutorial_Custom_Battle_Warning_Header	Власна битва	true
random_localisation_strings_string_unit_concerned_rear_attacked	Атаковані з тилу	true
random_localisation_strings_string_FACTION_PROVINCE_FOOD_FACTOR_RAIDING	Напад	true
random_localisation_strings_string_mission_issued_public_order	Відновити громадський порядок:	true
random_localisation_strings_string_agent_help_string_region_in_rebellion	У цій провінції вже діють заколотники.	true
random_localisation_strings_string_player_stats_total_mp_land_battles_won	Всього виграних наземних битв в мережевій грі	true
random_localisation_strings_string_round_id_march	Березень	true
random_localisation_strings_string_replenish_no_selection	Виберіть не повні загони, щоб поповнити.	true
random_localisation_strings_string_round_id_late_december	Кінець грудня	true
random_localisation_strings_string_character_situation_subterfuge_spying	Шпигунство	true
random_localisation_strings_string_fe_recruitment_card_tooltip_command_clash_sea	Ви не в змозі найняти цей загін, доки у Ваших військах не буде полководця	true
random_localisation_strings_string_town_factor_ministers	text_rejected	true
random_localisation_strings_string_technology_status_available	text_rejected	true
random_localisation_strings_string_Tutorial_Custom_Battle_Warning_Content	text_rejected	true
random_localisation_strings_string_unit_stat_bonus_melee_improved	Покращений ближній бій	true
random_localisation_strings_string_StratHudbutton_Cannot_Recruit_Unit8	Ви не можете найняти цей загін, доки не вивчите та не опануєте необхідну для нього технологію.	true
random_localisation_strings_string_StratHudbutton_Cannot_Recruit_Unit9	Ви не в змозі найняти цей загін, доки не побудуєте додаткову будівлю, необхідну для нього.	true
random_localisation_strings_string_StratHudbutton_Cannot_Recruit_Unit2	Ви не в змозі дозволити собі найняти цей загін. Вартість:	true
random_localisation_strings_string_StratHudbutton_Cannot_Recruit_Unit3		true
random_localisation_strings_string_StratHudbutton_Cannot_Recruit_Unit0	Неможливо найняти загін	true
random_localisation_strings_string_StratHudbutton_Cannot_Recruit_Unit1	Немає доступного шляху від місця збору загону до вербувальника.	true
random_localisation_strings_string_StratHudbutton_Cannot_Recruit_Unit6	Чисельність населення занадто низька для набору, Вам доведеться почекати, поки вона не зросте.	true
random_localisation_strings_string_StratHudbutton_Cannot_Recruit_Unit7	Ви вже набрали максимальну кількість таких загонів.	true
random_localisation_strings_string_StratHudbutton_Cannot_Recruit_Unit4	Ви не в змозі найняти загін тут, поки Ви в облозі	true
random_localisation_strings_string_StratHudbutton_Cannot_Recruit_Unit5	Будівля вербування для цього загону пошкоджена, і її потрібно спочатку відремонтувати.	true
random_localisation_strings_string_resource_value	Цінність ресурсу	true
random_localisation_strings_string_win_chance_very_high	Дуже висок.	true
random_localisation_strings_string_unit_encouraged_overwhelming_friendly_units	Кращі місцеві сили	true
random_localisation_strings_string_battle_defeat_close_phyrric	Героїчна поразка||Ворог переміг, але це йому дорого коштувало. Їхні мертві тіла удобрюють землю!	true
random_localisation_strings_string_network_error_join_failed_closed_game	Не вдалося приєднатися до гри: гра триває	true
random_localisation_strings_string_CAMPAIGN_POLITICS_ACTION_TYPE_SPREAD_RUMOURS	Поширення чуток	true
random_localisation_strings_string_ability_drop_siege_equipment	Кинути облогові машини||Ваш загін покине облогові машини.	true
random_localisation_strings_string_event_log_battle_defeat_close_phyrric	Героїчна поразка	true
random_localisation_strings_string_Unit_not_replenishing_09_expedition	Загони експедиції можуть поповнюватися лише в таборі або на території союзників.	true
random_localisation_strings_string_Tutorial_Custom_Battle_Warning	text_rejected	true
random_localisation_strings_string_technology_status_unavailable_to_steal	Або ця технологія вже відома, або Ви недостатньо розвинені, щоб її використовувати.	true
random_localisation_strings_string_town_factor_bankruptcy	Банкрутство	true
random_localisation_strings_string_diplomacy_button_need_access_to_cancel_access	Немає військового доступу, який можна скасувати.	true
random_localisation_strings_string_finances_tribute_expenditure_breakdown_other	text_rejected	true
random_localisation_strings_string_network_message_not_responding_client	Один або більше гравців не відповідають. Продовжити очікування чи все таки залишити цю гру?	true
random_localisation_strings_string_religion_factor_percentage_next_turn	Відсоток наступного ходу: %d%	true
random_localisation_strings_string_fe_unit_card_tooltip_cap_land	Загони цього типу обмежено %d на армію.	true
random_localisation_strings_string_FACTION_PROVINCE_FOOD_FACTOR_EDICTS	Едикти	true
random_localisation_strings_string_FACTION_PROVINCE_FOOD_FACTOR_EVENTS	Події провінції	true
random_localisation_strings_string_stats_clan_clan_total_ranked_game_wins	text_rejected	true
random_localisation_strings_string_campaign_type_world_domination	Кампанія "Світове панування"	true
random_localisation_strings_string_stat_ap_damage	Шкода крізь обладунки	true
random_localisation_strings_string_food_breakdown	Подробиці про їжу	true
random_localisation_strings_string_resource_exporting_percentage_not_full	Збільшення торгівельних шляхів збільшить відсоток цього ресурсу, який Ви можете експортувати.	true
random_localisation_strings_string_unit_concerned_flanks_exposed_single	Оголений фланг	true
random_localisation_strings_string_military_force_legacy_name_pirate_navy	Піратська фльота	true
random_localisation_strings_string_gfx_drop_ultra	Дуже висок.	true
random_localisation_strings_string_mission_issued_trade_agreement	Налагодити торгівлю:	true
random_localisation_strings_string_mp_ready_error_no_map_selected	Жодна мапа не вибрана	true
random_localisation_strings_string_finance_header_raided	Напад	true
random_localisation_strings_string_campaign_type_co_op	Спільна гра	true
random_localisation_strings_string_predicted_with_units_removed	передбачено, якщо вибрані загони будуть прибрані із залоги	true
random_localisation_strings_string_gfx_shader_4_1	Модель шейдера 4.1	true
random_localisation_strings_string_trade_agreement_tooltip_existing_route_shifted	Один із Ваших поточних морських торгівельних шляхів можна перевести на суходіл.||Є Можливість встановити інший морський шлях із Вашої столиці.	true
random_localisation_strings_string_state_religion_change_active	Зміна релігії	true
random_localisation_strings_string_technology_status_researched	text_rejected	true
random_localisation_strings_string_StratHud_Unit_Card_Recruit_Selection	Клацніть ЛКМ, щоб найняти цей загін, клацніть ПКМ, щоб отримати додаткову інформацію.	true
random_localisation_strings_string_victory_conditions_conquest_tutorial	Захопіть і утримуйте %n провінцій, включно з такими:	true
random_localisation_strings_string_FACTION_FOOD_FACTOR_RIVALRY	Суперництво	true
random_localisation_strings_string_pre_battle_siege_equipment_totals_tooltip_cap	\\nМісткість: %d	true
random_localisation_strings_string_CAMPAIGN_POLITICS_ACTION_TYPE_BRIBE	Підкуп	true
random_localisation_strings_string_character_situation_subterfuge_assassination	Вбивства	true
random_localisation_strings_string_StratHudbutton_cannot_disembark_here	Неможливо зійти на берег||Ви не в змозі зійти на берег, тому що ця місцина непрохідна.	true
random_localisation_strings_string_home_region_expedition	Немає (Експедиція)	true
random_localisation_strings_string_fatigue_tired	Втомилися	true
random_localisation_strings_string_network_error_stats_no_steam	text_rejected	true
random_localisation_strings_string_FACTION_FOOD_FACTOR_FERTILITY	Родючість	true
random_localisation_strings_string_mission_issued_form_alliance	Утворити альянс (союз):	true
random_localisation_strings_string_FACTION_PROVINCE_FOOD_FACTOR_HORDES	Орди в цій провінції	true
random_localisation_strings_string_morale_20	Вагаються	true
random_localisation_strings_string_benchmark_dialog_title	Залишити тестування	true
random_localisation_strings_string_military_force_legacy_name_prefix_army	Легіон	true
random_localisation_strings_string_Tutorial_First_Battle_Warning	text_rejected	true
random_localisation_strings_string_battle_time_remaining	Час, що залишився:	true
random_localisation_strings_string_network_error_dropped	Ви втратили зв'язок з грою.	true
random_localisation_strings_string_overwrite_legendary_save_warning_text	Почавши нову гру на легендарному рівні,  Ви перезапишете поточне легендарне збереження. Ви все ще бажаєте продовжити?	true
random_localisation_strings_string_campaign_type_short	Велика кампанія	true
random_localisation_strings_string_network_error_authentication_failed	Ви не авторизовані грати	true
random_localisation_strings_string_mp_ready_error_no_commander	Ви повинні додати командувача перед початком бою.	true
random_localisation_strings_string_finance_header_taxes	Податки	true
random_localisation_strings_string_unit_concerned_attacked_by_projectile	Під обстрілом	true
random_localisation_strings_string_finance_header_other	Інше	true
random_localisation_strings_string_finance_header_mines	Копальні	true
random_localisation_strings_string_event_log_battle_defeat_major_decisive	Повна поразка	true
random_localisation_strings_string_land_combatant_losing_slightly	Загін трохи програє	true
random_localisation_strings_string_weather_tooltips_storm	Піщаний буревій|| Щоб підпалити човни, будівлі та укріплення, потрібно більше часу.	true
random_localisation_strings_string_August	text_rejected	true
random_localisation_strings_string_mp_ready_error_too_many_armies	Ви не в змозі почати, оскільки забагато гравців для цієї мапи. \\nАбо змініть мапу, або видаліть деяких гравців.	true
random_localisation_strings_string_campaign_autoresolver_tooltip_stance_naval_defensive	Ваші загони займуть оборонну позицію. Зазвичай це дієво, коли у Вас є більше стрільців. Це зменшить втрати.	true
random_localisation_strings_string_agent_help_string_cannot_incite_own_religion	text_rejected	true
random_localisation_strings_string_finance_header_trade	Торгівля	true
random_localisation_strings_string_unit_encouraged_fortification	Всередині укріплення	true
random_localisation_strings_string_character_type_title_general	Полководець	true
random_localisation_strings_string_bribe_nonhostile_panel_title	Спроба маніпуляції	true
random_localisation_strings_string_MILITARY_FORCE_FOOD_FACTOR_FERTILITY	Родючість	true
random_localisation_strings_string_character_role_wife	Дружина	true
random_localisation_strings_string_finance_header_agent_actions	Дії агентів	true
random_localisation_strings_string_finance_header_ransom_battle_captives	Викуп за військовополонених	true
random_localisation_strings_string_character_situation_land_siege_attack	Облогові напади	true
random_localisation_strings_string_chat_help_text	ПІДКАЗКА\\nФормат команди: /команда аргумент1 аргумент2 \\nВи можете рухатися між варіантами за допомогою клавіш ВГОРУ/ВНИЗ і натискати TAB, щоб вибрати пропозицію (для команд спілкування та імен гравців).\\n\\nДоступні команди:\\n	true
random_localisation_strings_string_Empty_building_warning	\\n\\nЯкщо Ви залишите це місце без розвитку на довгий час, тут з'являться нетрі.	true
random_localisation_strings_string_Change_Reinforcement_Position	Перетягуйте картки загонів, щоб змінити їхню позицію в черзі підкріплення.	true
random_localisation_strings_string_class_lower	Нижчі класи	true
random_localisation_strings_string_network_error_title	Помилка	true
random_localisation_strings_string_class_upper	Аристократія	true
random_localisation_strings_string_victory_conditions_one_vs_one	text_rejected	true
random_localisation_strings_string_region_colon	Регіон:	true
random_localisation_strings_string_diplomacy_button_need_peace_to_trade	text_rejected	true
random_localisation_strings_string_battle_filter_naval	Морські битви	true
random_localisation_strings_string_morale_60	Надійні	true
random_localisation_strings_string_finance_header_total_expenses	Загальні витрати	true
random_localisation_strings_string_StratHudbutton_Cannot_Repair_Naval2	Ви можете ремонтувати човни лише в порту	true
random_localisation_strings_string_StratHudbutton_Cannot_Repair_Naval0	Неможливо відремонтувати	true
random_localisation_strings_string_StratHudbutton_Cannot_Repair_Naval1	Ви не в змозі дозволити собі ремонт цього. Вартість:	true
random_localisation_strings_string_trade_status_tooltip_cannot	Не може займатися торгівлею	true
random_localisation_strings_string_player_stats_num_pistol_duels	text_rejected	true
random_localisation_strings_string_Unit_not_replenishing_09	Орди можуть поповнюватись лише в таборі або на території союзників.	true
random_localisation_strings_string_Unit_not_replenishing_08	- Ця фльота не в дружніх водах.	true
random_localisation_strings_string_Unit_not_replenishing_05	- Ви банкрут.	true
random_localisation_strings_string_Unit_not_replenishing_04	- В облозі.	true
random_localisation_strings_string_Unit_not_replenishing_07	- Ця військо не на дружній території.	true
random_localisation_strings_string_Unit_not_replenishing_06	- Нестача харчів.	true
random_localisation_strings_string_Unit_not_replenishing_01	Цей загін не може бути поповнений через:	true
random_localisation_strings_string_Unit_not_replenishing_03	- У цього війська немає полководця.	true
random_localisation_strings_string_Unit_not_replenishing_02	- Останні події	true
random_localisation_strings_string_round_id_early_january	Початок січня	true
random_localisation_strings_string_StratHudbutton_Cannot_Recruit_Geisha2	Ви не в змозі дозволити собі найняти цього агента. Вартість:	true
random_localisation_strings_string_character_situation_subterfuge_sabotage_army	Саботаж у війську	true
random_localisation_strings_string_auto_save_filename_legendary	auto_save_legendary	true
random_localisation_strings_string_stats_clan_best_clan_map_rank	text_rejected	true
random_localisation_strings_string_gempei_religion_colon	Вірність:	true
random_localisation_strings_string_StratHudbutton_cannot_enlist_no_cand	text_rejected	true
random_localisation_strings_string_morale_40	Слухняні	true
random_localisation_strings_string_mp_ready_error_no_siege_units	Ви повинні вибрати кілька піхотних або артилерійських загонів, здатних атакувати укріплення.	true
random_localisation_strings_string_Unit_not_replenishing_10	Військо ворога в регіоні блокує поповнення	true
random_localisation_strings_string_tax_level_4	Здирницький	true
random_localisation_strings_string_tax_level_0	Мінімальний	true
random_localisation_strings_string_tax_level_1	Низький	true
random_localisation_strings_string_tax_level_2	Нормальний	true
random_localisation_strings_string_tax_level_3	Високий	true
random_localisation_strings_string_ship_card_red_captured	Цей човен захопив ворог!	true
random_localisation_strings_string_fe_unit_card_tooltip_cap_naval	Загони цього типу обмежено %d на фльоту.	true
random_localisation_strings_string_StratHudbutton_Cannot_Recruit_Metuske2	Ви не в змозі дозволити собі найняти цього агента. Вартість:	true
random_localisation_strings_string_trade_route_tooltip_neutral	(інше)	true
random_localisation_strings_string_cannot_merge_agent_not_enough_action_points	Цей агент не має достатньо очок дій, щоб досягти до іншого збройного формування.	true
random_localisation_strings_string_player_stats_successful_duels	Успішні дуелі	true
random_localisation_strings_string_FACTION_PROVINCE_FOOD_FACTOR_ARMIES	Ворожі війська в цій провінції	true
random_localisation_strings_string_conversion_factor_characters_christian	text_rejected	true
random_localisation_strings_string_land_combatant_winning	Загін перемагає	true
random_localisation_strings_string_repair_prerequisites_not_met	Вам потрібно бути в порту і мати достатньо коштів, щоб відремонтувати вибрані човни цієї фльоти. Вартість:	true
random_localisation_strings_string_agent_recruitment_insufficient_money	[[col:red]]У Вашій скарбниці недостатньо коштів, щоб завербувати цю особу.[[/col]]	true
random_localisation_strings_string_trade_status_tooltip_value_potential	\\nЙмовірна вартість	true
random_localisation_strings_string_weather_tooltips_snow	Сніг||Загони рухаються повільніше в снігу і потребують більше часу, щоб відновитися після втоми.	true
random_localisation_strings_string_Empty_building	Будівельний майданчик||Тут можна будувати нові споруди.	true
random_localisation_strings_string_unit_encouraged_general_nearby	Полководець поруч	true
random_localisation_strings_string_unit_concerned_friends_routing	Союзники тікають	true
random_localisation_strings_string_public_order	Поточний громад. порядок	true
random_localisation_strings_string_trade_route	Торгівельний шлях	true
random_localisation_strings_string_agent_recruitment_reduced_bodyguard	[[col:red]]Недостатньо коштів – поточний захін охоронців буде недоукомплектований.[[/col]]	true
random_localisation_strings_string_FACTION_FOOD_FACTOR_BUILDINGS	Споруди	true
random_localisation_strings_string_SkillTree_Skill_Unavailable_Function_Tooltip_0	Недоступно	true
random_localisation_strings_string_character_situation_zeal_inspire_town	text_rejected	true
random_localisation_strings_string_SkillTree_Skill_Unavailable_Function_Tooltip_1	Ви не маєте необхідних очок вмінь, щоб придбати це.	true
random_localisation_strings_string_SkillTree_Skill_Unavailable_Function_Tooltip_2	Ви не відповідаєте вимогам.	true
random_localisation_strings_string_SkillTree_Skill_Unavailable_Function_Tooltip_3	Цей вміння відноситься до іншої гілки.	true
random_localisation_strings_string_trade_node_tooltip_predicted_supply	попередня кількість припасів, які будуть отримані	true
random_localisation_strings_string_player_stats_ranked_land_battles_lost	Поразок в рейтингових наземних битвах	true
random_localisation_strings_string_stats_clan_current_highest_ranked_4v4_clan_team_na	text_rejected	true
random_localisation_strings_string_mission_issued_build_building	Побудувати споруду:	true
random_localisation_strings_string_campaign_difficulty_slider_legendary	Збереження власноруч заборонено в кампанії. Накази не можливо віддавати, коли битва призупинена.	true
random_localisation_strings_string_campaign_type_prestige	Впливова перемога	true
random_localisation_strings_string_controls_empty	<Порожньо>	true
random_localisation_strings_string_fe_recruitment_card_tooltip_required_ancillary	Для використання цього необхідно мати даного наймита у господі Вашого персонажа:	true
random_localisation_strings_string_town_factor_discontent	Незадоволення	true
random_localisation_strings_string_FACTION_FOOD_FACTOR_BASE_FOOD	Базове харчування	true
random_localisation_strings_string_event_log_battle_victory_minor_close	Важка перемога	true
random_localisation_strings_string_diplomacy_button_cannot_military_access_war	text_rejected	true
random_localisation_strings_string_weather_storm	Піщаний буревій	true
random_localisation_strings_string_diplomacy_header_other_clans	text_rejected	true
random_localisation_strings_string_campaign_autoresolver_tooltip_stance_siege_defensive	Ваші загони займуть оборонну позицію. Зазвичай це дієво, коли у Вас є більше стрільців. Це зменшить втрати.	true
random_localisation_strings_string_unit_card_lost_hero_disbanded	text_rejected	true
random_localisation_strings_string_morale_80	Віддані	true
random_localisation_strings_string_player_stats_friendly_units_rallied	Макс. дружніх загонів згуртовано	true
random_localisation_strings_string_agent_cannot_act_force_full	Це військо вже має максимальну кількість агентів.	true
random_localisation_strings_string_front_end_unit_size_with_fleet_tooltip	Змінює кількість людей у кожному загоні в наземних боях і максимальну кількість човнів, дозволену у фльоті. Зменшення кількості може значно покращити ігрову продуктивність у боях.	true
random_localisation_strings_string_region_specialty_stone	text_rejected	true
random_localisation_strings_string_region_specialty_iron_mining	text_rejected	true
random_localisation_strings_string_finance_header_income	Прибуток	true
random_localisation_strings_string_action_result_type_critical_failure	Критична невдача	true
random_localisation_strings_string_stat_xp_value	Додатковий досвід	true
random_localisation_strings_string_stats_clan_current_highest_ranked_2v2_clan_team_na	text_rejected	true
random_localisation_strings_string_town_factor_education	Освіта	true
random_localisation_strings_string_stats_clan_current_clan_ladder_rank	text_rejected	true
random_localisation_strings_string_unit_concerned_fear_enemy_unit	Налякані ворожим загоном	true
random_localisation_strings_string_trade_route_tooltip_raid_value	Ціна рейду на торгівельні шляхи:	true
random_localisation_strings_string_StratHudbutton_Ruined_Building	Зруйнована будівля||Поки не буде відремонтовано, ця будівля неефективна.	true
random_localisation_strings_string_finances_tribute_expenditure_breakdown_faction	%S (залишилося ходів %d)	true
random_localisation_strings_string_round_id_late_february	Кінець лютого	true
random_localisation_strings_string_tech_required_for_construction	text_rejected	true
random_localisation_strings_string_diplomacy_button_no_trade_to_demand_they_break	text_rejected	true
random_localisation_strings_string_MILITARY_FORCE_FOOD_FACTOR_CHARACTERS	Персонажі	true
random_localisation_strings_string_building_under_construction_damaged_demolish	Натисніть тут, щоб скасувати ремонт недобудови.	true
random_localisation_strings_string_event_log_rebellion_christian	text_rejected	true
random_localisation_strings_string_replenish_selection	Поповнюйте неповні загони в цій вибірці. Вартість:	true
random_localisation_strings_string_stats_clan_current_highest_ranked_3v3_clan_team_na	text_rejected	true
random_localisation_strings_string_character_situation_land_siege_defence	Облогова оборона	true
random_localisation_strings_string_cannot_enter_enemy_zoc	Ви не в змозі увійти в зону контролю ворожої сили, окрім як здійснити атаку.	true
random_localisation_strings_string_round_id_late_november	Кінець листопада	true
random_localisation_strings_string_Single	Одноосібна	true
random_localisation_strings_string_ability_formed_attack	Напад в строю||Загін намагатиметься не залишати стрій під час ближнього бою.	true
random_localisation_strings_string_unit_card_lost_men_captured	Цей загін захоплено ворогом.	true
random_localisation_strings_string_tech_building_tooltip2	text_rejected	true
random_localisation_strings_string_tech_building_tooltip1	text_rejected	true
random_localisation_strings_string_finance_header_civic	Громада	true
random_localisation_strings_string_MILITARY_FORCE_FOOD_FACTOR_BASE_FOOD	Базове харчування	true
random_localisation_strings_string_confirm_delete_title	Підтвердьте видалення	true
random_localisation_strings_string_cancel_demolish_building_once_settled	Орда повинна осісти, щоб закінчити демонтаж цієї будівлі. Клацніть ЛКМ, щоб скасувати знесення.	true
random_localisation_strings_string_clan_promotion	text_rejected	true
random_localisation_strings_string_tech_category_enlightenment	text_rejected	true
random_localisation_strings_string_conversion_factor_buildings_christian	text_rejected	true
random_localisation_strings_string_MILITARY_FORCE_FOOD_FACTOR_BUILDINGS	Споруди	true
random_localisation_strings_string_weather_tooltips_rain	Дощ|| Щоб запалити човни, будівлі та укріплення, потрібно більше часу.	true
