key	text	tooltip
#Loc;1;text/db/scripted_subtitles.loc		
scripted_subtitles_localised_text_Att.Pro.Olbia.Intro_01	370 р. н.е.	true
scripted_subtitles_localised_text_Att.Pro.Olbia.Intro_02	Ольвія, на узбережжі Чорного моря, є основним поселенням вестготів.	true
scripted_subtitles_localised_text_Att.Pro.Olbia.Intro_03	Вестготські вояки в повній бойовій готовності. Назріває остання битва тривалої громадянської війни.	true
scripted_subtitles_localised_text_Att.Pro.Olbia.Intro_04	Остготи, ворожі племена готського народу, знову атакують.	true
scripted_subtitles_localised_text_Att.Pro.Olbia.Intro_05	Оборона Ольвії повинна витримати напад остготів, інакше вестготи зникнуть	true
scripted_subtitles_localised_text_Att.Pro.Olbia.First_Hunnic_Attack_01	Володарю, нас знову атакують!	true
scripted_subtitles_localised_text_Att.Pro.Olbia.Ostrogoth_Victory_01	Остготи тікають, рятуючи своє життя! Перемога за нами!	true
scripted_subtitles_localised_text_Att.HB.UT.Intro_04	Римський полководець Арнегіскл зібрав величезне військо, щоб зупинити Аттилу.	true
scripted_subtitles_localised_text_Att.HB.UT.Intro_05	Дві армії зійшлися в битві на берегах річки Ут.	true
scripted_subtitles_localised_text_Att.HB.UT.Intro_01	447 р. н.е	true
scripted_subtitles_localised_text_Att.HB.UT.Intro_02	Військові дії були оголошені між гунами та Східною Римською імперією після відмови щорічної данини золотом.	true
scripted_subtitles_localised_text_Att.HB.UT.Intro_03	Гунський король Аттила зі своєю армією штурмував балканські регіони, що належали Східній імперії.	true
scripted_subtitles_localised_text_Att.HB.CP.Intro_04	Римляни неочікувано знайшли союзника в особі Теодоріха I, короля вестготів.	true
scripted_subtitles_localised_text_Att.HB.CP.Intro_05	Перехопивши Аттилу на Каталаунських рівнинах, обидві сторони зійшлися в битві.	true
scripted_subtitles_localised_text_Att.HB.CP.Intro_01	20 червня 451 р. н.е.	true
scripted_subtitles_localised_text_Att.HB.CP.Intro_02	Гуни Аттили розпочали напад на Галлію, грабуючи міста і містечка.	true
scripted_subtitles_localised_text_Att.HB.CP.Intro_03	Побоюючись нападу на Північну Італію, Магістр армії Флавій Аецій зібрав військо, щоб перешкодити просуваннюгунів.	true
scripted_subtitles_localised_text_Att.HB.FR.Intro_04	Легіони Феодосія підкріплені його вестготськими союзниками на чолі з їхнім вождем Аларіхом.	true
scripted_subtitles_localised_text_Att.HB.FR.Intro_05	Дві сторони нарешті зіткнулися на берегах річки Фрігід. Майбутнє Імперії вирішиться на цьому бойовищі.	true
scripted_subtitles_localised_text_Att.HB.FR.Intro_01	6 вересня 394 р. н.е.	true
scripted_subtitles_localised_text_Att.HB.FR.Intro_02	Прихильник язичництва Євгеній, лідер Західної імперії, перешкоджає християнізації Риму.	true
scripted_subtitles_localised_text_Att.HB.FR.Intro_03	Східний імператор Феодосій I, побожний християнин, рушив армію зі Сходу, щоб кинути виклик Євгенію.	true
scripted_subtitles_localised_text_Att.Pro.Intro_04	Проте до римського світу наближається більша загроза. Наближаються гуни.  Народи на шляху орди, постають перед вибором: тікати чи померти.	true
scripted_subtitles_localised_text_Att.Pro.Intro_05	Готи в громадянські боротьбі, незабаром зіткнуться труднощами. Те, що почалося як міжусобиця між готськими народами, закінчиться їхнім постійним переселенням на римські землі, гунами на кордонах імперії та імператором, який лежить мертвий на бойовищі...	true
scripted_subtitles_localised_text_Att.Pro.Intro_02	Зі свого центру в Медіоланумі корумпований і елітарний Західний Сенат бореться проти військових повстань і постійних варварських набігів на півночі.	true
scripted_subtitles_localised_text_Att.Pro.Intro_03	Східна імперія з центром в Константинополі, повинна боротися з релігійними потрясіннями та загрозою Сасанідів на Сході.	true
scripted_subtitles_localised_text_Att.Pro.Intro_01	Це 370 рік нашої ери, майже 400 років з моменту утворення імперії. Рим, який раніше не мав жодного суперника в Середземномор’ї, тепер занепадає. Тепер римляни опинилися імперії, що розкололася на дві частини.	true
scripted_subtitles_localised_text_Att.HB.AD.Intro_04	Дві армії зустрінуться на узбережжі Середземного моря.	true
scripted_subtitles_localised_text_Att.HB.AD.Intro_01	13 вересня 533 р. н.е.	true
scripted_subtitles_localised_text_Att.HB.AD.Intro_02	Полководець Східної Римської імперії Велізарій вдерся в Північну Африку в надії відвоювати провінцію.	true
scripted_subtitles_localised_text_Att.HB.AD.Intro_03	Попереджений про неминучий напад, король Вандальського королівства Гелімер розташував свої сили біля Ад-Децим.	true
scripted_subtitles_localised_text_Att.HB.DA.Intro_08	Отже, римляни знають, що незабаром їх чекає битва.	true
scripted_subtitles_localised_text_Att.HB.CA.Intro_04	Кілька західноримських капітанів були підкуплені і тепер воюють разом з вандалами.	true
scripted_subtitles_localised_text_Att.HB.DA.Intro_04	Велізарій повинен змінити хід війни, яка поки, що не на користь римлянам.	true
scripted_subtitles_localised_text_Att.HB.RA.Intro_04	Падіння Равенни означатиме кінець римського панування над Італією.	true
scripted_subtitles_localised_text_Att.HB.SA.Intro_04	Намагаючись деморалізувати і виморити римлян, Сасаніди послали численні бойові загони, щоб переслідувати їх.	true
scripted_subtitles_localised_text_Att.HB.CA.Intro_05	Поразка римлян у Карфахені, безумовно, поклала б край їхнім прагненням відвоювати Африку.	true
scripted_subtitles_localised_text_Att.HB.DA.Intro_05	Він укріплює місто Дара, що лежить неподалік від ворожого кордону. Сасаніди послали армію під орудою Пероза, щоб зупинити його.	true
scripted_subtitles_localised_text_Att.HB.SA.Intro_05	Тепер сасанідська армія атакує Самарру, намагаючись покласти край війні.	true
scripted_subtitles_localised_text_Att.HB.DA.Intro_06	Переважаючи чисельно, римляни вирили траншею перед мурами, щоб підсилити оборону міста.	true
scripted_subtitles_localised_text_Att.HB.DA.Intro_07	Пероз послав Велізарію повідомлення, щоб йому приготували ванну в місті.	true
scripted_subtitles_localised_text_Att.HB.CA.Intro_01	13 травня 461 р. н.е. 	true
scripted_subtitles_localised_text_Att.HB.DA.Intro_01	530 р. н.е.	true
scripted_subtitles_localised_text_Att.HB.RA.Intro_01	2 вересня 476 р. н.е.	true
scripted_subtitles_localised_text_Att.HB.SA.Intro_01	26 червня 363 р. н.е.	true
scripted_subtitles_localised_text_Att.HB.CA.Intro_02	Римський імператор Майоріан побудував фльоту, за допомогою якої він планує вдертися в окуповану вандалами Північну Африку.	true
scripted_subtitles_localised_text_Att.HB.DA.Intro_02	Римська і Сасанідська імперії воюють між собою.	true
scripted_subtitles_localised_text_Att.HB.RA.Intro_02	Герули - федерати Західної Римської імперії, повстали. Їх очолює їхній цар Одоакр.	true
scripted_subtitles_localised_text_Att.HB.SA.Intro_02	Імператор Східної Римської імперії Юліан очолив експедицію до Персії.	true
scripted_subtitles_localised_text_Att.HB.CA.Intro_03	Усвідомлюючи можливість нападу, вандали завдали удару першими, перш ніж римська фльота не стала сильною.	true
scripted_subtitles_localised_text_Att.HB.DA.Intro_03	Римський імператор Юстиніан призначив молодого Велізарія командувачем своєї армії на сході.	true
scripted_subtitles_localised_text_Att.HB.RA.Intro_03	Залишки римської армії в Італії тепер збираються, щоб захистити столицю Равенну від наступу Одоакра.	true
scripted_subtitles_localised_text_Att.HB.SA.Intro_03	Не маючи змоги захопити столицю Сасанідів Ктезифон, Юліан відтягнув свої сили назад на північ.	true
scripted_subtitles_localised_text_Att.HB.CB.Intro_04	Інша римська фльота, що пливе з Сардинії, атакує зі сходу.	true
scripted_subtitles_localised_text_Att.HB.CB.Intro_05	Тепер вандали повинні використовувати всю зброю зі свого арсеналу, щоб протистояти нападу римлян.	true
scripted_subtitles_localised_text_Att.HB.CB.Intro_01	468 р. н.е.	true
scripted_subtitles_localised_text_Att.HB.CB.Intro_02	Після пограбування Риму в 455 році нашої ери обидві Римські імперії розробили план покарання короля вандалів Гейзеріха.	true
scripted_subtitles_localised_text_Att.HB.CB.Intro_03	Римська фльота під проводом Василіска атакує із заходу, пропливаючи повз окупований вандалами Карфаген.	true
scripted_subtitles_localised_text_Att.HB.AN.Intro_04	Незначні сили готів отаборилися на вершині пагорба. Незважаючи не те, що римляни перебували в русі, маючи чисельну перевагу вони починають атакувати.	true
scripted_subtitles_localised_text_Att.HB.AN.Intro_05	Римляни не знали, що готська кіннота вже недалеко. Вони обов’язково повинні повернуться до табору.	true
scripted_subtitles_localised_text_Att.HB.AN.Intro_06	Готи повинні протистояти нападу римлян, доки не прибуде їхнє підкріплення.	true
scripted_subtitles_localised_text_Att.HB.AN.Intro_01	9 серпня 378 р. н.е.	true
scripted_subtitles_localised_text_Att.HB.AN.Outro_01	Смерть Валента і знищення його армії означали виживання готського народу на території Імперії.	true
scripted_subtitles_localised_text_Att.HB.AN.Intro_02	Адріанополь, Фракія.	true
scripted_subtitles_localised_text_Att.HB.AN.Outro_02	Римляни більше не контролювали власні кордони. Вторгнення готів передвіщало велике переселення, яке гнали гуни, на римські землі.	true
scripted_subtitles_localised_text_Att.HB.AN.Intro_03	Імператор Валент особисто веде римську армію до Адріанополя, намагаючись розгромити готів.	true
scripted_subtitles_localised_text_Att.HB.AN.Outro_03	Це переселення спонукало до пограбування Риму та сприяло розпаду Західної імперії.	true
scripted_subtitles_localised_text_Att.HB.SO.Intro_04	Захоплення Суассона подвоїло б розмір Франкського королівства.	true
scripted_subtitles_localised_text_Att.HB.SO.Intro_01	486 р. н.е.	true
scripted_subtitles_localised_text_Att.HB.SO.Intro_02	Західна Римська імперія розпалася. У Галлії залишається окрема держава, Суассонська область, на чолі з Сіагрієм.	true
scripted_subtitles_localised_text_Att.HB.SO.Intro_03	Проте землі Сіагрія жадають сусідні франки. Франкський король Хлодвіг I викликав його на бій.	true
