key	text	tooltip
#Loc;1;text/db/start_pos_regions.loc		
start_pos_regions_long_description_att_reg_tripolitana_macomadesmain_attila	placeholder	true
start_pos_regions_rebel_faction_name_att_reg_syria_tyruspro_attila	Заколотники	true
start_pos_regions_long_description_att_reg_baetica_malacamain_attila	placeholder	true
start_pos_regions_long_description_att_reg_asorstan_arbelamain_attila	placeholder	true
start_pos_regions_rebel_faction_name_cha_reg_marca_inferior_coimbracha_attila	Заколотники	true
start_pos_regions_rebel_faction_name_cha_reg_eastphalia_halberstadtcha_attila	Заколотники	true
start_pos_regions_rebel_faction_name_cha_reg_obodrites_havelbergcha_attila	Заколотники	true
start_pos_regions_rebel_faction_name_att_reg_aquitania_burdigalamain_attila	Заколотники	true
start_pos_regions_rebel_faction_name_att_reg_africa_hadrumentummain_attila	Заколотники	true
start_pos_regions_rebel_faction_name_cha_reg_croatia_ptujcha_attila	Заколотники	true
start_pos_regions_rebel_faction_name_att_reg_libya_augilamain_attila	Заколотники	true
start_pos_regions_rebel_faction_name_att_reg_spahan_susamain_attila	Заколотники	true
start_pos_regions_rebel_faction_name_cha_reg_frisia_ghentcha_attila	Заколотники	true
start_pos_regions_rebel_faction_name_cha_reg_septimania_toulousecha_attila	Заколотники	true
start_pos_regions_rebel_faction_name_bel_reg_apulia_et_calabria_tarentumbel_attila	Заколотники	true
start_pos_regions_rebel_faction_name_att_reg_aquitania_burdigalapro_attila	Заколотники	true
start_pos_regions_rebel_faction_name_att_reg_makran_phramain_attila	Заколотники	true
start_pos_regions_rebel_faction_name_cha_reg_france_parischa_attila	Заколотники	true
start_pos_regions_rebel_faction_name_att_reg_sarmatia_asiatica_samandarmain_attila	Заколотники	true
start_pos_regions_long_description_att_reg_osroene_nisibispro_attila	placeholder	true
start_pos_regions_rebel_faction_name_cha_reg_wilzi_cottbuscha_attila	Заколотники	true
start_pos_regions_long_description_att_reg_dalmatia_domaviapro_attila	placeholder	true
start_pos_regions_rebel_faction_name_att_reg_spahan_issatispro_attila	Заколотники	true
start_pos_regions_rebel_faction_name_att_reg_tarraconensis_caesaraugustapro_attila	Заколотники	true
start_pos_regions_long_description_att_reg_cilicia_iconiumpro_attila	placeholder	true
start_pos_regions_rebel_faction_name_bel_reg_italia_reatebel_attila	Заколотники	true
start_pos_regions_rebel_faction_name_att_reg_arabia_felix_eudaemonmain_attila	Заколотники	true
start_pos_regions_long_description_att_reg_lugdunensis_rotomagusmain_attila	placeholder	true
start_pos_regions_rebel_faction_name_att_reg_britannia_inferior_segontiummain_attila	Заколотники	true
start_pos_regions_long_description_att_reg_media_atropatene_rhagapro_attila	placeholder	true
start_pos_regions_rebel_faction_name_bel_reg_flaminia_et_picenum_bononiabel_attila	Заколотники	true
start_pos_regions_rebel_faction_name_att_reg_lugdunensis_lugdunumpro_attila	Заколотники	true
start_pos_regions_long_description_att_reg_liguria_segusiopro_attila	placeholder	true
start_pos_regions_long_description_att_reg_venetia_ravennapro_attila	placeholder	true
start_pos_regions_rebel_faction_name_bel_reg_carthaginensis_carthago_novabel_attila	Заколотники	true
start_pos_regions_rebel_faction_name_att_reg_macedonia_dyrrhachiumpro_attila	Заколотники	true
start_pos_regions_rebel_faction_name_att_reg_mauretania_tamousigapro_attila	Заколотники	true
start_pos_regions_rebel_faction_name_att_reg_raetia_et_noricum_augusta_vindelicorumpro_attila	Заколотники	true
start_pos_regions_rebel_faction_name_att_reg_britannia_superior_camulodunonpro_attila	Заколотники	true
start_pos_regions_rebel_faction_name_bel_reg_apulia_et_calabria_sipontumbel_attila	Заколотники	true
start_pos_regions_long_description_att_reg_thracia_marcianopolismain_attila	placeholder	true
start_pos_regions_long_description_att_reg_osroene_edessapro_attila	placeholder	true
start_pos_regions_rebel_faction_name_att_reg_cappadocia_trapezusmain_attila	Заколотники	true
start_pos_regions_rebel_faction_name_cha_reg_northumbria_bamburghcha_attila	Заколотники	true
start_pos_regions_rebel_faction_name_cha_reg_mercia_chestercha_attila	Заколотники	true
start_pos_regions_rebel_faction_name_att_reg_syria_tyrusmain_attila	Заколотники	true
start_pos_regions_rebel_faction_name_att_reg_maxima_sequanorum_octodurusmain_attila	Заколотники	true
start_pos_regions_rebel_faction_name_att_reg_transcarpathia_belzpro_attila	Заколотники	true
start_pos_regions_rebel_faction_name_bel_reg_carthaginensis_ilicibel_attila	Заколотники	true
start_pos_regions_rebel_faction_name_att_reg_macedonia_corinthuspro_attila	Заколотники	true
start_pos_regions_long_description_att_reg_scandza_alabumain_attila	placeholder	true
start_pos_regions_rebel_faction_name_att_reg_dacia_apulumpro_attila	Заколотники	true
start_pos_regions_rebel_faction_name_att_reg_persis_sirafpro_attila	Заколотники	true
start_pos_regions_long_description_att_reg_phazania_garamamain_attila	placeholder	true
start_pos_regions_long_description_att_reg_dardania_serdicapro_attila	placeholder	true
start_pos_regions_rebel_faction_name_att_reg_maxima_sequanorum_octoduruspro_attila	Заколотники	true
start_pos_regions_rebel_faction_name_bel_reg_apulia_et_calabria_hydruntumbel_attila	Заколотники	true
start_pos_regions_rebel_faction_name_bel_reg_mauretania_sitifensis_tipasabel_attila	Заколотники	true
start_pos_regions_long_description_att_reg_cilicia_tarsuspro_attila	placeholder	true
start_pos_regions_long_description_att_reg_tarraconensis_pompaelopro_attila	placeholder	true
start_pos_regions_rebel_faction_name_att_reg_scandza_hafnpro_attila	Заколотники	true
start_pos_regions_rebel_faction_name_cha_reg_frisia_utrechtcha_attila	Заколотники	true
start_pos_regions_rebel_faction_name_cha_reg_friuli_veneziacha_attila	Заколотники	true
start_pos_regions_long_description_att_reg_germano_sarmatia_oiummain_attila	placeholder	true
start_pos_regions_rebel_faction_name_att_reg_italia_romamain_attila	Заколотники	true
start_pos_regions_rebel_faction_name_att_reg_transcaspia_siahkuhmain_attila	Заколотники	true
start_pos_regions_long_description_att_reg_osroene_edessamain_attila	placeholder	true
start_pos_regions_long_description_att_reg_sarmatia_europaea_olbiamain_attila	placeholder	true
start_pos_regions_rebel_faction_name_att_reg_mediterraneus_occidentalis_caralismain_attila	Заколотники	true
start_pos_regions_long_description_att_reg_venetia_veronapro_attila	placeholder	true
start_pos_regions_long_description_att_reg_dacia_romulamain_attila	placeholder	true
start_pos_regions_rebel_faction_name_att_reg_persis_stakhrmain_attila	Заколотники	true
start_pos_regions_rebel_faction_name_bel_reg_mauretania_sitifensis_cirtabel_attila	Заколотники	true
start_pos_regions_rebel_faction_name_att_reg_spahan_susapro_attila	Заколотники	true
start_pos_regions_rebel_faction_name_att_reg_britannia_superior_londiniumpro_attila	Заколотники	true
start_pos_regions_rebel_faction_name_bel_reg_zeugitana_bulla_regiabel_attila	Заколотники	true
start_pos_regions_rebel_faction_name_att_reg_mediterraneus_orientalis_constantiapro_attila	Заколотники	true
start_pos_regions_rebel_faction_name_att_reg_gallaecia_brigantiummain_attila	Заколотники	true
start_pos_regions_long_description_att_reg_palaestinea_aelia_capitolinamain_attila	placeholder	true
start_pos_regions_long_description_att_reg_scythia_saraimain_attila	placeholder	true
start_pos_regions_rebel_faction_name_att_reg_britannia_inferior_eboracummain_attila	Заколотники	true
start_pos_regions_rebel_faction_name_bel_reg_praeualitana_docleabel_attila	Заколотники	true
start_pos_regions_rebel_faction_name_bel_reg_mauretania_tingitana_tingisbel_attila	Заколотники	true
start_pos_regions_rebel_faction_name_cha_reg_france_tourscha_attila	Заколотники	true
start_pos_regions_rebel_faction_name_att_reg_dacia_apulummain_attila	Заколотники	true
start_pos_regions_rebel_faction_name_att_reg_armenia_tosppro_attila	Заколотники	true
start_pos_regions_rebel_faction_name_att_reg_frisia_flevummain_attila	Заколотники	true
start_pos_regions_rebel_faction_name_att_reg_britannia_superior_londiniummain_attila	Заколотники	true
start_pos_regions_rebel_faction_name_bel_reg_italia_cosabel_attila	Заколотники	true
start_pos_regions_rebel_faction_name_att_reg_britannia_inferior_segontiumpro_attila	Заколотники	true
start_pos_regions_rebel_faction_name_att_reg_gallaecia_brigantiumpro_attila	Заколотники	true
start_pos_regions_rebel_faction_name_att_reg_cappadocia_melitenemain_attila	Заколотники	true
start_pos_regions_long_description_att_reg_asorstan_meshanmain_attila	placeholder	true
start_pos_regions_rebel_faction_name_att_reg_mauretania_caesareapro_attila	Заколотники	true
start_pos_regions_rebel_faction_name_att_reg_italia_romapro_attila	Заколотники	true
start_pos_regions_long_description_att_reg_liguria_genuamain_attila	placeholder	true
start_pos_regions_rebel_faction_name_att_reg_britannia_inferior_eboracumpro_attila	Заколотники	true
start_pos_regions_long_description_att_reg_macedonia_dyrrhachiummain_attila	placeholder	true
start_pos_regions_rebel_faction_name_att_reg_tarraconensis_tarracopro_attila	Заколотники	true
start_pos_regions_rebel_faction_name_cha_reg_east_neustria_reimscha_attila	Заколотники	true
start_pos_regions_rebel_faction_name_att_reg_tripolitana_sabratamain_attila	Заколотники	true
start_pos_regions_rebel_faction_name_bel_reg_flaminia_et_picenum_ravennabel_attila	Заколотники	true
start_pos_regions_long_description_att_reg_magna_graecia_tarentumpro_attila	placeholder	true
start_pos_regions_rebel_faction_name_bel_reg_tuscia_et_umbria_pisaebel_attila	Заколотники	true
start_pos_regions_long_description_att_reg_cilicia_tarsusmain_attila	placeholder	true
start_pos_regions_rebel_faction_name_cha_reg_gascony_agencha_attila	Заколотники	true
start_pos_regions_long_description_att_reg_dardania_scupipro_attila	placeholder	true
start_pos_regions_rebel_faction_name_att_reg_bithynia_nicomediamain_attila	Заколотники	true
start_pos_regions_rebel_faction_name_att_reg_palaestinea_aelia_capitolinapro_attila	Заколотники	true
start_pos_regions_rebel_faction_name_cha_reg_wilzi_lipskcha_attila	Заколотники	true
start_pos_regions_rebel_faction_name_cha_reg_franconia_frankfurtcha_attila	Заколотники	true
start_pos_regions_rebel_faction_name_att_reg_asorstan_ctesiphonmain_attila	Заколотники	true
start_pos_regions_long_description_att_reg_mediterraneus_orientalis_rhodesmain_attila	placeholder	true
start_pos_regions_rebel_faction_name_att_reg_syria_emesamain_attila	Заколотники	true
start_pos_regions_rebel_faction_name_cha_reg_marca_inferior_bragacha_attila	Заколотники	true
start_pos_regions_rebel_faction_name_cha_reg_franconia_hallstadtcha_attila	Заколотники	true
start_pos_regions_long_description_att_reg_tarraconensis_tarracopro_attila	placeholder	true
start_pos_regions_rebel_faction_name_bel_reg_tarraconensis_caesaraugustabel_attila	Заколотники	true
start_pos_regions_rebel_faction_name_att_reg_khwarasan_abarshahrmain_attila	Заколотники	true
start_pos_regions_long_description_att_reg_dalmatia_sisciamain_attila	placeholder	true
start_pos_regions_long_description_att_reg_mediterraneus_orientalis_gortynapro_attila	placeholder	true
start_pos_regions_rebel_faction_name_cha_reg_france_chatrescha_attila	Заколотники	true
start_pos_regions_rebel_faction_name_att_reg_makran_purapro_attila	Заколотники	true
start_pos_regions_rebel_faction_name_att_reg_makran_phrapro_attila	Заколотники	true
start_pos_regions_rebel_faction_name_att_reg_cappadocia_trapezuspro_attila	Заколотники	true
start_pos_regions_rebel_faction_name_cha_reg_benevento_beneventocha_attila	Заколотники	true
start_pos_regions_rebel_faction_name_att_reg_tarraconensis_caesaraugustamain_attila	Заколотники	true
start_pos_regions_long_description_att_reg_britannia_superior_londiniummain_attila	placeholder	true
start_pos_regions_long_description_att_reg_germania_uburzispro_attila	placeholder	true
start_pos_regions_rebel_faction_name_att_reg_aethiopia_pachorasmain_attila	Заколотники	true
start_pos_regions_long_description_att_reg_dacia_apulummain_attila	placeholder	true
start_pos_regions_rebel_faction_name_att_reg_palaestinea_aelia_capitolinamain_attila	Заколотники	true
start_pos_regions_rebel_faction_name_att_reg_hyperborea_kariskosmain_attila	Заколотники	true
start_pos_regions_long_description_att_reg_macedonia_thessalonicapro_attila	placeholder	true
start_pos_regions_rebel_faction_name_att_reg_maxima_sequanorum_argentoratumpro_attila	Заколотники	true
start_pos_regions_rebel_faction_name_att_reg_syria_emesapro_attila	Заколотники	true
start_pos_regions_rebel_faction_name_att_reg_aquitania_avaricummain_attila	Заколотники	true
start_pos_regions_rebel_faction_name_bel_reg_mauretania_sitifensis_sitifisbel_attila	Заколотники	true
start_pos_regions_long_description_att_reg_gallaecia_brigantiummain_attila	placeholder	true
start_pos_regions_rebel_faction_name_att_reg_macedonia_corinthusmain_attila	Заколотники	true
start_pos_regions_rebel_faction_name_att_reg_mauretania_caesareamain_attila	Заколотники	true
start_pos_regions_long_description_att_reg_baetica_cordubapro_attila	placeholder	true
start_pos_regions_long_description_att_reg_pannonia_sirmiumpro_attila	placeholder	true
start_pos_regions_long_description_att_reg_caucasia_gabalamain_attila	placeholder	true
start_pos_regions_long_description_att_reg_caucasia_kotaismain_attila	placeholder	true
start_pos_regions_long_description_att_reg_germano_sarmatia_dunamain_attila	placeholder	true
start_pos_regions_rebel_faction_name_att_reg_carthaginensis_carthago_novapro_attila	Заколотники	true
start_pos_regions_rebel_faction_name_bel_reg_sardinia_et_corsica_caralisbel_attila	Заколотники	true
start_pos_regions_rebel_faction_name_att_reg_dacia_romulamain_attila	Заколотники	true
start_pos_regions_long_description_att_reg_bithynia_ancyramain_attila	placeholder	true
start_pos_regions_rebel_faction_name_cha_reg_west_aquitaine_bourgescha_attila	Заколотники	true
start_pos_regions_rebel_faction_name_cha_reg_mercia_lincolncha_attila	Заколотники	true
start_pos_regions_rebel_faction_name_bel_reg_picenum_suburbicarium_anconabel_attila	Заколотники	true
start_pos_regions_rebel_faction_name_att_reg_africa_constantinamain_attila	Заколотники	true
start_pos_regions_rebel_faction_name_att_reg_hyperborea_moramarmain_attila	Заколотники	true
start_pos_regions_rebel_faction_name_att_reg_lugdunensis_turonummain_attila	Заколотники	true
start_pos_regions_long_description_att_reg_phazania_cydamuspro_attila	placeholder	true
start_pos_regions_long_description_att_reg_media_atropatene_ganzagapro_attila	placeholder	true
start_pos_regions_rebel_faction_name_att_reg_belgica_augusta_treverorummain_attila	Заколотники	true
start_pos_regions_rebel_faction_name_att_reg_transcaspia_dahistanpro_attila	Заколотники	true
start_pos_regions_rebel_faction_name_bel_reg_zeugitana_hippo_regisbel_attila	Заколотники	true
start_pos_regions_long_description_att_reg_scythia_bolgharpro_attila	placeholder	true
start_pos_regions_rebel_faction_name_cha_reg_marca_media_salamancacha_attila	Заколотники	true
start_pos_regions_rebel_faction_name_cha_reg_septimania_narbonnecha_attila	Заколотники	true
start_pos_regions_long_description_att_reg_osroene_amidamain_attila	placeholder	true
start_pos_regions_rebel_faction_name_att_reg_scandza_hrefnesholtmain_attila	Заколотники	true
start_pos_regions_long_description_att_reg_pannonia_savariapro_attila	placeholder	true
start_pos_regions_rebel_faction_name_bel_reg_septimania_narbonnebel_attila	Заколотники	true
start_pos_regions_long_description_att_reg_lusitania_pax_augustamain_attila	placeholder	true
start_pos_regions_rebel_faction_name_att_reg_germania_lupfurdummain_attila	Заколотники	true
start_pos_regions_rebel_faction_name_att_reg_sarmatia_asiatica_anacopiamain_attila	Заколотники	true
start_pos_regions_rebel_faction_name_att_reg_cappadocia_caesarea_eusebiamain_attila	Заколотники	true
start_pos_regions_rebel_faction_name_cha_reg_eastphalia_magdeburgcha_attila	Заколотники	true
start_pos_regions_rebel_faction_name_att_reg_khwarasan_abarshahrpro_attila	Заколотники	true
start_pos_regions_rebel_faction_name_cha_reg_marca_inferior_lisboncha_attila	Заколотники	true
start_pos_regions_rebel_faction_name_att_reg_cappadocia_melitenepro_attila	Заколотники	true
start_pos_regions_rebel_faction_name_att_reg_cilicia_myrapro_attila	Заколотники	true
start_pos_regions_long_description_att_reg_gothiscandza_ascaucalismain_attila	placeholder	true
start_pos_regions_long_description_att_reg_phazania_dimmidipro_attila	placeholder	true
start_pos_regions_rebel_faction_name_bel_reg_epirus_nova_dyrrachiumbel_attila	Заколотники	true
start_pos_regions_long_description_att_reg_sarmatia_asiatica_tanaispro_attila	placeholder	true
start_pos_regions_rebel_faction_name_att_reg_spahan_spahanmain_attila	Заколотники	true
start_pos_regions_long_description_att_reg_macedonia_dyrrhachiumpro_attila	placeholder	true
start_pos_regions_rebel_faction_name_att_reg_dardania_viminaciumpro_attila	Заколотники	true
start_pos_regions_rebel_faction_name_att_reg_aegyptus_alexandriapro_attila	Заколотники	true
start_pos_regions_long_description_att_reg_sarmatia_europaea_chersonessuspro_attila	placeholder	true
start_pos_regions_long_description_att_reg_britannia_inferior_segontiummain_attila	placeholder	true
start_pos_regions_rebel_faction_name_att_reg_arabia_felix_zafarmain_attila	Заколотники	true
start_pos_regions_rebel_faction_name_att_reg_britannia_superior_coriniumpro_attila	Заколотники	true
start_pos_regions_rebel_faction_name_bel_reg_italia_romabel_attila	Заколотники	true
start_pos_regions_rebel_faction_name_bel_reg_gallaecia_brigantiumbel_attila	Заколотники	true
start_pos_regions_rebel_faction_name_att_reg_armenia_duinpro_attila	Заколотники	true
start_pos_regions_rebel_faction_name_att_reg_arabia_felix_omanamain_attila	Заколотники	true
start_pos_regions_rebel_faction_name_cha_reg_munster_corkcha_attila	Заколотники	true
start_pos_regions_rebel_faction_name_bel_reg_tarraconensis_barcinobel_attila	Заколотники	true
start_pos_regions_rebel_faction_name_bel_reg_praeualitana_lissusbel_attila	Заколотники	true
start_pos_regions_rebel_faction_name_att_reg_carthaginensis_toletumpro_attila	Заколотники	true
start_pos_regions_rebel_faction_name_att_reg_britannia_superior_coriniummain_attila	Заколотники	true
start_pos_regions_rebel_faction_name_att_reg_libya_augilapro_attila	Заколотники	true
start_pos_regions_rebel_faction_name_att_reg_transcarpathia_belzmain_attila	Заколотники	true
start_pos_regions_long_description_att_reg_tarraconensis_tarracomain_attila	placeholder	true
start_pos_regions_long_description_att_reg_dalmatia_salonamain_attila	placeholder	true
start_pos_regions_long_description_att_reg_libya_augilamain_attila	placeholder	true
start_pos_regions_rebel_faction_name_att_reg_maxima_sequanorum_vesontiomain_attila	Заколотники	true
start_pos_regions_rebel_faction_name_bel_reg_celtiberia_tolentumbel_attila	Заколотники	true
start_pos_regions_rebel_faction_name_att_reg_gallaecia_asturicamain_attila	Заколотники	true
start_pos_regions_rebel_faction_name_att_reg_belgica_durocorterumpro_attila	Заколотники	true
start_pos_regions_long_description_att_reg_magna_graecia_rhegiummain_attila	placeholder	true
start_pos_regions_long_description_att_reg_palaestinea_nova_trajana_bostrapro_attila	placeholder	true
start_pos_regions_long_description_att_reg_khwarasan_mervpro_attila	placeholder	true
start_pos_regions_rebel_faction_name_att_reg_frisia_anguluspro_attila	Заколотники	true
start_pos_regions_rebel_faction_name_cha_reg_saxony_hamburgcha_attila	Заколотники	true
start_pos_regions_rebel_faction_name_att_reg_hyperborea_kariskospro_attila	Заколотники	true
start_pos_regions_rebel_faction_name_att_reg_dacia_romulapro_attila	Заколотники	true
start_pos_regions_long_description_att_reg_baetica_malacapro_attila	placeholder	true
start_pos_regions_rebel_faction_name_att_reg_gothiscandza_rugionpro_attila	Заколотники	true
start_pos_regions_rebel_faction_name_att_reg_makran_puramain_attila	Заколотники	true
start_pos_regions_rebel_faction_name_att_reg_armenia_payttakaranmain_attila	Заколотники	true
start_pos_regions_rebel_faction_name_bel_reg_picenum_suburbicarium_asculumbel_attila	Заколотники	true
start_pos_regions_rebel_faction_name_bel_reg_celtiberia_complutumbel_attila	Заколотники	true
start_pos_regions_rebel_faction_name_cha_reg_jutland_ribecha_attila	Заколотники	true
start_pos_regions_long_description_att_reg_venetia_veronamain_attila	placeholder	true
start_pos_regions_long_description_att_reg_bithynia_amaseamain_attila	placeholder	true
start_pos_regions_long_description_att_reg_osroene_amidapro_attila	placeholder	true
start_pos_regions_long_description_att_reg_tripolitana_macomadespro_attila	placeholder	true
start_pos_regions_long_description_att_reg_asia_synnadamain_attila	placeholder	true
start_pos_regions_rebel_faction_name_att_reg_aegyptus_oxyrhynchusmain_attila	Заколотники	true
start_pos_regions_rebel_faction_name_att_reg_arabia_magna_dumathapro_attila	Заколотники	true
start_pos_regions_long_description_att_reg_persis_stakhrmain_attila	placeholder	true
start_pos_regions_rebel_faction_name_bel_reg_campania_et_samnium_neapolisbel_attila	Заколотники	true
start_pos_regions_rebel_faction_name_att_reg_asia_cyzicuspro_attila	Заколотники	true
start_pos_regions_rebel_faction_name_att_reg_venetia_veronapro_attila	Заколотники	true
start_pos_regions_rebel_faction_name_bel_reg_mauretania_tingitana_rusaddirbel_attila	Заколотники	true
start_pos_regions_rebel_faction_name_cha_reg_east_neustria_troyescha_attila	Заколотники	true
start_pos_regions_long_description_att_reg_germano_sarmatia_oiumpro_attila	placeholder	true
start_pos_regions_rebel_faction_name_att_reg_arabia_magna_yathribmain_attila	Заколотники	true
start_pos_regions_rebel_faction_name_cha_reg_bohemia_iglaucha_attila	Заколотники	true
start_pos_regions_rebel_faction_name_att_reg_thracia_marcianopolispro_attila	Заколотники	true
start_pos_regions_long_description_att_reg_italia_neapolismain_attila	placeholder	true
start_pos_regions_rebel_faction_name_bel_reg_tarraconensis_valentiabel_attila	Заколотники	true
start_pos_regions_rebel_faction_name_att_reg_aegyptus_alexandriamain_attila	Заколотники	true
start_pos_regions_long_description_att_reg_magna_graecia_syracusaepro_attila	placeholder	true
start_pos_regions_long_description_att_reg_carthaginensis_segobrigapro_attila	placeholder	true
start_pos_regions_rebel_faction_name_att_reg_cilicia_tarsuspro_attila	Заколотники	true
start_pos_regions_rebel_faction_name_att_reg_tarraconensis_pompaelopro_attila	Заколотники	true
start_pos_regions_rebel_faction_name_att_reg_germano_sarmatia_oiummain_attila	Заколотники	true
start_pos_regions_long_description_att_reg_palaestinea_ailapro_attila	placeholder	true
start_pos_regions_long_description_att_reg_palaestinea_nova_trajana_bostramain_attila	placeholder	true
start_pos_regions_rebel_faction_name_cha_reg_wales_caerwentcha_attila	Заколотники	true
start_pos_regions_long_description_att_reg_asia_ephesusmain_attila	placeholder	true
start_pos_regions_long_description_att_reg_dalmatia_sisciapro_attila	placeholder	true
start_pos_regions_rebel_faction_name_bel_reg_venetia_et_histria_pataviumbel_attila	Заколотники	true
start_pos_regions_rebel_faction_name_bel_reg_africa_proconsularis_thuburbobel_attila	Заколотники	true
start_pos_regions_rebel_faction_name_att_reg_scythia_saraipro_attila	Заколотники	true
start_pos_regions_long_description_att_reg_carthaginensis_toletummain_attila	placeholder	true
start_pos_regions_rebel_faction_name_bel_reg_byzacena_hadrumentumbel_attila	Заколотники	true
start_pos_regions_rebel_faction_name_att_reg_liguria_genuamain_attila	Заколотники	true
start_pos_regions_rebel_faction_name_att_reg_macedonia_dyrrhachiummain_attila	Заколотники	true
start_pos_regions_rebel_faction_name_att_reg_magna_graecia_tarentumpro_attila	Заколотники	true
start_pos_regions_rebel_faction_name_cha_reg_west_neustria_bayeuxcha_attila	Заколотники	true
start_pos_regions_long_description_att_reg_asorstan_arbelapro_attila	placeholder	true
start_pos_regions_long_description_att_reg_scandza_alabupro_attila	placeholder	true
start_pos_regions_long_description_att_reg_sarmatia_europaea_chersonessusmain_attila	placeholder	true
start_pos_regions_long_description_att_reg_persis_sirafmain_attila	placeholder	true
start_pos_regions_long_description_att_reg_arabia_magna_dumathamain_attila	placeholder	true
start_pos_regions_rebel_faction_name_cha_reg_munster_dublincha_attila	Заколотники	true
start_pos_regions_long_description_att_reg_transcaspia_kathpro_attila	placeholder	true
start_pos_regions_long_description_att_reg_magna_graecia_syracusaemain_attila	placeholder	true
start_pos_regions_rebel_faction_name_att_reg_dardania_scupipro_attila	Заколотники	true
start_pos_regions_long_description_att_reg_aethiopia_adulispro_attila	placeholder	true
start_pos_regions_rebel_faction_name_cha_reg_provence_arlescha_attila	Заколотники	true
start_pos_regions_long_description_att_reg_caledonia_et_hibernia_tuesismain_attila	placeholder	true
start_pos_regions_long_description_att_reg_frisia_flevummain_attila	placeholder	true
start_pos_regions_long_description_att_reg_macedonia_thessalonicamain_attila	placeholder	true
start_pos_regions_rebel_faction_name_att_reg_scandza_hafnmain_attila	Заколотники	true
start_pos_regions_long_description_att_reg_frisia_flevumpro_attila	placeholder	true
start_pos_regions_rebel_faction_name_att_reg_caledonia_et_hibernia_eblanapro_attila	Заколотники	true
start_pos_regions_rebel_faction_name_att_reg_caledonia_et_hibernia_eildonpro_attila	Заколотники	true
start_pos_regions_rebel_faction_name_att_reg_scythia_saraimain_attila	Заколотники	true
start_pos_regions_long_description_att_reg_syria_antiochiamain_attila	placeholder	true
start_pos_regions_rebel_faction_name_cha_reg_east_neustria_amienscha_attila	Заколотники	true
start_pos_regions_rebel_faction_name_att_reg_asia_synnadapro_attila	Заколотники	true
start_pos_regions_rebel_faction_name_cha_reg_rome_spoletocha_attila	Заколотники	true
start_pos_regions_long_description_att_reg_persis_stakhrpro_attila	placeholder	true
start_pos_regions_long_description_att_reg_transcarpathia_arheimarpro_attila	placeholder	true
start_pos_regions_rebel_faction_name_att_reg_cilicia_myramain_attila	Заколотники	true
start_pos_regions_long_description_att_reg_tripolitana_leptis_magnapro_attila	placeholder	true
start_pos_regions_rebel_faction_name_bel_reg_campania_et_samnium_beneventumbel_attila	Заколотники	true
start_pos_regions_long_description_att_reg_lugdunensis_lugdunummain_attila	placeholder	true
start_pos_regions_long_description_att_reg_spahan_issatispro_attila	placeholder	true
start_pos_regions_rebel_faction_name_att_reg_aegyptus_oxyrhynchuspro_attila	Заколотники	true
start_pos_regions_long_description_att_reg_cilicia_iconiummain_attila	placeholder	true
start_pos_regions_rebel_faction_name_cha_reg_friuli_veronacha_attila	Заколотники	true
start_pos_regions_rebel_faction_name_cha_reg_angria_erfurtcha_attila	Заколотники	true
start_pos_regions_rebel_faction_name_att_reg_arabia_magna_yathribpro_attila	Заколотники	true
start_pos_regions_long_description_att_reg_arabia_felix_eudaemonmain_attila	placeholder	true
start_pos_regions_rebel_faction_name_bel_reg_liguria_genuabel_attila	Заколотники	true
start_pos_regions_long_description_att_reg_transcarpathia_arheimarmain_attila	placeholder	true
start_pos_regions_long_description_att_reg_aquitania_elusamain_attila	placeholder	true
start_pos_regions_rebel_faction_name_att_reg_lugdunensis_turonumpro_attila	Заколотники	true
start_pos_regions_long_description_att_reg_germano_sarmatia_dunapro_attila	placeholder	true
start_pos_regions_rebel_faction_name_att_reg_scythia_ramain_attila	Заколотники	true
start_pos_regions_long_description_att_reg_magna_graecia_tarentummain_attila	placeholder	true
start_pos_regions_rebel_faction_name_att_reg_liguria_genuapro_attila	Заколотники	true
start_pos_regions_rebel_faction_name_att_reg_armenia_tospmain_attila	Заколотники	true
start_pos_regions_long_description_att_reg_britannia_superior_camulodunonmain_attila	placeholder	true
start_pos_regions_rebel_faction_name_att_reg_tripolitana_macomadesmain_attila	Заколотники	true
start_pos_regions_long_description_att_reg_africa_carthagomain_attila	placeholder	true
start_pos_regions_rebel_faction_name_bel_reg_neustria_parisbel_attila	Заколотники	true
start_pos_regions_rebel_faction_name_att_reg_caledonia_et_hibernia_eblanamain_attila	Заколотники	true
start_pos_regions_long_description_att_reg_libya_ptolemaismain_attila	placeholder	true
start_pos_regions_long_description_att_reg_transcaspia_dahistanmain_attila	placeholder	true
start_pos_regions_rebel_faction_name_cha_reg_toledo_toledocha_attila	Заколотники	true
start_pos_regions_rebel_faction_name_att_reg_liguria_mediolanummain_attila	Заколотники	true
start_pos_regions_long_description_att_reg_lugdunensis_rotomaguspro_attila	placeholder	true
start_pos_regions_long_description_att_reg_sarmatia_europaea_olbiapro_attila	placeholder	true
start_pos_regions_rebel_faction_name_cha_reg_eastphalia_hildesheimcha_attila	Заколотники	true
start_pos_regions_rebel_faction_name_att_reg_magna_graecia_rhegiumpro_attila	Заколотники	true
start_pos_regions_rebel_faction_name_att_reg_asia_ephesuspro_attila	Заколотники	true
start_pos_regions_long_description_att_reg_transcarpathia_leopolispro_attila	placeholder	true
start_pos_regions_rebel_faction_name_cha_reg_navarre_tudelacha_attila	Заколотники	true
start_pos_regions_long_description_att_reg_caucasia_kotaispro_attila	placeholder	true
start_pos_regions_rebel_faction_name_att_reg_asia_cyzicusmain_attila	Заколотники	true
start_pos_regions_long_description_att_reg_carthaginensis_carthago_novamain_attila	placeholder	true
start_pos_regions_rebel_faction_name_bel_reg_flaminia_et_picenum_pisaurumbel_attila	Заколотники	true
start_pos_regions_rebel_faction_name_cha_reg_lombardy_pisacha_attila	Заколотники	true
start_pos_regions_rebel_faction_name_bel_reg_picenum_suburbicarium_spoletumbel_attila	Заколотники	true
start_pos_regions_rebel_faction_name_att_reg_scandza_alabumain_attila	Заколотники	true
start_pos_regions_long_description_att_reg_mediterraneus_occidentalis_ajaxmain_attila	placeholder	true
start_pos_regions_long_description_att_reg_khwarasan_hareymain_attila	placeholder	true
start_pos_regions_rebel_faction_name_bel_reg_africa_proconsularis_carthagobel_attila	Заколотники	true
start_pos_regions_rebel_faction_name_att_reg_mauretania_tamousigamain_attila	Заколотники	true
start_pos_regions_rebel_faction_name_att_reg_lusitania_pax_augustapro_attila	Заколотники	true
start_pos_regions_rebel_faction_name_cha_reg_gallicia_lugocha_attila	Заколотники	true
start_pos_regions_long_description_att_reg_raetia_et_noricum_augusta_vindelicorumpro_attila	placeholder	true
start_pos_regions_long_description_att_reg_makran_harmosiapro_attila	placeholder	true
start_pos_regions_rebel_faction_name_cha_reg_sardinia_and_corsica_cagliaricha_attila	Заколотники	true
start_pos_regions_rebel_faction_name_att_reg_caledonia_et_hibernia_eildonmain_attila	Заколотники	true
start_pos_regions_rebel_faction_name_cha_reg_east_aquitaine_autuncha_attila	Заколотники	true
start_pos_regions_long_description_att_reg_britannia_superior_camulodunonpro_attila	placeholder	true
start_pos_regions_rebel_faction_name_att_reg_lugdunensis_rotomagusmain_attila	Заколотники	true
start_pos_regions_long_description_att_reg_osroene_nisibismain_attila	placeholder	true
start_pos_regions_rebel_faction_name_att_reg_media_atropatene_rhagapro_attila	Заколотники	true
start_pos_regions_long_description_att_reg_mediterraneus_orientalis_rhodespro_attila	placeholder	true
start_pos_regions_long_description_att_reg_armenia_duinmain_attila	placeholder	true
start_pos_regions_rebel_faction_name_att_reg_scandza_hrefnesholtpro_attila	Заколотники	true
start_pos_regions_rebel_faction_name_bel_reg_venetia_et_histria_aquileiabel_attila	Заколотники	true
start_pos_regions_long_description_att_reg_belgica_durocorterummain_attila	placeholder	true
start_pos_regions_long_description_att_reg_spahan_spahanpro_attila	placeholder	true
start_pos_regions_long_description_att_reg_khwarasan_mervmain_attila	placeholder	true
start_pos_regions_rebel_faction_name_att_reg_caledonia_et_hibernia_tuesispro_attila	Заколотники	true
start_pos_regions_rebel_faction_name_bel_reg_baetica_gadesbel_attila	Заколотники	true
start_pos_regions_rebel_faction_name_cha_reg_moravia_nitracha_attila	Заколотники	true
start_pos_regions_long_description_att_reg_arabia_felix_eudaemonpro_attila	placeholder	true
start_pos_regions_rebel_faction_name_att_reg_osroene_edessapro_attila	Заколотники	true
start_pos_regions_rebel_faction_name_att_reg_thracia_marcianopolismain_attila	Заколотники	true
start_pos_regions_rebel_faction_name_cha_reg_jutland_hedebycha_attila	Заколотники	true
start_pos_regions_rebel_faction_name_att_reg_spahan_spahanpro_attila	Заколотники	true
start_pos_regions_rebel_faction_name_att_reg_arabia_felix_eudaemonpro_attila	Заколотники	true
start_pos_regions_rebel_faction_name_att_reg_armenia_duinmain_attila	Заколотники	true
start_pos_regions_rebel_faction_name_att_reg_gothiscandza_rugionmain_attila	Заколотники	true
start_pos_regions_long_description_att_reg_spahan_spahanmain_attila	placeholder	true
start_pos_regions_rebel_faction_name_att_reg_belgica_durocorterummain_attila	Заколотники	true
start_pos_regions_long_description_att_reg_caledonia_et_hibernia_eildonmain_attila	placeholder	true
start_pos_regions_long_description_att_reg_bithynia_ancyrapro_attila	placeholder	true
start_pos_regions_long_description_att_reg_gothiscandza_ascaucalispro_attila	placeholder	true
start_pos_regions_long_description_att_reg_lusitania_pax_augustapro_attila	placeholder	true
start_pos_regions_long_description_att_reg_aethiopia_aksumpro_attila	placeholder	true
start_pos_regions_long_description_att_reg_mauretania_tamousigamain_attila	placeholder	true
start_pos_regions_rebel_faction_name_cha_reg_leon_valladoidcha_attila	Заколотники	true
start_pos_regions_rebel_faction_name_bel_reg_praeualitana_epidaurumbel_attila	Заколотники	true
start_pos_regions_rebel_faction_name_att_reg_sarmatia_europaea_chersonessuspro_attila	Заколотники	true
start_pos_regions_rebel_faction_name_cha_reg_west_neustria_rennescha_attila	Заколотники	true
start_pos_regions_long_description_att_reg_asia_cyzicusmain_attila	placeholder	true
start_pos_regions_rebel_faction_name_att_reg_carthaginensis_carthago_novamain_attila	Заколотники	true
start_pos_regions_long_description_att_reg_media_atropatene_rhagamain_attila	placeholder	true
start_pos_regions_long_description_att_reg_phazania_garamapro_attila	placeholder	true
start_pos_regions_rebel_faction_name_bel_reg_novempopulania_tolosabel_attila	Заколотники	true
start_pos_regions_rebel_faction_name_cha_reg_west_neustria_nantescha_attila	Заколотники	true
start_pos_regions_rebel_faction_name_cha_reg_croatia_sisakcha_attila	Заколотники	true
start_pos_regions_rebel_faction_name_cha_reg_provence_nicecha_attila	Заколотники	true
start_pos_regions_rebel_faction_name_att_reg_osroene_amidamain_attila	Заколотники	true
start_pos_regions_long_description_att_reg_aethiopia_aksummain_attila	placeholder	true
start_pos_regions_long_description_att_reg_bithynia_amaseapro_attila	placeholder	true
start_pos_regions_long_description_att_reg_magna_graecia_rhegiumpro_attila	placeholder	true
start_pos_regions_rebel_faction_name_cha_reg_swabia_speyercha_attila	Заколотники	true
start_pos_regions_rebel_faction_name_cha_reg_wessex_londoncha_attila	Заколотники	true
start_pos_regions_long_description_att_reg_dacia_petrodavapro_attila	placeholder	true
start_pos_regions_rebel_faction_name_att_reg_transcaspia_dahistanmain_attila	Заколотники	true
start_pos_regions_rebel_faction_name_cha_reg_sardinia_and_corsica_ajacciocha_attila	Заколотники	true
start_pos_regions_rebel_faction_name_bel_reg_campania_et_samnium_corfiniumbel_attila	Заколотники	true
start_pos_regions_rebel_faction_name_att_reg_lugdunensis_rotomaguspro_attila	Заколотники	true
start_pos_regions_rebel_faction_name_cha_reg_marca_hispanica_gironacha_attila	Заколотники	true
start_pos_regions_rebel_faction_name_cha_reg_alemannia_churcha_attila	Заколотники	true
start_pos_regions_rebel_faction_name_cha_reg_lombardy_paviacha_attila	Заколотники	true
start_pos_regions_rebel_faction_name_att_reg_lusitania_pax_augustamain_attila	Заколотники	true
start_pos_regions_long_description_att_reg_caledonia_et_hibernia_eblanamain_attila	placeholder	true
start_pos_regions_long_description_att_reg_asorstan_meshanpro_attila	placeholder	true
start_pos_regions_long_description_att_reg_frisia_anguluspro_attila	placeholder	true
start_pos_regions_long_description_att_reg_frisia_angulusmain_attila	placeholder	true
start_pos_regions_rebel_faction_name_cha_reg_bohemia_prahacha_attila	Заколотники	true
start_pos_regions_rebel_faction_name_cha_reg_east_aquitaine_rodezcha_attila	Заколотники	true
start_pos_regions_rebel_faction_name_cha_reg_munster_cashelcha_attila	Заколотники	true
start_pos_regions_rebel_faction_name_att_reg_magna_graecia_rhegiummain_attila	Заколотники	true
start_pos_regions_rebel_faction_name_att_reg_khwarasan_mervpro_attila	Заколотники	true
start_pos_regions_rebel_faction_name_bel_reg_epirus_nova_photikibel_attila	Заколотники	true
start_pos_regions_long_description_att_reg_armenia_tospmain_attila	placeholder	true
start_pos_regions_long_description_att_reg_liguria_genuapro_attila	placeholder	true
start_pos_regions_long_description_att_reg_tarraconensis_pompaelomain_attila	placeholder	true
start_pos_regions_rebel_faction_name_att_reg_germano_sarmatia_dunapro_attila	Заколотники	true
start_pos_regions_long_description_att_reg_baetica_cordubamain_attila	placeholder	true
start_pos_regions_rebel_faction_name_att_reg_baetica_malacapro_attila	Заколотники	true
start_pos_regions_rebel_faction_name_cha_reg_pictland_sconecha_attila	Заколотники	true
start_pos_regions_long_description_att_reg_italia_neapolispro_attila	placeholder	true
start_pos_regions_long_description_att_reg_carthaginensis_toletumpro_attila	placeholder	true
start_pos_regions_long_description_att_reg_maxima_sequanorum_argentoratummain_attila	placeholder	true
start_pos_regions_long_description_att_reg_persis_behdeshirpro_attila	placeholder	true
start_pos_regions_long_description_att_reg_liguria_segusiomain_attila	placeholder	true
start_pos_regions_long_description_att_reg_venetia_aquileiapro_attila	placeholder	true
start_pos_regions_long_description_att_reg_venetia_ravennamain_attila	placeholder	true
start_pos_regions_long_description_att_reg_makran_harmosiamain_attila	placeholder	true
start_pos_regions_rebel_faction_name_cha_reg_carinthia_wiencha_attila	Заколотники	true
start_pos_regions_rebel_faction_name_cha_reg_austrasia_metzcha_attila	Заколотники	true
start_pos_regions_long_description_att_reg_raetia_et_noricum_augusta_vindelicorummain_attila	placeholder	true
start_pos_regions_rebel_faction_name_att_reg_lugdunensis_lugdunummain_attila	Заколотники	true
start_pos_regions_long_description_att_reg_aquitania_elusapro_attila	placeholder	true
start_pos_regions_rebel_faction_name_cha_reg_burgundy_lyoncha_attila	Заколотники	true
start_pos_regions_long_description_att_reg_mediterraneus_occidentalis_palmapro_attila	placeholder	true
start_pos_regions_rebel_faction_name_att_reg_tarraconensis_tarracomain_attila	Заколотники	true
start_pos_regions_long_description_att_reg_cilicia_myramain_attila	placeholder	true
start_pos_regions_rebel_faction_name_att_reg_persis_stakhrpro_attila	Заколотники	true
start_pos_regions_rebel_faction_name_att_reg_germano_sarmatia_palteskjamain_attila	Заколотники	true
start_pos_regions_long_description_att_reg_dacia_petrodavamain_attila	placeholder	true
start_pos_regions_long_description_att_reg_scandza_hafnmain_attila	placeholder	true
start_pos_regions_rebel_faction_name_att_reg_tripolitana_sabratapro_attila	Заколотники	true
start_pos_regions_rebel_faction_name_att_reg_frisia_flevumpro_attila	Заколотники	true
start_pos_regions_long_description_att_reg_maxima_sequanorum_argentoratumpro_attila	placeholder	true
start_pos_regions_long_description_att_reg_africa_carthagopro_attila	placeholder	true
start_pos_regions_rebel_faction_name_att_reg_caledonia_et_hibernia_tuesismain_attila	Заколотники	true
start_pos_regions_long_description_att_reg_scythia_bolgharmain_attila	placeholder	true
start_pos_regions_rebel_faction_name_cha_reg_jutland_aarhuscha_attila	Заколотники	true
start_pos_regions_rebel_faction_name_cha_reg_benevento_baricha_attila	Заколотники	true
start_pos_regions_rebel_faction_name_att_reg_macedonia_thessalonicapro_attila	Заколотники	true
start_pos_regions_rebel_faction_name_att_reg_persis_sirafmain_attila	Заколотники	true
start_pos_regions_rebel_faction_name_att_reg_arabia_magna_dumathamain_attila	Заколотники	true
start_pos_regions_long_description_att_reg_dardania_scupimain_attila	placeholder	true
start_pos_regions_rebel_faction_name_att_reg_transcaspia_siahkuhpro_attila	Заколотники	true
start_pos_regions_rebel_faction_name_bel_reg_africa_proconsularis_hippo_diarrhytusbel_attila	Заколотники	true
start_pos_regions_rebel_faction_name_cha_reg_croatia_jadracha_attila	Заколотники	true
start_pos_regions_long_description_att_reg_khwarasan_hareypro_attila	placeholder	true
start_pos_regions_rebel_faction_name_att_reg_scandza_alabupro_attila	Заколотники	true
start_pos_regions_long_description_att_reg_caucasia_gabalapro_attila	placeholder	true
start_pos_regions_rebel_faction_name_att_reg_cappadocia_caesarea_eusebiapro_attila	Заколотники	true
start_pos_regions_long_description_att_reg_dalmatia_salonapro_attila	placeholder	true
start_pos_regions_rebel_faction_name_att_reg_thracia_trimontiummain_attila	Заколотники	true
start_pos_regions_long_description_att_reg_scythia_saraipro_attila	placeholder	true
start_pos_regions_rebel_faction_name_att_reg_asia_ephesusmain_attila	Заколотники	true
start_pos_regions_long_description_att_reg_libya_ptolemaispro_attila	placeholder	true
start_pos_regions_long_description_att_reg_baetica_hispalispro_attila	placeholder	true
start_pos_regions_rebel_faction_name_cha_reg_gharb_al_anadalus_bejacha_attila	Заколотники	true
start_pos_regions_rebel_faction_name_cha_reg_leon_santandercha_attila	Заколотники	true
start_pos_regions_rebel_faction_name_att_reg_narbonensis_viennamain_attila	Заколотники	true
start_pos_regions_rebel_faction_name_att_reg_dardania_viminaciummain_attila	Заколотники	true
start_pos_regions_rebel_faction_name_att_reg_mediterraneus_orientalis_constantiamain_attila	Заколотники	true
start_pos_regions_rebel_faction_name_cha_reg_saxony_bremencha_attila	Заколотники	true
start_pos_regions_rebel_faction_name_cha_reg_wales_degannwycha_attila	Заколотники	true
start_pos_regions_long_description_att_reg_thracia_marcianopolispro_attila	placeholder	true
start_pos_regions_rebel_faction_name_att_reg_germano_sarmatia_oiumpro_attila	Заколотники	true
start_pos_regions_long_description_att_reg_arabia_magna_yathribmain_attila	placeholder	true
start_pos_regions_long_description_att_reg_mediterraneus_occidentalis_ajaxpro_attila	placeholder	true
start_pos_regions_long_description_att_reg_italia_fiorentiapro_attila	placeholder	true
start_pos_regions_long_description_att_reg_aegyptus_oxyrhynchusmain_attila	placeholder	true
start_pos_regions_rebel_faction_name_bel_reg_epirus_nova_nicopolisbel_attila	Заколотники	true
start_pos_regions_rebel_faction_name_att_reg_armenia_payttakaranpro_attila	Заколотники	true
start_pos_regions_rebel_faction_name_cha_reg_marca_media_cacerescha_attila	Заколотники	true
start_pos_regions_rebel_faction_name_att_reg_osroene_amidapro_attila	Заколотники	true
start_pos_regions_long_description_att_reg_spahan_issatismain_attila	placeholder	true
start_pos_regions_rebel_faction_name_att_reg_asia_synnadamain_attila	Заколотники	true
start_pos_regions_long_description_att_reg_syria_antiochiapro_attila	placeholder	true
start_pos_regions_rebel_faction_name_att_reg_tripolitana_macomadespro_attila	Заколотники	true
start_pos_regions_long_description_att_reg_hyperborea_sylispro_attila	placeholder	true
start_pos_regions_rebel_faction_name_cha_reg_bavaria_passaucha_attila	Заколотники	true
start_pos_regions_rebel_faction_name_bel_reg_baetica_malacabel_attila	Заколотники	true
start_pos_regions_rebel_faction_name_att_reg_germano_sarmatia_dunamain_attila	Заколотники	true
start_pos_regions_long_description_att_reg_transcarpathia_leopolismain_attila	placeholder	true
start_pos_regions_long_description_att_reg_thracia_constantinopolispro_attila	placeholder	true
start_pos_regions_rebel_faction_name_cha_reg_valencia_palmacha_attila	Заколотники	true
start_pos_regions_rebel_faction_name_att_reg_gallaecia_bracaramain_attila	Заколотники	true
start_pos_regions_long_description_att_reg_tripolitana_sabratamain_attila	placeholder	true
start_pos_regions_long_description_att_reg_tripolitana_leptis_magnamain_attila	placeholder	true
start_pos_regions_rebel_faction_name_att_reg_palaestinea_ailamain_attila	Заколотники	true
start_pos_regions_rebel_faction_name_att_reg_germania_aregeliapro_attila	Заколотники	true
start_pos_regions_long_description_att_reg_spahan_susapro_attila	placeholder	true
start_pos_regions_rebel_faction_name_bel_reg_byzacena_thysdrusbel_attila	Заколотники	true
start_pos_regions_long_description_att_reg_mediterraneus_orientalis_constantiapro_attila	placeholder	true
start_pos_regions_rebel_faction_name_cha_reg_wessex_winchestercha_attila	Заколотники	true
start_pos_regions_rebel_faction_name_att_reg_germania_lupfurdumpro_attila	Заколотники	true
start_pos_regions_rebel_faction_name_att_reg_caucasia_mtskhetamain_attila	Заколотники	true
start_pos_regions_rebel_faction_name_att_reg_gallaecia_asturicapro_attila	Заколотники	true
start_pos_regions_rebel_faction_name_cha_reg_franconia_wurzburgcha_attila	Заколотники	true
start_pos_regions_rebel_faction_name_att_reg_sarmatia_asiatica_samandarpro_attila	Заколотники	true
start_pos_regions_long_description_att_reg_britannia_inferior_lindummain_attila	placeholder	true
start_pos_regions_long_description_att_reg_arabia_felix_zafarpro_attila	placeholder	true
start_pos_regions_long_description_att_reg_mediterraneus_occidentalis_caralismain_attila	placeholder	true
start_pos_regions_rebel_faction_name_cha_reg_gharb_al_anadalus_sevillecha_attila	Заколотники	true
start_pos_regions_long_description_att_reg_britannia_inferior_eboracummain_attila	placeholder	true
start_pos_regions_long_description_att_reg_armenia_tosppro_attila	placeholder	true
start_pos_regions_rebel_faction_name_cha_reg_brittany_st_malocha_attila	Заколотники	true
start_pos_regions_rebel_faction_name_bel_reg_brittany_riedonumbel_attila	Заколотники	true
start_pos_regions_rebel_faction_name_cha_reg_brittany_quimpercha_attila	Заколотники	true
start_pos_regions_rebel_faction_name_att_reg_frisia_tulifurdumpro_attila	Заколотники	true
start_pos_regions_rebel_faction_name_att_reg_osroene_edessamain_attila	Заколотники	true
start_pos_regions_long_description_att_reg_gallaecia_brigantiumpro_attila	placeholder	true
start_pos_regions_long_description_att_reg_britannia_inferior_segontiumpro_attila	placeholder	true
start_pos_regions_rebel_faction_name_bel_reg_aquitaine_avaricumbel_attila	Заколотники	true
start_pos_regions_long_description_att_reg_cappadocia_melitenemain_attila	placeholder	true
start_pos_regions_long_description_att_reg_maxima_sequanorum_octoduruspro_attila	placeholder	true
start_pos_regions_rebel_faction_name_att_reg_asorstan_meshanmain_attila	Заколотники	true
start_pos_regions_long_description_att_reg_lusitania_emerita_augustapro_attila	placeholder	true
start_pos_regions_long_description_att_reg_bithynia_nicomediamain_attila	placeholder	true
start_pos_regions_rebel_faction_name_att_reg_cilicia_tarsusmain_attila	Заколотники	true
start_pos_regions_long_description_att_reg_britannia_superior_londiniumpro_attila	placeholder	true
start_pos_regions_rebel_faction_name_att_reg_hercynia_budorgismain_attila	Заколотники	true
start_pos_regions_rebel_faction_name_bel_reg_lusitania_aeminiumbel_attila	Заколотники	true
start_pos_regions_rebel_faction_name_att_reg_scythia_rapro_attila	Заколотники	true
start_pos_regions_long_description_att_reg_mauretania_caesareapro_attila	placeholder	true
start_pos_regions_long_description_att_reg_britannia_inferior_eboracumpro_attila	placeholder	true
start_pos_regions_long_description_att_reg_italia_romapro_attila	placeholder	true
start_pos_regions_long_description_att_reg_germania_uburzismain_attila	placeholder	true
start_pos_regions_rebel_faction_name_att_reg_aethiopia_pachoraspro_attila	Заколотники	true
start_pos_regions_long_description_att_reg_scandza_hafnpro_attila	placeholder	true
start_pos_regions_rebel_faction_name_att_reg_venetia_aquileiamain_attila	Заколотники	true
start_pos_regions_long_description_att_reg_africa_hadrumentumpro_attila	placeholder	true
start_pos_regions_rebel_faction_name_att_reg_carthaginensis_segobrigamain_attila	Заколотники	true
start_pos_regions_long_description_att_reg_dalmatia_domaviamain_attila	placeholder	true
start_pos_regions_long_description_att_reg_baetica_hispalismain_attila	placeholder	true
start_pos_regions_rebel_faction_name_bel_reg_dalmatia_tarsaticabel_attila	Заколотники	true
start_pos_regions_long_description_att_reg_transcaspia_siahkuhmain_attila	placeholder	true
start_pos_regions_long_description_att_reg_italia_romamain_attila	placeholder	true
start_pos_regions_rebel_faction_name_att_reg_narbonensis_aquae_sextiaemain_attila	Заколотники	true
start_pos_regions_rebel_faction_name_att_reg_transcaspia_kathmain_attila	Заколотники	true
start_pos_regions_rebel_faction_name_att_reg_sarmatia_europaea_olbiamain_attila	Заколотники	true
start_pos_regions_rebel_faction_name_cha_reg_northumbria_streonshalhcha_attila	Заколотники	true
start_pos_regions_long_description_att_reg_belgica_colonia_agrippinapro_attila	placeholder	true
start_pos_regions_rebel_faction_name_att_reg_raetia_et_noricum_iuvavumpro_attila	Заколотники	true
start_pos_regions_long_description_att_reg_caucasia_mtskhetapro_attila	placeholder	true
start_pos_regions_long_description_att_reg_maxima_sequanorum_octodurusmain_attila	placeholder	true
start_pos_regions_long_description_att_reg_syria_tyrusmain_attila	placeholder	true
start_pos_regions_rebel_faction_name_att_reg_narbonensis_narbopro_attila	Заколотники	true
start_pos_regions_long_description_att_reg_tarraconensis_caesaraugustapro_attila	placeholder	true
start_pos_regions_rebel_faction_name_bel_reg_provence_vapincumbel_attila	Заколотники	true
start_pos_regions_long_description_att_reg_gothiscandza_gothiscandzapro_attila	placeholder	true
start_pos_regions_rebel_faction_name_att_reg_persis_behdeshirmain_attila	Заколотники	true
start_pos_regions_rebel_faction_name_att_reg_hyperborea_sylismain_attila	Заколотники	true
start_pos_regions_rebel_faction_name_att_reg_cilicia_iconiumpro_attila	Заколотники	true
start_pos_regions_long_description_att_reg_dacia_apulumpro_attila	placeholder	true
start_pos_regions_rebel_faction_name_att_reg_germania_aregeliamain_attila	Заколотники	true
start_pos_regions_rebel_faction_name_cha_reg_bavaria_regensburgcha_attila	Заколотники	true
start_pos_regions_rebel_faction_name_att_reg_germano_sarmatia_palteskjapro_attila	Заколотники	true
start_pos_regions_rebel_faction_name_bel_reg_sicilia_agrigentumbel_attila	Заколотники	true
start_pos_regions_long_description_att_reg_persis_sirafpro_attila	placeholder	true
start_pos_regions_long_description_att_reg_raetia_et_noricum_virunummain_attila	placeholder	true
start_pos_regions_rebel_faction_name_att_reg_dardania_serdicapro_attila	Заколотники	true
start_pos_regions_rebel_faction_name_att_reg_phazania_garamamain_attila	Заколотники	true
start_pos_regions_rebel_faction_name_cha_reg_leon_leoncha_attila	Заколотники	true
start_pos_regions_long_description_att_reg_aquitania_burdigalapro_attila	placeholder	true
start_pos_regions_long_description_att_reg_sarmatia_asiatica_samandarmain_attila	placeholder	true
start_pos_regions_long_description_att_reg_phazania_cydamusmain_attila	placeholder	true
start_pos_regions_rebel_faction_name_att_reg_osroene_nisibispro_attila	Заколотники	true
start_pos_regions_rebel_faction_name_att_reg_sarmatia_europaea_gelonusmain_attila	Заколотники	true
start_pos_regions_rebel_faction_name_att_reg_pannonia_sopianaemain_attila	Заколотники	true
start_pos_regions_long_description_att_reg_mauretania_tamousigapro_attila	placeholder	true
start_pos_regions_long_description_att_reg_lugdunensis_lugdunumpro_attila	placeholder	true
start_pos_regions_long_description_att_reg_mauretania_tingismain_attila	placeholder	true
start_pos_regions_long_description_att_reg_mauretania_tingispro_attila	placeholder	true
start_pos_regions_long_description_att_reg_africa_hadrumentummain_attila	placeholder	true
start_pos_regions_rebel_faction_name_cha_reg_bohemia_dresdencha_attila	Заколотники	true
start_pos_regions_long_description_att_reg_hercynia_casurgispro_attila	placeholder	true
start_pos_regions_long_description_att_reg_phazania_dimmidimain_attila	placeholder	true
start_pos_regions_long_description_att_reg_cappadocia_trapezusmain_attila	placeholder	true
start_pos_regions_rebel_faction_name_att_reg_hercynia_nitrahwapro_attila	Заколотники	true
start_pos_regions_rebel_faction_name_att_reg_dardania_serdicamain_attila	Заколотники	true
start_pos_regions_long_description_att_reg_syria_tyruspro_attila	placeholder	true
start_pos_regions_rebel_faction_name_cha_reg_west_aquitaine_angoulemecha_attila	Заколотники	true
start_pos_regions_rebel_faction_name_att_reg_pannonia_sirmiummain_attila	Заколотники	true
start_pos_regions_rebel_faction_name_att_reg_baetica_malacamain_attila	Заколотники	true
start_pos_regions_rebel_faction_name_cha_reg_swabia_strasbourgcha_attila	Заколотники	true
start_pos_regions_long_description_att_reg_hercynia_budorgispro_attila	placeholder	true
start_pos_regions_rebel_faction_name_bel_reg_brittany_osismorumbel_attila	Заколотники	true
start_pos_regions_rebel_faction_name_att_reg_bithynia_nicomediapro_attila	Заколотники	true
start_pos_regions_long_description_att_reg_makran_phramain_attila	placeholder	true
start_pos_regions_long_description_att_reg_macedonia_corinthuspro_attila	placeholder	true
start_pos_regions_rebel_faction_name_att_reg_dalmatia_domaviapro_attila	Заколотники	true
start_pos_regions_long_description_att_reg_arabia_magna_hirapro_attila	placeholder	true
start_pos_regions_long_description_att_reg_raetia_et_noricum_virunumpro_attila	placeholder	true
start_pos_regions_rebel_faction_name_bel_reg_mauretania_caesariensis_pomariabel_attila	Заколотники	true
start_pos_regions_long_description_att_reg_thracia_constantinopolismain_attila	placeholder	true
start_pos_regions_rebel_faction_name_bel_reg_liguria_augusta_taurinorumbel_attila	Заколотники	true
start_pos_regions_long_description_att_reg_transcarpathia_belzpro_attila	placeholder	true
start_pos_regions_long_description_att_reg_arabia_felix_omanapro_attila	placeholder	true
start_pos_regions_long_description_att_reg_aegyptus_berenicepro_attila	placeholder	true
start_pos_regions_long_description_att_reg_pannonia_sopianaepro_attila	placeholder	true
start_pos_regions_rebel_faction_name_bel_reg_sardinia_et_corsica_aleriabel_attila	Заколотники	true
start_pos_regions_rebel_faction_name_att_reg_aquitania_avaricumpro_attila	Заколотники	true
start_pos_regions_rebel_faction_name_cha_reg_sardinia_and_corsica_olbiacha_attila	Заколотники	true
start_pos_regions_long_description_att_reg_raetia_et_noricum_iuvavummain_attila	placeholder	true
start_pos_regions_rebel_faction_name_att_reg_asorstan_arbelamain_attila	Заколотники	true
start_pos_regions_rebel_faction_name_cha_reg_septimania_urgellcha_attila	Заколотники	true
start_pos_regions_rebel_faction_name_cha_reg_alemannia_konstanzcha_attila	Заколотники	true
start_pos_regions_long_description_att_reg_aquitania_burdigalamain_attila	placeholder	true
start_pos_regions_rebel_faction_name_att_reg_lusitania_emerita_augustamain_attila	Заколотники	true
start_pos_regions_long_description_att_reg_spahan_susamain_attila	placeholder	true
start_pos_regions_long_description_att_reg_maxima_sequanorum_vesontiopro_attila	placeholder	true
start_pos_regions_long_description_att_reg_italia_fiorentiamain_attila	placeholder	true
start_pos_regions_rebel_faction_name_bel_reg_burgundy_valentiabel_attila	Заколотники	true
start_pos_regions_long_description_att_reg_pannonia_savariamain_attila	placeholder	true
start_pos_regions_rebel_faction_name_att_reg_liguria_segusiopro_attila	Заколотники	true
start_pos_regions_rebel_faction_name_att_reg_venetia_ravennapro_attila	Заколотники	true
start_pos_regions_rebel_faction_name_cha_reg_carinthia_salzburgcha_attila	Заколотники	true
start_pos_regions_long_description_att_reg_belgica_durocorterumpro_attila	placeholder	true
start_pos_regions_rebel_faction_name_att_reg_pannonia_savariamain_attila	Заколотники	true
start_pos_regions_long_description_att_reg_mediterraneus_occidentalis_caralispro_attila	placeholder	true
start_pos_regions_long_description_att_reg_dardania_viminaciumpro_attila	placeholder	true
start_pos_regions_rebel_faction_name_att_reg_italia_fiorentiamain_attila	Заколотники	true
start_pos_regions_rebel_faction_name_cha_reg_gascony_bayonnecha_attila	Заколотники	true
start_pos_regions_long_description_att_reg_arabia_felix_zafarmain_attila	placeholder	true
start_pos_regions_long_description_att_reg_aegyptus_alexandriapro_attila	placeholder	true
start_pos_regions_rebel_faction_name_cha_reg_pictland_dumbartoncha_attila	Заколотники	true
start_pos_regions_rebel_faction_name_att_reg_hercynia_casurgismain_attila	Заколотники	true
start_pos_regions_rebel_faction_name_bel_reg_neustria_turonorumbel_attila	Заколотники	true
start_pos_regions_long_description_att_reg_dacia_romulapro_attila	placeholder	true
start_pos_regions_long_description_att_reg_armenia_payttakaranmain_attila	placeholder	true
start_pos_regions_long_description_att_reg_makran_puramain_attila	placeholder	true
start_pos_regions_long_description_att_reg_khwarasan_abarshahrpro_attila	placeholder	true
start_pos_regions_long_description_att_reg_cappadocia_melitenepro_attila	placeholder	true
start_pos_regions_rebel_faction_name_att_reg_bithynia_amaseamain_attila	Заколотники	true
start_pos_regions_rebel_faction_name_cha_reg_wessex_canterburycha_attila	Заколотники	true
start_pos_regions_rebel_faction_name_att_reg_sarmatia_asiatica_anacopiapro_attila	Заколотники	true
start_pos_regions_rebel_faction_name_att_reg_libya_paraetoniummain_attila	Заколотники	true
start_pos_regions_rebel_faction_name_att_reg_aegyptus_berenicemain_attila	Заколотники	true
start_pos_regions_long_description_att_reg_armenia_duinpro_attila	placeholder	true
start_pos_regions_rebel_faction_name_att_reg_aegyptus_berenicepro_attila	Заколотники	true
start_pos_regions_rebel_faction_name_att_reg_pannonia_sopianaepro_attila	Заколотники	true
start_pos_regions_long_description_att_reg_sarmatia_asiatica_anacopiamain_attila	placeholder	true
start_pos_regions_long_description_att_reg_germania_lupfurdummain_attila	placeholder	true
start_pos_regions_long_description_att_reg_libya_augilapro_attila	placeholder	true
start_pos_regions_long_description_att_reg_britannia_superior_coriniummain_attila	placeholder	true
start_pos_regions_rebel_faction_name_att_reg_thracia_trimontiumpro_attila	Заколотники	true
start_pos_regions_long_description_att_reg_transcarpathia_belzmain_attila	placeholder	true
start_pos_regions_rebel_faction_name_att_reg_thracia_constantinopolismain_attila	Заколотники	true
start_pos_regions_rebel_faction_name_cha_reg_burgundy_grenoblecha_attila	Заколотники	true
start_pos_regions_rebel_faction_name_att_reg_dalmatia_salonamain_attila	Заколотники	true
start_pos_regions_rebel_faction_name_att_reg_arabia_magna_hirapro_attila	Заколотники	true
start_pos_regions_rebel_faction_name_att_reg_raetia_et_noricum_virunumpro_attila	Заколотники	true
start_pos_regions_rebel_faction_name_cha_reg_obodrites_stargardcha_attila	Заколотники	true
start_pos_regions_rebel_faction_name_bel_reg_liguria_mediolanumbel_attila	Заколотники	true
start_pos_regions_long_description_att_reg_cilicia_myrapro_attila	placeholder	true
start_pos_regions_rebel_faction_name_bel_reg_venetia_et_histria_veronabel_attila	Заколотники	true
start_pos_regions_rebel_faction_name_att_reg_phazania_dimmidipro_attila	Заколотники	true
start_pos_regions_long_description_att_reg_hyperborea_kariskospro_attila	placeholder	true
start_pos_regions_rebel_faction_name_bel_reg_provence_massiliabel_attila	Заколотники	true
start_pos_regions_rebel_faction_name_att_reg_gothiscandza_ascaucalismain_attila	Заколотники	true
start_pos_regions_rebel_faction_name_att_reg_hercynia_budorgispro_attila	Заколотники	true
start_pos_regions_long_description_att_reg_gothiscandza_rugionpro_attila	placeholder	true
start_pos_regions_long_description_att_reg_hercynia_nitrahwapro_attila	placeholder	true
start_pos_regions_long_description_att_reg_dardania_serdicamain_attila	placeholder	true
start_pos_regions_rebel_faction_name_att_reg_sarmatia_asiatica_tanaispro_attila	Заколотники	true
start_pos_regions_rebel_faction_name_att_reg_venetia_veronamain_attila	Заколотники	true
start_pos_regions_rebel_faction_name_cha_reg_sicilia_akragascha_attila	Заколотники	true
start_pos_regions_long_description_att_reg_pannonia_sirmiummain_attila	placeholder	true
start_pos_regions_rebel_faction_name_bel_reg_cantabria_portus_victoriaebel_attila	Заколотники	true
start_pos_regions_rebel_faction_name_att_reg_media_atropatene_ecbatanamain_attila	Заколотники	true
start_pos_regions_rebel_faction_name_att_reg_phazania_dimmidimain_attila	Заколотники	true
start_pos_regions_rebel_faction_name_att_reg_hercynia_casurgispro_attila	Заколотники	true
start_pos_regions_long_description_att_reg_gallaecia_asturicamain_attila	placeholder	true
start_pos_regions_long_description_att_reg_maxima_sequanorum_vesontiomain_attila	placeholder	true
start_pos_regions_rebel_faction_name_att_reg_mauretania_tingispro_attila	Заколотники	true
start_pos_regions_rebel_faction_name_att_reg_palaestinea_nova_trajana_bostrapro_attila	Заколотники	true
start_pos_regions_rebel_faction_name_bel_reg_lusitania_olissipobel_attila	Заколотники	true
start_pos_regions_rebel_faction_name_att_reg_hercynia_nitrahwamain_attila	Заколотники	true
start_pos_regions_rebel_faction_name_bel_reg_zeugitana_thagastebel_attila	Заколотники	true
start_pos_regions_long_description_att_reg_scandza_hrefnesholtmain_attila	placeholder	true
start_pos_regions_rebel_faction_name_att_reg_phazania_cydamusmain_attila	Заколотники	true
start_pos_regions_rebel_faction_name_att_reg_pannonia_savariapro_attila	Заколотники	true
start_pos_regions_long_description_att_reg_hyperborea_moramarpro_attila	placeholder	true
start_pos_regions_rebel_faction_name_bel_reg_mauretania_tingitana_anfabel_attila	Заколотники	true
start_pos_regions_rebel_faction_name_att_reg_asorstan_ctesiphonpro_attila	Заколотники	true
start_pos_regions_rebel_faction_name_att_reg_belgica_colonia_agrippinamain_attila	Заколотники	true
start_pos_regions_rebel_faction_name_att_reg_lusitania_olisipomain_attila	Заколотники	true
start_pos_regions_long_description_att_reg_cappadocia_caesarea_eusebiamain_attila	placeholder	true
start_pos_regions_rebel_faction_name_cha_reg_marca_media_meridacha_attila	Заколотники	true
start_pos_regions_long_description_att_reg_britannia_superior_coriniumpro_attila	placeholder	true
start_pos_regions_rebel_faction_name_cha_reg_pannonia_kaposvarcha_attila	Заколотники	true
start_pos_regions_rebel_faction_name_bel_reg_byzacena_sufetulabel_attila	Заколотники	true
start_pos_regions_long_description_att_reg_hyperborea_sylismain_attila	placeholder	true
start_pos_regions_rebel_faction_name_att_reg_gothiscandza_gothiscandzapro_attila	Заколотники	true
start_pos_regions_long_description_att_reg_persis_behdeshirmain_attila	placeholder	true
start_pos_regions_long_description_att_reg_narbonensis_narbopro_attila	placeholder	true
start_pos_regions_long_description_att_reg_arabia_felix_omanamain_attila	placeholder	true
start_pos_regions_rebel_faction_name_cha_reg_valencia_cartagenacha_attila	Заколотники	true
start_pos_regions_rebel_faction_name_bel_reg_aquitaine_arvernisbel_attila	Заколотники	true
start_pos_regions_long_description_att_reg_lugdunensis_turonummain_attila	placeholder	true
start_pos_regions_rebel_faction_name_att_reg_belgica_colonia_agrippinapro_attila	Заколотники	true
start_pos_regions_rebel_faction_name_att_reg_phazania_cydamuspro_attila	Заколотники	true
start_pos_regions_long_description_att_reg_aethiopia_pachorasmain_attila	placeholder	true
start_pos_regions_rebel_faction_name_att_reg_caucasia_mtskhetapro_attila	Заколотники	true
start_pos_regions_rebel_faction_name_cha_reg_gallicia_santiagocha_attila	Заколотники	true
start_pos_regions_long_description_att_reg_raetia_et_noricum_iuvavumpro_attila	placeholder	true
start_pos_regions_long_description_att_reg_transcaspia_kathmain_attila	placeholder	true
start_pos_regions_rebel_faction_name_att_reg_media_atropatene_ganzagapro_attila	Заколотники	true
start_pos_regions_rebel_faction_name_bel_reg_sardinia_et_corsica_turrisbel_attila	Заколотники	true
start_pos_regions_rebel_faction_name_att_reg_gothiscandza_gothiscandzamain_attila	Заколотники	true
start_pos_regions_long_description_att_reg_transcaspia_dahistanpro_attila	placeholder	true
start_pos_regions_long_description_att_reg_carthaginensis_segobrigamain_attila	placeholder	true
start_pos_regions_long_description_att_reg_makran_purapro_attila	placeholder	true
start_pos_regions_rebel_faction_name_cha_reg_calabria_tarantocha_attila	Заколотники	true
start_pos_regions_rebel_faction_name_att_reg_dalmatia_domaviamain_attila	Заколотники	true
start_pos_regions_long_description_att_reg_cappadocia_trapezuspro_attila	placeholder	true
start_pos_regions_rebel_faction_name_att_reg_baetica_hispalismain_attila	Заколотники	true
start_pos_regions_long_description_att_reg_makran_phrapro_attila	placeholder	true
start_pos_regions_long_description_att_reg_venetia_aquileiamain_attila	placeholder	true
start_pos_regions_long_description_att_reg_macedonia_corinthusmain_attila	placeholder	true
start_pos_regions_rebel_faction_name_bel_reg_cantabria_pompaelobel_attila	Заколотники	true
start_pos_regions_rebel_faction_name_att_reg_narbonensis_narbomain_attila	Заколотники	true
start_pos_regions_long_description_att_reg_mauretania_caesareamain_attila	placeholder	true
start_pos_regions_rebel_faction_name_att_reg_caucasia_kotaismain_attila	Заколотники	true
start_pos_regions_rebel_faction_name_att_reg_caucasia_gabalamain_attila	Заколотники	true
start_pos_regions_rebel_faction_name_att_reg_germania_uburzismain_attila	Заколотники	true
start_pos_regions_rebel_faction_name_cha_reg_valencia_valenciacha_attila	Заколотники	true
start_pos_regions_rebel_faction_name_att_reg_pannonia_sirmiumpro_attila	Заколотники	true
start_pos_regions_long_description_att_reg_carthaginensis_carthago_novapro_attila	placeholder	true
start_pos_regions_rebel_faction_name_att_reg_bithynia_ancyramain_attila	Заколотники	true
start_pos_regions_rebel_faction_name_bel_reg_burgundy_besantiobel_attila	Заколотники	true
start_pos_regions_long_description_att_reg_asorstan_ctesiphonmain_attila	placeholder	true
start_pos_regions_rebel_faction_name_att_reg_belgica_augusta_treverorumpro_attila	Заколотники	true
start_pos_regions_long_description_att_reg_tarraconensis_caesaraugustamain_attila	placeholder	true
start_pos_regions_rebel_faction_name_att_reg_narbonensis_viennapro_attila	Заколотники	true
start_pos_regions_rebel_faction_name_att_reg_germania_uburzispro_attila	Заколотники	true
start_pos_regions_rebel_faction_name_bel_reg_neustria_portus_namnetumbel_attila	Заколотники	true
start_pos_regions_rebel_faction_name_att_reg_lusitania_emerita_augustapro_attila	Заколотники	true
start_pos_regions_long_description_att_reg_belgica_augusta_treverorummain_attila	placeholder	true
start_pos_regions_rebel_faction_name_att_reg_scythia_bolgharpro_attila	Заколотники	true
start_pos_regions_rebel_faction_name_cha_reg_moravia_savariacha_attila	Заколотники	true
start_pos_regions_rebel_faction_name_cha_reg_pannonia_cibakhazacha_attila	Заколотники	true
start_pos_regions_long_description_att_reg_hyperborea_kariskosmain_attila	placeholder	true
start_pos_regions_long_description_att_reg_africa_constantinamain_attila	placeholder	true
start_pos_regions_rebel_faction_name_cha_reg_navarre_saragossacha_attila	Заколотники	true
start_pos_regions_long_description_att_reg_africa_constantinapro_attila	placeholder	true
start_pos_regions_long_description_att_reg_frisia_tulifurdumpro_attila	placeholder	true
start_pos_regions_long_description_att_reg_hyperborea_moramarmain_attila	placeholder	true
start_pos_regions_rebel_faction_name_cha_reg_rome_romacha_attila	Заколотники	true
start_pos_regions_long_description_att_reg_frisia_tulifurdummain_attila	placeholder	true
start_pos_regions_rebel_faction_name_cha_reg_al_andalus_cordobacha_attila	Заколотники	true
start_pos_regions_long_description_att_reg_palaestinea_aelia_capitolinapro_attila	placeholder	true
start_pos_regions_rebel_faction_name_att_reg_liguria_mediolanumpro_attila	Заколотники	true
start_pos_regions_rebel_faction_name_att_reg_mediterraneus_orientalis_rhodesmain_attila	Заколотники	true
start_pos_regions_long_description_att_reg_khwarasan_abarshahrmain_attila	placeholder	true
start_pos_regions_rebel_faction_name_cha_reg_provence_marseillecha_attila	Заколотники	true
start_pos_regions_rebel_faction_name_cha_reg_rome_sienacha_attila	Заколотники	true
start_pos_regions_rebel_faction_name_cha_reg_al_andalus_almeriacha_attila	Заколотники	true
start_pos_regions_long_description_att_reg_syria_emesamain_attila	placeholder	true
start_pos_regions_long_description_att_reg_aquitania_avaricummain_attila	placeholder	true
start_pos_regions_long_description_att_reg_syria_emesapro_attila	placeholder	true
start_pos_regions_rebel_faction_name_att_reg_dalmatia_sisciamain_attila	Заколотники	true
start_pos_regions_long_description_att_reg_arabia_magna_hiramain_attila	placeholder	true
start_pos_regions_rebel_faction_name_att_reg_tripolitana_leptis_magnamain_attila	Заколотники	true
start_pos_regions_rebel_faction_name_att_reg_baetica_cordubapro_attila	Заколотники	true
start_pos_regions_rebel_faction_name_att_reg_mediterraneus_orientalis_gortynapro_attila	Заколотники	true
start_pos_regions_long_description_att_reg_germania_aregeliapro_attila	placeholder	true
start_pos_regions_long_description_att_reg_palaestinea_ailamain_attila	placeholder	true
start_pos_regions_rebel_faction_name_att_reg_mauretania_tingismain_attila	Заколотники	true
start_pos_regions_long_description_att_reg_sarmatia_europaea_gelonusmain_attila	placeholder	true
start_pos_regions_rebel_faction_name_cha_reg_brittany_vannescha_attila	Заколотники	true
start_pos_regions_rebel_faction_name_att_reg_osroene_nisibismain_attila	Заколотники	true
start_pos_regions_rebel_faction_name_cha_reg_exarchate_bolognacha_attila	Заколотники	true
start_pos_regions_rebel_faction_name_cha_reg_marca_hispanica_barcelonacha_attila	Заколотники	true
start_pos_regions_rebel_faction_name_att_reg_sarmatia_asiatica_tanaismain_attila	Заколотники	true
start_pos_regions_long_description_att_reg_pannonia_sopianaemain_attila	placeholder	true
start_pos_regions_long_description_att_reg_sarmatia_europaea_gelonuspro_attila	placeholder	true
start_pos_regions_rebel_faction_name_bel_reg_austrasia_mettisbel_attila	Заколотники	true
start_pos_regions_rebel_faction_name_bel_reg_tuscia_et_umbria_arretiumbel_attila	Заколотники	true
start_pos_regions_long_description_att_reg_caledonia_et_hibernia_tuesispro_attila	placeholder	true
start_pos_regions_long_description_att_reg_scythia_ramain_attila	placeholder	true
start_pos_regions_long_description_att_reg_lugdunensis_turonumpro_attila	placeholder	true
start_pos_regions_rebel_faction_name_bel_reg_mauretania_caesariensis_cartennabel_attila	Заколотники	true
start_pos_regions_rebel_faction_name_att_reg_magna_graecia_tarentummain_attila	Заколотники	true
start_pos_regions_rebel_faction_name_att_reg_britannia_superior_camulodunonmain_attila	Заколотники	true
start_pos_regions_long_description_att_reg_asia_ephesuspro_attila	placeholder	true
start_pos_regions_rebel_faction_name_cha_reg_mercia_lichfieldcha_attila	Заколотники	true
start_pos_regions_rebel_faction_name_bel_reg_dalmatia_salonabel_attila	Заколотники	true
start_pos_regions_rebel_faction_name_cha_reg_swabia_bescanoncha_attila	Заколотники	true
start_pos_regions_rebel_faction_name_att_reg_raetia_et_noricum_virunummain_attila	Заколотники	true
start_pos_regions_long_description_att_reg_germania_aregeliamain_attila	placeholder	true
start_pos_regions_long_description_att_reg_germano_sarmatia_palteskjapro_attila	placeholder	true
start_pos_regions_rebel_faction_name_att_reg_khwarasan_hareymain_attila	Заколотники	true
start_pos_regions_rebel_faction_name_att_reg_mediterraneus_occidentalis_ajaxmain_attila	Заколотники	true
start_pos_regions_rebel_faction_name_att_reg_raetia_et_noricum_iuvavummain_attila	Заколотники	true
start_pos_regions_rebel_faction_name_att_reg_africa_carthagomain_attila	Заколотники	true
start_pos_regions_long_description_att_reg_scandza_hrefnesholtpro_attila	placeholder	true
start_pos_regions_long_description_att_reg_aquitania_avaricumpro_attila	placeholder	true
start_pos_regions_rebel_faction_name_bel_reg_baetica_hispalisbel_attila	Заколотники	true
start_pos_regions_rebel_faction_name_att_reg_mediterraneus_orientalis_rhodespro_attila	Заколотники	true
start_pos_regions_rebel_faction_name_cha_reg_calabria_regioncha_attila	Заколотники	true
start_pos_regions_rebel_faction_name_att_reg_khwarasan_mervmain_attila	Заколотники	true
start_pos_regions_rebel_faction_name_cha_reg_al_andalus_jaencha_attila	Заколотники	true
start_pos_regions_rebel_faction_name_att_reg_maxima_sequanorum_vesontiopro_attila	Заколотники	true
start_pos_regions_rebel_faction_name_cha_reg_toledo_calatravacha_attila	Заколотники	true
start_pos_regions_rebel_faction_name_bel_reg_mauretania_caesariensis_caesareabel_attila	Заколотники	true
start_pos_regions_long_description_att_reg_lusitania_emerita_augustamain_attila	placeholder	true
start_pos_regions_rebel_faction_name_att_reg_libya_ptolemaismain_attila	Заколотники	true
start_pos_regions_rebel_faction_name_att_reg_makran_harmosiapro_attila	Заколотники	true
start_pos_regions_rebel_faction_name_cha_reg_toledo_guadalajaracha_attila	Заколотники	true
start_pos_regions_long_description_att_reg_aegyptus_oxyrhynchuspro_attila	placeholder	true
start_pos_regions_rebel_faction_name_att_reg_cilicia_iconiummain_attila	Заколотники	true
start_pos_regions_rebel_faction_name_att_reg_caucasia_kotaispro_attila	Заколотники	true
start_pos_regions_rebel_faction_name_cha_reg_navarre_pamplonacha_attila	Заколотники	true
start_pos_regions_long_description_att_reg_bithynia_nicomediapro_attila	placeholder	true
start_pos_regions_rebel_faction_name_cha_reg_exarchate_anconacha_attila	Заколотники	true
start_pos_regions_rebel_faction_name_bel_reg_tuscia_et_umbria_faesulaebel_attila	Заколотники	true
start_pos_regions_rebel_faction_name_cha_reg_wales_mathrafalcha_attila	Заколотники	true
start_pos_regions_rebel_faction_name_cha_reg_alemannia_baselcha_attila	Заколотники	true
start_pos_regions_rebel_faction_name_att_reg_arabia_felix_omanapro_attila	Заколотники	true
start_pos_regions_long_description_att_reg_arabia_magna_yathribpro_attila	placeholder	true
start_pos_regions_rebel_faction_name_bel_reg_austrasia_augustobona_tricassiumbel_attila	Заколотники	true
start_pos_regions_rebel_faction_name_att_reg_aethiopia_adulismain_attila	Заколотники	true
start_pos_regions_long_description_att_reg_liguria_mediolanummain_attila	placeholder	true
start_pos_regions_rebel_faction_name_att_reg_transcarpathia_arheimarmain_attila	Заколотники	true
start_pos_regions_rebel_faction_name_att_reg_sarmatia_europaea_olbiapro_attila	Заколотники	true
start_pos_regions_rebel_faction_name_cha_reg_gallicia_oviedocha_attila	Заколотники	true
start_pos_regions_rebel_faction_name_att_reg_transcarpathia_leopolispro_attila	Заколотники	true
start_pos_regions_rebel_faction_name_att_reg_aquitania_elusamain_attila	Заколотники	true
start_pos_regions_rebel_faction_name_cha_reg_obodrites_rerikcha_attila	Заколотники	true
start_pos_regions_long_description_att_reg_mediterraneus_orientalis_gortynamain_attila	placeholder	true
start_pos_regions_long_description_att_reg_caledonia_et_hibernia_eildonpro_attila	placeholder	true
start_pos_regions_long_description_att_reg_caledonia_et_hibernia_eblanapro_attila	placeholder	true
start_pos_regions_rebel_faction_name_cha_reg_gharb_al_anadalus_cadizcha_attila	Заколотники	true
start_pos_regions_rebel_faction_name_bel_reg_austrasia_remorumbel_attila	Заколотники	true
start_pos_regions_rebel_faction_name_att_reg_media_atropatene_ganzagamain_attila	Заколотники	true
start_pos_regions_long_description_att_reg_lusitania_olisipopro_attila	placeholder	true
start_pos_regions_rebel_faction_name_att_reg_syria_antiochiamain_attila	Заколотники	true
start_pos_regions_long_description_att_reg_gallaecia_bracarapro_attila	placeholder	true
start_pos_regions_long_description_att_reg_asia_synnadapro_attila	placeholder	true
start_pos_regions_rebel_faction_name_bel_reg_sicilia_syracusebel_attila	Заколотники	true
start_pos_regions_rebel_faction_name_cha_reg_sicilia_syracusecha_attila	Заколотники	true
start_pos_regions_rebel_faction_name_cha_reg_gascony_bordeauxcha_attila	Заколотники	true
start_pos_regions_rebel_faction_name_cha_reg_pannonia_szegedcha_attila	Заколотники	true
start_pos_regions_rebel_faction_name_att_reg_tripolitana_leptis_magnapro_attila	Заколотники	true
start_pos_regions_rebel_faction_name_bel_reg_lucania_et_brutii_rhegiumbel_attila	Заколотники	true
start_pos_regions_long_description_att_reg_libya_paraetoniumpro_attila	placeholder	true
start_pos_regions_rebel_faction_name_att_reg_magna_graecia_syracusaepro_attila	Заколотники	true
start_pos_regions_rebel_faction_name_cha_reg_pictland_rhyniecha_attila	Заколотники	true
start_pos_regions_rebel_faction_name_bel_reg_brittany_gwenedbel_attila	Заколотники	true
start_pos_regions_long_description_att_reg_gallaecia_bracaramain_attila	placeholder	true
start_pos_regions_rebel_faction_name_cha_reg_exarchate_ravennacha_attila	Заколотники	true
start_pos_regions_long_description_att_reg_britannia_inferior_lindumpro_attila	placeholder	true
start_pos_regions_rebel_faction_name_cha_reg_ulster_downpatrickcha_attila	Заколотники	true
start_pos_regions_rebel_faction_name_att_reg_arabia_felix_zafarpro_attila	Заколотники	true
start_pos_regions_rebel_faction_name_att_reg_britannia_inferior_lindummain_attila	Заколотники	true
start_pos_regions_long_description_att_reg_germania_lupfurdumpro_attila	placeholder	true
start_pos_regions_long_description_att_reg_gallaecia_asturicapro_attila	placeholder	true
start_pos_regions_long_description_att_reg_caucasia_mtskhetamain_attila	placeholder	true
start_pos_regions_rebel_faction_name_bel_reg_novempopulania_burdigalabel_attila	Заколотники	true
start_pos_regions_rebel_faction_name_att_reg_magna_graecia_syracusaemain_attila	Заколотники	true
start_pos_regions_rebel_faction_name_att_reg_transcaspia_kathpro_attila	Заколотники	true
start_pos_regions_rebel_faction_name_cha_reg_marca_hispanica_tarragonacha_attila	Заколотники	true
start_pos_regions_rebel_faction_name_cha_reg_northumbria_yorkcha_attila	Заколотники	true
start_pos_regions_long_description_att_reg_sarmatia_asiatica_samandarpro_attila	placeholder	true
start_pos_regions_rebel_faction_name_att_reg_aethiopia_adulispro_attila	Заколотники	true
start_pos_regions_rebel_faction_name_att_reg_africa_hadrumentumpro_attila	Заколотники	true
start_pos_regions_long_description_att_reg_aegyptus_alexandriamain_attila	placeholder	true
start_pos_regions_rebel_faction_name_cha_reg_calabria_krotoncha_attila	Заколотники	true
start_pos_regions_long_description_att_reg_aethiopia_pachoraspro_attila	placeholder	true
start_pos_regions_rebel_faction_name_bel_reg_aquitaine_lemonumbel_attila	Заколотники	true
start_pos_regions_rebel_faction_name_att_reg_carthaginensis_segobrigapro_attila	Заколотники	true
start_pos_regions_rebel_faction_name_cha_reg_carinthia_lorchcha_attila	Заколотники	true
start_pos_regions_rebel_faction_name_att_reg_transcarpathia_arheimarpro_attila	Заколотники	true
start_pos_regions_rebel_faction_name_cha_reg_austrasia_triercha_attila	Заколотники	true
start_pos_regions_long_description_att_reg_narbonensis_aquae_sextiaepro_attila	placeholder	true
start_pos_regions_rebel_faction_name_att_reg_palaestinea_nova_trajana_bostramain_attila	Заколотники	true
start_pos_regions_rebel_faction_name_cha_reg_angria_paderborncha_attila	Заколотники	true
start_pos_regions_rebel_faction_name_att_reg_palaestinea_ailapro_attila	Заколотники	true
start_pos_regions_rebel_faction_name_att_reg_macedonia_thessalonicamain_attila	Заколотники	true
start_pos_regions_rebel_faction_name_att_reg_mediterraneus_occidentalis_palmamain_attila	Заколотники	true
start_pos_regions_long_description_att_reg_narbonensis_aquae_sextiaemain_attila	placeholder	true
start_pos_regions_rebel_faction_name_bel_reg_celtiberia_segoviabel_attila	Заколотники	true
start_pos_regions_long_description_att_reg_asia_cyzicuspro_attila	placeholder	true
start_pos_regions_long_description_att_reg_arabia_magna_dumathapro_attila	placeholder	true
start_pos_regions_rebel_faction_name_att_reg_media_atropatene_ecbatanapro_attila	Заколотники	true
start_pos_regions_rebel_faction_name_att_reg_sarmatia_europaea_chersonessusmain_attila	Заколотники	true
start_pos_regions_rebel_faction_name_att_reg_asorstan_arbelapro_attila	Заколотники	true
start_pos_regions_rebel_faction_name_att_reg_italia_neapolismain_attila	Заколотники	true
start_pos_regions_rebel_faction_name_att_reg_dalmatia_sisciapro_attila	Заколотники	true
start_pos_regions_long_description_att_reg_hercynia_budorgismain_attila	placeholder	true
start_pos_regions_long_description_att_reg_scythia_rapro_attila	placeholder	true
start_pos_regions_rebel_faction_name_att_reg_carthaginensis_toletummain_attila	Заколотники	true
start_pos_regions_rebel_faction_name_bel_reg_lucania_et_brutii_thuriibel_attila	Заколотники	true
start_pos_regions_rebel_faction_name_att_reg_dalmatia_salonapro_attila	Заколотники	true
start_pos_regions_rebel_faction_name_att_reg_italia_fiorentiapro_attila	Заколотники	true
start_pos_regions_long_description_att_reg_cappadocia_caesarea_eusebiapro_attila	placeholder	true
start_pos_regions_rebel_faction_name_att_reg_caucasia_gabalapro_attila	Заколотники	true
start_pos_regions_long_description_att_reg_thracia_trimontiummain_attila	placeholder	true
start_pos_regions_long_description_att_reg_narbonensis_narbomain_attila	placeholder	true
start_pos_regions_rebel_faction_name_att_reg_libya_ptolemaispro_attila	Заколотники	true
start_pos_regions_rebel_faction_name_att_reg_thracia_constantinopolispro_attila	Заколотники	true
start_pos_regions_rebel_faction_name_att_reg_transcarpathia_leopolismain_attila	Заколотники	true
start_pos_regions_rebel_faction_name_att_reg_dardania_scupimain_attila	Заколотники	true
start_pos_regions_long_description_att_reg_transcaspia_siahkuhpro_attila	placeholder	true
start_pos_regions_rebel_faction_name_att_reg_hyperborea_sylispro_attila	Заколотники	true
start_pos_regions_rebel_faction_name_cha_reg_angria_buraburgcha_attila	Заколотники	true
start_pos_regions_long_description_att_reg_media_atropatene_ecbatanapro_attila	placeholder	true
start_pos_regions_rebel_faction_name_att_reg_khwarasan_hareypro_attila	Заколотники	true
start_pos_regions_long_description_att_reg_dardania_viminaciummain_attila	placeholder	true
start_pos_regions_long_description_att_reg_mediterraneus_occidentalis_palmamain_attila	placeholder	true
start_pos_regions_rebel_faction_name_cha_reg_west_aquitaine_poitierscha_attila	Заколотники	true
start_pos_regions_long_description_att_reg_tripolitana_sabratapro_attila	placeholder	true
start_pos_regions_rebel_faction_name_cha_reg_moravia_mosaburgcha_attila	Заколотники	true
start_pos_regions_rebel_faction_name_att_reg_africa_carthagopro_attila	Заколотники	true
start_pos_regions_long_description_att_reg_mediterraneus_orientalis_constantiamain_attila	placeholder	true
start_pos_regions_rebel_faction_name_cha_reg_burgundy_genevecha_attila	Заколотники	true
start_pos_regions_long_description_att_reg_gothiscandza_gothiscandzamain_attila	placeholder	true
start_pos_regions_rebel_faction_name_att_reg_narbonensis_aquae_sextiaepro_attila	Заколотники	true
start_pos_regions_rebel_faction_name_bel_reg_carthaginensis_libisosabel_attila	Заколотники	true
start_pos_regions_long_description_att_reg_germano_sarmatia_palteskjamain_attila	placeholder	true
start_pos_regions_long_description_att_reg_armenia_payttakaranpro_attila	placeholder	true
start_pos_regions_rebel_faction_name_bel_reg_gallaecia_bracarabel_attila	Заколотники	true
start_pos_regions_rebel_faction_name_att_reg_spahan_issatismain_attila	Заколотники	true
start_pos_regions_long_description_att_reg_liguria_mediolanumpro_attila	placeholder	true
start_pos_regions_rebel_faction_name_att_reg_syria_antiochiapro_attila	Заколотники	true
start_pos_regions_rebel_faction_name_att_reg_arabia_magna_hiramain_attila	Заколотники	true
start_pos_regions_rebel_faction_name_bel_reg_lusitania_emeritabel_attila	Заколотники	true
start_pos_regions_rebel_faction_name_cha_reg_bavaria_augsburgcha_attila	Заколотники	true
start_pos_regions_rebel_faction_name_att_reg_baetica_hispalispro_attila	Заколотники	true
start_pos_regions_rebel_faction_name_att_reg_mediterraneus_occidentalis_ajaxpro_attila	Заколотники	true
start_pos_regions_rebel_faction_name_att_reg_britannia_inferior_lindumpro_attila	Заколотники	true
start_pos_regions_rebel_faction_name_att_reg_libya_paraetoniumpro_attila	Заколотники	true
start_pos_regions_long_description_att_reg_belgica_augusta_treverorumpro_attila	placeholder	true
start_pos_regions_rebel_faction_name_cha_reg_lombardy_genovacha_attila	Заколотники	true
start_pos_regions_long_description_att_reg_narbonensis_viennapro_attila	placeholder	true
start_pos_regions_rebel_faction_name_att_reg_dacia_petrodavamain_attila	Заколотники	true
start_pos_regions_rebel_faction_name_att_reg_africa_constantinapro_attila	Заколотники	true
start_pos_regions_rebel_faction_name_att_reg_frisia_tulifurdummain_attila	Заколотники	true
start_pos_regions_rebel_faction_name_att_reg_lusitania_olisipopro_attila	Заколотники	true
start_pos_regions_long_description_att_reg_narbonensis_viennamain_attila	placeholder	true
start_pos_regions_rebel_faction_name_att_reg_scythia_bolgharmain_attila	Заколотники	true
start_pos_regions_rebel_faction_name_att_reg_gallaecia_bracarapro_attila	Заколотники	true
start_pos_regions_rebel_faction_name_cha_reg_ulster_cruachancha_attila	Заколотники	true
start_pos_regions_rebel_faction_name_cha_reg_austrasia_aachencha_attila	Заколотники	true
start_pos_regions_long_description_att_reg_media_atropatene_ganzagamain_attila	placeholder	true
start_pos_regions_long_description_att_reg_sarmatia_asiatica_anacopiapro_attila	placeholder	true
start_pos_regions_rebel_faction_name_att_reg_bithynia_amaseapro_attila	Заколотники	true
start_pos_regions_rebel_faction_name_att_reg_makran_harmosiamain_attila	Заколотники	true
start_pos_regions_rebel_faction_name_bel_reg_gallaecia_astorgabel_attila	Заколотники	true
start_pos_regions_rebel_faction_name_cha_reg_east_aquitaine_arvernischa_attila	Заколотники	true
start_pos_regions_rebel_faction_name_att_reg_venetia_aquileiapro_attila	Заколотники	true
start_pos_regions_rebel_faction_name_att_reg_venetia_ravennamain_attila	Заколотники	true
start_pos_regions_long_description_att_reg_aegyptus_berenicemain_attila	placeholder	true
start_pos_regions_rebel_faction_name_att_reg_liguria_segusiomain_attila	Заколотники	true
start_pos_regions_long_description_att_reg_libya_paraetoniummain_attila	placeholder	true
start_pos_regions_rebel_faction_name_att_reg_persis_behdeshirpro_attila	Заколотники	true
start_pos_regions_rebel_faction_name_att_reg_mediterraneus_orientalis_gortynamain_attila	Заколотники	true
start_pos_regions_long_description_att_reg_aethiopia_adulismain_attila	placeholder	true
start_pos_regions_rebel_faction_name_att_reg_dacia_petrodavapro_attila	Заколотники	true
start_pos_regions_rebel_faction_name_bel_reg_burgundy_viennebel_attila	Заколотники	true
start_pos_regions_rebel_faction_name_att_reg_phazania_garamapro_attila	Заколотники	true
start_pos_regions_rebel_faction_name_att_reg_media_atropatene_rhagamain_attila	Заколотники	true
start_pos_regions_long_description_att_reg_thracia_trimontiumpro_attila	placeholder	true
start_pos_regions_rebel_faction_name_att_reg_mediterraneus_occidentalis_palmapro_attila	Заколотники	true
start_pos_regions_rebel_faction_name_att_reg_mediterraneus_occidentalis_caralispro_attila	Заколотники	true
start_pos_regions_rebel_faction_name_att_reg_gothiscandza_ascaucalispro_attila	Заколотники	true
start_pos_regions_rebel_faction_name_att_reg_bithynia_ancyrapro_attila	Заколотники	true
start_pos_regions_rebel_faction_name_cha_reg_saxony_osnabruckcha_attila	Заколотники	true
start_pos_regions_rebel_faction_name_bel_reg_provence_nikaiabel_attila	Заколотники	true
start_pos_regions_rebel_faction_name_cha_reg_wilzi_brandenburgcha_attila	Заколотники	true
start_pos_regions_rebel_faction_name_cha_reg_benevento_salernocha_attila	Заколотники	true
start_pos_regions_rebel_faction_name_bel_reg_cantabria_legiobel_attila	Заколотники	true
start_pos_regions_rebel_faction_name_att_reg_aethiopia_aksumpro_attila	Заколотники	true
start_pos_regions_rebel_faction_name_bel_reg_lucania_et_brutii_crotonabel_attila	Заколотники	true
start_pos_regions_rebel_faction_name_bel_reg_novempopulania_aquensiumbel_attila	Заколотники	true
start_pos_regions_rebel_faction_name_bel_reg_sicilia_panormusbel_attila	Заколотники	true
start_pos_regions_rebel_faction_name_cha_reg_sicilia_panormoscha_attila	Заколотники	true
start_pos_regions_rebel_faction_name_att_reg_baetica_cordubamain_attila	Заколотники	true
start_pos_regions_long_description_att_reg_hercynia_casurgismain_attila	placeholder	true
start_pos_regions_rebel_faction_name_cha_reg_ulster_grinan_of_ailechcha_attila	Заколотники	true
start_pos_regions_rebel_faction_name_cha_reg_friuli_aquileiacha_attila	Заколотники	true
start_pos_regions_rebel_faction_name_att_reg_hyperborea_moramarpro_attila	Заколотники	true
start_pos_regions_long_description_att_reg_hercynia_nitrahwamain_attila	placeholder	true
start_pos_regions_rebel_faction_name_bel_reg_septimania_nimesbel_attila	Заколотники	true
start_pos_regions_rebel_faction_name_bel_reg_dalmatia_naronabel_attila	Заколотники	true
start_pos_regions_rebel_faction_name_att_reg_raetia_et_noricum_augusta_vindelicorummain_attila	Заколотники	true
start_pos_regions_rebel_faction_name_att_reg_aquitania_elusapro_attila	Заколотники	true
start_pos_regions_rebel_faction_name_att_reg_aethiopia_aksummain_attila	Заколотники	true
start_pos_regions_long_description_att_reg_asorstan_ctesiphonpro_attila	placeholder	true
start_pos_regions_long_description_att_reg_belgica_colonia_agrippinamain_attila	placeholder	true
start_pos_regions_long_description_att_reg_lusitania_olisipomain_attila	placeholder	true
start_pos_regions_rebel_faction_name_cha_reg_frisia_boulognecha_attila	Заколотники	true
start_pos_regions_rebel_faction_name_att_reg_maxima_sequanorum_argentoratummain_attila	Заколотники	true
start_pos_regions_rebel_faction_name_att_reg_italia_neapolispro_attila	Заколотники	true
start_pos_regions_rebel_faction_name_bel_reg_septimania_elnebel_attila	Заколотники	true
start_pos_regions_long_description_att_reg_gothiscandza_rugionmain_attila	placeholder	true
start_pos_regions_rebel_faction_name_att_reg_tarraconensis_pompaelomain_attila	Заколотники	true
start_pos_regions_rebel_faction_name_att_reg_asorstan_meshanpro_attila	Заколотники	true
start_pos_regions_long_description_att_reg_media_atropatene_ecbatanamain_attila	placeholder	true
start_pos_regions_rebel_faction_name_att_reg_sarmatia_europaea_gelonuspro_attila	Заколотники	true
start_pos_regions_long_description_att_reg_sarmatia_asiatica_tanaismain_attila	placeholder	true
start_pos_regions_rebel_faction_name_att_reg_frisia_angulusmain_attila	Заколотники	true
