key	text	tooltip
#Loc;1;text/db/character_skills.loc		
character_skills_localised_name_att_skill_background_champion_elite_nomadic	Great Warrior	true
character_skills_localised_name_cha_skill_general_motivator	Motivator	true
character_skills_localised_description_att_skill_background_general_merchant_roman	This man cares little for nation, allegiance or creed. Only for coin.	true
character_skills_localised_name_att_trad_army_roman_4_nomad_hunters	Nomad Hunters	true
character_skills_localised_description_att_skill_background_spy_agriculture_nomadic	Some animals are more equal than others.	true
character_skills_localised_name_mk_skill_priest_belief_islam	Beliefs	true
character_skills_localised_description_att_trad_navy_roman_1_coastal_patrol	In home waters, these sailors remain unrivalled.	true
character_skills_localised_name_att_skill_background_champion_marine_eastern	Corsair	true
character_skills_localised_name_mk_skill_priest_belief_pagan	Beliefs	true
character_skills_localised_description_att_skill_background_priest_militarist_eastern	Well, I suppose peace is AN option, but so is bloody dancing!	true
character_skills_localised_description_cha_trad_army_cavalry_training	Only from the great aristocratic families are the best generals from.	true
character_skills_localised_name_att_skill_background_champion_scout_nomadic	Pathfinder	true
character_skills_localised_name_cha_skill_priest_back_elder	Elder	true
character_skills_localised_description_cha_trad_army_looters	Leave nothing behind but flesh for the carrion.	true
character_skills_localised_name_cha_skill_spy_local_agents	Local Agents	true
character_skills_localised_description_att_agent_skills_champion_skirmishing	A continuous barrage of missiles consistently wears an enemy down to dust.	true
character_skills_localised_description_att_skill_background_champion_standard_bearer_eastern	The banner of a victorious, resplendent nation is raised proudly in this man's hands.	true
character_skills_localised_name_att_skill_background_wife_roman_noble	Noble	true
character_skills_localised_description_bel_trad_army_roman_3_attacking_enemy	If you’re on their soil, the fight is almost done before a single blow is struck.	true
character_skills_localised_name_att_skill_background_champion_aide_camp_roman	Tribunus Militum	true
character_skills_localised_description_att_skill_background_priest_benefactor_eastern	When the cat is away, this man makes sure the mice stay entirely where they should.	true
character_skills_localised_description_att_trad_army_eastern_4_savaran_regime	With nobility at the fore, the sea of cavalry consumes all before it.	true
character_skills_localised_name_att_skill_background_general_handler_eastern	Handler	true
character_skills_localised_name_att_trad_army_roman_4_heavy_training	Heavy Training	true
character_skills_localised_description_att_trad_army_barbarian_4_bane_east	Glittering towers fall before the oathsworn sword.	true
character_skills_localised_description_cha_trad_navy_double_planking	What if, instead of one plank of wood, they had to get past… two!	true
character_skills_localised_description_att_skill_background_spy_agriculture_barbarian	Some animals are more equal than others.	true
character_skills_localised_name_att_trad_navy_barbarian_3_dauntless_navigators	Dauntless Navigators	true
character_skills_localised_description_att_trad_army_nomadic_5_scourge_world	Look upon them and know doom.	true
character_skills_localised_name_att_agent_skills_champion_marauding	Raiding	true
character_skills_localised_description_att_skill_background_general_scholar_eastern	Books are the mightiest weapon in the war against ignorance.	true
character_skills_localised_description_cha_skill_general_tactician	The tactician is the master of the gameboard, always thinking many moves ahead.	true
character_skills_localised_description_cha_skill_priest_spiritual_leadership	The blind will see! The deaf will hear!	true
character_skills_localised_name_att_skill_background_wife_civilised_educated	Educated	true
character_skills_localised_description_att_skill_background_priest_spiritual_leader_nomadic	Look to your own sins; the night is dark and full of terrors.	true
character_skills_localised_description_att_skill_background_general_merchant_eastern	This man cares little for nation, allegiance or creed. Only for coin.	true
character_skills_localised_description_att_skill_background_wife_roman_sharp_tongue	And why are we entertaining that fat pig, Flatulus Maximus, again? And no, I don't care if he hears!	true
character_skills_localised_description_cha_skill_general_back_supply	Food and weapons win wars as much as any soldier.	true
character_skills_localised_description_cha_skill_general_back_patron	This is a glorious building. Yes. Beautiful. I'll take ten.	true
character_skills_localised_name_att_trad_army_eastern_2_nomad_hunters	Nomad Hunters	true
character_skills_localised_description_att_trad_navy_roman_2_naval_logistics	Everything must be in order, and ready for the voyage.	true
character_skills_localised_description_att_agent_skills_champion_ruse	Look over there! A three-headed monkey!	true
character_skills_localised_name_mk_skill_general_back_scholar	Scholar	true
character_skills_localised_description_att_skill_background_champion_assassin_nomadic	I will be your champion.	true
character_skills_localised_name_att_agent_skills_spy_military_infiltration	Military Infiltration	true
character_skills_localised_name_att_skill_background_wife_roman_sharp_tongue	Sharp Tongue	true
character_skills_localised_description_att_skill_background_champion_scout_eastern	The road ahead is shrouded in darkness. I am the light.	true
character_skills_localised_name_cha_skill_general_back_entrepeneur	Entrepeneur	true
character_skills_localised_name_mk_skill_general_tactician	Tactician	true
character_skills_localised_name_att_skill_background_priest_spiritual_leader_nomadic	Spiritual Leader	true
character_skills_localised_name_att_skill_background_general_administrator_eastern	Administrator	true
character_skills_localised_name_att_skill_background_general_scholar_eastern	Scholar	true
character_skills_localised_description_att_skill_background_wife_civilised_educated	Men, my darling, do not look at a woman's mind first. And I have a sharp mind…	true
character_skills_localised_name_att_trad_navy_barbarian_5_scourge_seas	Scourge of the Seas	true
character_skills_localised_name_cha_skill_assassin_back_scout	Scout	true
character_skills_localised_name_att_skill_background_general_leader_barbarian	Leader	true
character_skills_localised_description_att_agent_skills_champion_provision	An army marches on its stomach.	true
character_skills_localised_description_att_trad_army_roman_4_heavy_training	A well trained, armoured soldier is a terror on the battlefield.	true
character_skills_localised_description_att_skill_background_wife_barbarian_uncanny	I walked the path for you, my love. The trees spoke of you…	true
character_skills_localised_description_att_skill_background_champion_elite_eastern	Trusted servant and fearful fighter, this man has earned respect.	true
character_skills_localised_description_att_skill_background_general_handler_eastern	Just and fair in all things, this man provides tutelage and advice to those who seek it.	true
character_skills_localised_name_att_trad_army_roman_2_barbarian_subjugators	Barbarian Subjugators	true
character_skills_localised_description_att_skill_background_champion_officer_nomadic	Leaders of men. Warriors. Covered in blood, battle and glory.	true
character_skills_localised_description_mk_skill_general_bureaucrat	Yes, war, an excellent choice. However, there IS some paperwork…	true
character_skills_localised_name_att_skill_background_champion_elite_barbarian	Man-at-Arms	true
character_skills_localised_description_att_skill_background_priest_accountant_nomadic	A man with a gift for numbers is valuable amongst a crowd of warmongers.	true
character_skills_localised_name_att_skill_background_wife_civilised_efficient	Efficient	true
character_skills_localised_name_att_trad_army_eastern_3_parthian_horsemanship	Parthian Horsemanship	true
character_skills_localised_description_att_general_skills_nomadic_1_lightning	For I beheld him when he fell from the heavens, LIKE LIGHTNING!	true
character_skills_localised_name_cha_skill_spy_eyes_and_ears	Eyes & Ears	true
character_skills_localised_name_att_skill_background_wife_civilised_goddess	Domestic Goddess	true
character_skills_localised_name_att_skill_background_general_melee_nomadic	Fighter	true
character_skills_localised_description_cha_skill_spy_sapping	A wall is just another obstacle for this man to undermine.	true
character_skills_localised_name_att_skill_background_general_rider_nomadic	Champion Rider	true
character_skills_localised_description_mk_skill_assassin_fear	I move for no man.	true
character_skills_localised_name_att_trad_army_eastern_4_barbarian_subjugators	Barbarian Subjugators	true
character_skills_localised_name_att_trad_navy_roman_3_military_escorts	Military Escorts	true
character_skills_localised_description_att_skill_background_champion_marine_eastern	Victory on land, victory on sea. Victory above all.	true
character_skills_localised_description_att_skill_background_general_attacker_roman	Renowned for dogmatic belligerence, this man will not stop until his enemies are trampled beneath him.	true
character_skills_localised_description_mk_skill_priest_belief_pagan	The Earth does not belong to us. We belong to the Earth.	true
character_skills_localised_description_att_skill_background_wife_civilised_wealthy	Some men marry for gold, and others envy them.	true
character_skills_localised_description_mk_skill_priest_belief_islam	Belief includes obligations. Whoever fulfills all of them has perfected his belief.	true
character_skills_localised_name_att_trad_navy_roman_1_coastal_patrol	Coastal Patrol	true
character_skills_localised_name_att_skill_background_spy_agriculture_nomadic	Herder	true
character_skills_localised_name_att_skill_background_spy_informant_nomadic	Double Agent	true
character_skills_localised_name_att_trad_army_barbarian_2_ruin_rome	Ruin of Rome	true
character_skills_localised_description_mk_trad_army_infantry_training	Even craftsmen can turn an army back from their city with proper training.	true
character_skills_localised_name_att_skill_background_wife_barbarian_priestess	Priestess	true
character_skills_localised_name_att_skill_background_general_taskmaster_roman	Taskmaster	true
character_skills_localised_name_att_trad_army_barbarian_5_inexorable_warband	Inexorable Warband	true
character_skills_localised_name_att_skill_background_champion_medic_eastern	Physician	true
character_skills_localised_description_att_skill_background_spy_mole_eastern	A man in the right places, hearing the right things, is more valuable than a thousand Zhayedan.	true
character_skills_localised_name_att_trad_navy_barbarian_2_ruin_rome	Ruin of Rome	true
character_skills_localised_name_att_skill_background_general_warrior_eastern	Fearless Warrior	true
character_skills_localised_name_att_skill_background_spy_racketeer_nomadic	Criminal	true
character_skills_localised_description_att_skill_background_general_warrior_barbarian	I move for no man.	true
character_skills_localised_name_att_skill_background_general_politician_roman	Political Animal	true
character_skills_localised_description_att_skill_background_spy_conspirator_nomadic	Chicanery, machinations and a fair deal of skulduggery.	true
character_skills_localised_name_att_trad_army_barbarian_1_guerrilla_warfare	Guerrilla Warfare	true
character_skills_localised_description_att_skill_background_general_entrepreneur_barbarian	The world finds important whatever this man deems to be important.	true
character_skills_localised_description_att_skill_background_general_defender_nomadic	A wall, upon which enemies crash in multitudes and are dashed and broken.	true
character_skills_localised_name_cha_trad_navy_placed_shots	True Aim	true
character_skills_localised_name_cha_trad_army_placed_shots	True Aim	true
character_skills_localised_description_att_skill_background_wife_all_faithful	My husband, my lord, my love. Always.	true
character_skills_localised_description_att_skill_background_wife_all_arrogant	And who are you, to speak to MY husband?	true
character_skills_localised_name_att_trad_army_eastern_3_border_defenders	Border Defenders	true
character_skills_localised_name_mk_skill_spy_smuggler	Smuggler	true
character_skills_localised_name_att_skill_background_wife_roman_conservative	Traditional	true
character_skills_localised_name_cha_skill_spy_surveillance	Surveillance	true
character_skills_localised_name_att_trad_navy_roman_4_barbarian_subjugators	Barbarian Subjugators	true
character_skills_localised_description_att_skill_background_wife_barbarian_midwife	Drink this. Now bite down hard on that.	true
character_skills_localised_description_cha_skill_assassin_determined	To strive, to seek, to find, and not to yield.	true
character_skills_localised_description_mk_skill_priest_back_militant	I'll fight anyone. I'll fight you. I'll fight your dog. I'll fight myself!	true
character_skills_localised_name_att_skill_background_champion_scout_barbarian	Pioneer	true
character_skills_localised_name_att_skill_background_wife_barbarian_swordmaid	Swordmaiden	true
character_skills_localised_name_att_skill_background_champion_quartermaster_barbarian	Supply Master	true
character_skills_localised_name_att_skill_background_wife_civilised_political	Political	true
character_skills_localised_description_mk_trad_army_ferocious	Howling, slobbering, gnashing; these men are fury personified.	true
character_skills_localised_description_mk_skill_priest_belief	Be on your guard; stand firm in the faith; be men of courage; be strong.	true
character_skills_localised_description_att_skill_background_champion_quartermaster_eastern	The matter of procurement, and suitable equipment, is this man's expertise.	true
character_skills_localised_description_mk_trad_navy_boarders	These men descend upon enemy vessels, swarming and annihilating.	true
character_skills_localised_name_att_general_skills_nomadic_2_hunter	Hunter	true
character_skills_localised_description_att_skill_background_priest_scholar_barbarian	Stay a while and listen.	true
character_skills_localised_name_att_skill_background_general_marksman_roman	Marksman	true
character_skills_localised_description_att_skill_background_wife_civilised_superior	Do we have to entertain those awful, little people again? I hate counting the napkins afterwards...	true
character_skills_localised_name_att_trad_army_roman_2_light_training	Light Training	true
character_skills_localised_description_att_trad_army_barbarian_2_domestic_devotion	A dedication to their family, and their gods.	true
character_skills_localised_description_att_general_skills_nomadic_4_warmaster	War is his being. He is bidden to fight and seek conflict; he is good at it.	true
character_skills_localised_description_att_general_skills_eastern_3_marzban	The walls are secure with this man at the parapets. 	true
character_skills_localised_description_att_trad_army_nomadic_1_raider_band	Pillage to survive… and, also, for fun.	true
character_skills_localised_description_att_trad_army_roman_2_light_training	You will learn to fight, and to move, and to never be caught.	true
character_skills_localised_name_att_skill_background_wife_civilised_superior	Superior	true
character_skills_localised_description_att_skill_background_general_marksman_eastern	Through fire, and wind, and death, his shot flies true to its target every time.	true
character_skills_localised_description_mk_trad_navy_steady	Hold firm, lads, and we'll live to see this day end!	true
character_skills_localised_name_att_general_skills_eastern_3_marzban	Border Guardian	true
character_skills_localised_name_att_skill_background_champion_medic_barbarian	Healer	true
character_skills_localised_description_att_skill_background_champion_war_hero_eastern	This man lives for war. His time is done, his battles won, yet he remains.	true
character_skills_localised_description_att_skill_background_wife_civilised_unsuitable	Some men marry for love, and others call them fools.	true
character_skills_localised_description_att_skill_background_champion_watchman_nomadic	He waits. That's what he does. 	true
character_skills_localised_name_att_skill_background_priest_elder_barbarian	Elder	true
character_skills_localised_description_mk_trad_army_supplies	Without supplies there can be no question of war.	true
character_skills_localised_description_att_skill_background_champion_medic_nomadic	Physician, heal thyself.	true
character_skills_localised_description_att_skill_background_wife_all_fertile	Children are the blessings of heaven!	true
character_skills_localised_description_att_skill_background_priest_advisor_barbarian	What the king dreams, the hand will build.	true
character_skills_localised_description_att_trad_navy_barbarian_4_bane_east	Easterners have too much sand in their brains to challenge us at sea.	true
character_skills_localised_description_mk_trad_navy_stores	A bow without an arrow is just a very expensive paperweight.	true
character_skills_localised_description_att_skill_background_wife_roman_conservative	What finer thing is there than a lady at the side of her manly husband?	true
character_skills_localised_name_att_agent_skills_priest_dogma	Dogma	true
character_skills_localised_description_att_skill_background_spy_conspirator_barbarian	Chicanery, machinations and a fair deal of skulduggery.	true
character_skills_localised_name_mk_skill_assassin_opportunism	Opportunism	true
character_skills_localised_description_att_skill_background_spy_mole_roman	A man in the right places, hearing the right things, is more valuable than a thousand armies.	true
character_skills_localised_description_mk_skill_priest_dogma	I will succeed because I believe.	true
character_skills_localised_name_att_skill_background_champion_quartermaster_nomadic	Supply Master	true
character_skills_localised_name_cha_skill_general_commander	Commander	true
character_skills_localised_name_cha_skill_spy_misdirection	Misdirection	true
character_skills_localised_description_att_skill_background_champion_horse_vet_roman	"Open wide and say neigh!"""""	true
character_skills_localised_description_att_skill_background_general_attacker_eastern	Renowned for dogmatic belligerence, this man will not stop until his enemies are trampled beneath him.	true
character_skills_localised_name_att_skill_background_spy_conspirator_nomadic	Conspirator	true
character_skills_localised_name_att_skill_background_spy_spymaster_nomadic	Spymaster	true
character_skills_localised_description_att_trad_army_eastern_3_border_defenders	Someone has to look after the borders whilst you're out conquering.	true
character_skills_localised_description_att_skill_background_champion_engineer_eastern	To the warmaker, artillery is a weapon of war. To this man, it is a work of art.	true
character_skills_localised_description_att_skill_background_general_warrior_eastern	I move for no man.	true
character_skills_localised_description_cha_trad_navy_scourge_pirates	Black sails know better than to trade blows with these sailors.	true
character_skills_localised_description_att_skill_background_general_defender_roman	A wall, upon which enemies crash in multitudes and are dashed and broken.	true
character_skills_localised_description_att_general_skills_roman_2_infantry_commander	The men will walk far, fighting many foes, so long as this man commands them.	true
character_skills_localised_description_att_trad_army_barbarian_5_inexorable_warband	Crush your enemies and see them driven before you!	true
character_skills_localised_description_mk_skill_priest_provocation	Swords will not avail you. I am guarded by a heavenly host.	true
character_skills_localised_description_att_skill_background_spy_courier_roman	Fleet of foot and swift of tongue.	true
character_skills_localised_description_att_agent_skills_champion_intimidation	They have ways of making you talk. Oh yes…	true
character_skills_localised_name_mk_skill_general_back_warrior	Warrior	true
character_skills_localised_description_att_skill_background_champion_elite_nomadic	Trusted servant and fearless fighter, this man has earned respect.	true
character_skills_localised_description_att_skill_background_general_handler_nomadic	Just and fair in all things, this man provides tutelage and advice to those who seek it.	true
character_skills_localised_description_cha_skill_general_motivator	I believe in you. Don't believe in you, believe in ME who believes in you!	true
character_skills_localised_description_att_skill_background_champion_officer_eastern	Leaders of men. Warriors. Covered in blood, battle and glory.	true
character_skills_localised_description_att_trad_army_roman_4_nomad_hunters	Killing a horde of riders at the same time is more efficient.	true
character_skills_localised_name_att_skill_background_general_merchant_roman	Merchant	true
character_skills_localised_name_att_skill_background_champion_marine_roman	Liburnarius	true
character_skills_localised_description_att_agent_skills_spy_coercion	What good is a missive if you are unable to speak?	true
character_skills_localised_name_cha_trad_navy_stores	Stores	true
character_skills_localised_description_att_skill_background_priest_public_speaker_barbarian	Friends, brothers, countrymen! Lend me your ears!	true
character_skills_localised_description_att_general_skills_roman_3_logistician	The most complex strategies lay in pieces before him, to be assembled as if a puzzle.	true
character_skills_localised_description_att_skill_background_priest_accountant_eastern	A man with a gift for numbers is valuable amongst a crowd of warmongers.	true
character_skills_localised_description_cha_skill_priest_back_elder	Honeyed words and wisdom make sweetness of intelligence.	true
character_skills_localised_description_att_skill_background_champion_scout_nomadic	The road ahead is shrouded in darkness. I am the light.	true
character_skills_localised_name_att_skill_background_priest_spiritual_leader_eastern	Dastwar	true
character_skills_localised_name_att_general_skills_barbarian_celts_rigfennid	Rigfennid 	true
character_skills_localised_name_mk_skill_spy_eyes_and_ears	Eyes & Ears	true
character_skills_localised_name_cha_trad_navy_steady	Steady	true
character_skills_localised_name_att_agent_skills_champion_subversion	Subversion	true
character_skills_localised_name_att_skill_background_general_administrator_nomadic	Dignitary	true
character_skills_localised_name_att_skill_background_general_scholar_nomadic	Sage	true
character_skills_localised_description_att_skill_background_priest_strategy_gaming_barbarian	A good player is not one who is five moves ahead, but who has won from the first.	true
character_skills_localised_description_att_trad_navy_eastern_1_persian_naval_heritage	The naval traditions of the eastern nations are an enduring legacy.	true
character_skills_localised_description_att_skill_background_spy_builder_roman	One brick follows another. The greatest buildings start with the smallest objects.	true
character_skills_localised_name_att_skill_background_general_patron_barbarian	Patron	true
character_skills_localised_description_att_trad_army_nomadic_3_unconventional_warfare	Fighting is not about style, it is about victory.	true
character_skills_localised_description_att_skill_background_champion_marine_nomadic	Victory on land, victory on sea. Victory above all.	true
character_skills_localised_description_att_skill_background_priest_progressive_roman	Stay on the cliff too long and you'll be washed away.	true
character_skills_localised_name_att_skill_background_spy_informant_eastern	Double Agent	true
character_skills_localised_name_cha_skill_priest_provocation	Provocation	true
character_skills_localised_description_att_general_skills_barbarian_celts_plunderer	Burned, battered, or broken, it still has value.	true
character_skills_localised_name_att_skill_background_spy_agriculture_eastern	Vastryosh	true
character_skills_localised_name_att_trad_army_barbarian_4_bane_east	Bane of the East	true
character_skills_localised_description_att_skill_background_wife_all_drunkard	It makes me happier than you ever could, you bastard!	true
character_skills_localised_name_att_general_skills_roman_3_fleet_commander	Fleet Commander	true
character_skills_localised_name_att_skill_background_general_strategist_roman	Master Planner	true
character_skills_localised_name_att_skill_background_spy_hunter_roman	Venator	true
character_skills_localised_description_cha_skill_priest_back_militant	I'll fight anyone. I'll fight you. I'll fight your dog. I'll fight myself!	true
character_skills_localised_name_att_skill_background_priest_spiritual_leader_roman	Pontifex	true
character_skills_localised_description_att_agent_skills_champion_marauding	Raiding leaves nothing for the victim, and everything for the opportunist.	true
character_skills_localised_name_att_agent_skills_priest_spiritual_leadership	Spiritual Leadership	true
character_skills_localised_name_cha_skill_spy_back_rumours	Rumours	true
character_skills_localised_name_cha_skill_general_tactician	Tactician	true
character_skills_localised_name_att_agent_skills_spy_civilian_infiltration	Civilian Infiltration	true
character_skills_localised_name_att_skill_background_general_melee_eastern	Fighter	true
character_skills_localised_name_att_skill_background_general_rider_eastern	Champion Rider	true
character_skills_localised_name_cha_skill_back_dice_roller	Dice Roller	true
character_skills_localised_description_cha_trad_navy_boarders	These men descend upon enemy vessels, swarming and annihilating.	true
character_skills_localised_name_att_trad_army_nomadic_3_barbarian_subjugators	Barbarian Subjugators	true
character_skills_localised_name_mk_skill_assassin_back_master	Master	true
character_skills_localised_description_att_trad_navy_roman_5_defenders_mediterranean	To hold the Mediterranean is to be strong. These men hold the Mediterranean.	true
character_skills_localised_name_att_general_skills_eastern_2_spahbod	Commander-in-Chief	true
character_skills_localised_description_att_general_skills_nomadic_2_thunder	He falls upon the enemy as the great drumbeat of the skies falls on the clouds.	true
character_skills_localised_name_mk_skill_spy_back_conspirator	Conspirator	true
character_skills_localised_name_att_trad_navy_barbarian_2_seafaring_traditions	Seafaring Traditions	true
character_skills_localised_description_cha_trad_navy_raiders	Success on the seas is not always about victory in battle.	true
character_skills_localised_description_att_skill_background_champion_standard_bearer_nomadic	The flag of a victorious, resplendent nation is raised proudly in this man's hands.	true
character_skills_localised_name_att_skill_background_champion_scout_eastern	Scout	true
character_skills_localised_description_att_trad_navy_eastern_5_defence_fleet	There is no port or harbour that cannot be protected.	true
character_skills_localised_description_att_agent_skills_priest_spiritual_leadership	The blind will see! The deaf will hear!	true
character_skills_localised_description_att_skill_background_spy_artisan_roman	My hands are my tools; with them I create great and beautiful things.	true
character_skills_localised_description_att_skill_background_priest_benefactor_nomadic	When the cat is away, this man makes sure the mice stay entirely where they should.	true
character_skills_localised_name_att_general_skills_nomadic_2_thunder	Thunder	true
character_skills_localised_description_att_general_skills_eastern_2_spahbod	A leader of men, a defeater of enemies. The right man for the job.	true
character_skills_localised_description_att_skill_background_wife_barbarian_shieldmaid	Well, I was a maiden. Until I met him.	true
character_skills_localised_description_att_general_skills_nomadic_3_wind	Wind fulfills; a subtle, cunning draft or tempestuous mistral. 	true
character_skills_localised_description_cha_skill_priest_provocation	Swords will not avail you. I am guarded by a heavenly host.	true
character_skills_localised_name_att_agent_skills_champion_provision	Provision	true
character_skills_localised_description_att_skill_background_spy_agriculture_eastern	Some animals are more equal than others.	true
character_skills_localised_name_att_general_skills_barbarian_celts_plunderer	Plunderer 	true
character_skills_localised_name_att_skill_background_champion_elite_eastern	Aswaran	true
character_skills_localised_name_att_skill_background_wife_barbarian_uncanny	Uncanny	true
character_skills_localised_description_att_trad_army_roman_2_barbarian_subjugators	Nobody will miss a mud hut or ten.	true
character_skills_localised_description_cha_skill_general_back_leader	Courage is not the absence of fear, but triumph over it.	true
character_skills_localised_name_att_skill_background_champion_marine_nomadic	Marine	true
character_skills_localised_description_att_agent_skills_spy_tracking	A broken twig is all that's needed to track an enemy. Giant footprints help, too.	true
character_skills_localised_name_mk_skill_general_bureaucrat	Bureaucrat	true
character_skills_localised_description_att_skill_background_priest_militarist_nomadic	Well, I suppose peace is AN option, but so is bloody dancing!	true
character_skills_localised_description_cha_trad_army_supplies	Without supplies there can be no question of war.	true
character_skills_localised_description_att_skill_background_general_scholar_barbarian	Books are the mightiest weapon in the war against ignorance.	true
character_skills_localised_name_att_skill_background_general_supply_barbarian	Logistics Expert	true
character_skills_localised_description_att_skill_background_wife_civilised_unfaithful	Yes, I flirted with him! And more. Of course I did. I thought it might help your prospects.	true
character_skills_localised_name_att_trad_navy_roman_1_mediterranean_seamanship	Mediterranean Seamanship	true
character_skills_localised_description_att_skill_background_general_scholar_nomadic	Books are the mightiest weapon in the war against ignorance.	true
character_skills_localised_name_mk_skill_priest_back_elder	Elder	true
character_skills_localised_description_cha_trad_navy_steady	Hold firm, lads, and we'll live to see this day end!	true
character_skills_localised_description_cha_skill_spy_eyes_and_ears	This man sees all, and hears all. He misses nothing.	true
character_skills_localised_description_att_skill_background_wife_civilised_goddess	Ooohh! Yes! Cream…	true
character_skills_localised_description_att_agent_skills_champion_subversion	The way to a man's heart is through his mind.	true
character_skills_localised_description_att_skill_background_general_merchant_nomadic	This man cares little for nation, allegiance or creed. Only for coin.	true
character_skills_localised_description_att_general_skills_barbarian_celts_rigfennid	Some men are born leaders, not just of warriors, but of people.	true
character_skills_localised_description_att_skill_background_priest_spiritual_leader_eastern	Look to your own sins; the night is dark and full of terrors.	true
character_skills_localised_description_att_agent_skills_spy_violence	Murder can be fun.	true
character_skills_localised_name_att_general_skills_barbarian_2_hunter	Hunter	true
character_skills_localised_description_cha_skill_priest_dogma	I will succeed because I believe.	true
character_skills_localised_description_mk_skill_back_watchman	He waits and watches. Every move is carefully considered.	true
character_skills_localised_description_att_skill_background_champion_assassin_eastern	I will be your champion.	true
character_skills_localised_name_mk_skill_spy_tracking	Tracking	true
character_skills_localised_description_att_general_skills_nomadic_3_despoiler	No inch of land, nor acre of property, is safe from his irascible greed.	true
character_skills_localised_name_mk_skill_general_sweet_talker	Sweet Talker	true
character_skills_localised_name_mk_skill_general_motivator	Motivator	true
character_skills_localised_description_cha_skill_priest_back_advisor	What the king dreams, the hand will build.	true
character_skills_localised_name_att_skill_background_priest_public_speaker_barbarian	Public Speaker	true
character_skills_localised_name_att_skill_background_general_attacker_roman	Relentless Attacker	true
character_skills_localised_name_att_skill_background_wife_civilised_wealthy	Wealthy	true
character_skills_localised_description_cha_trad_navy_stores	A bow without an arrow is just a very expensive paperweight.	true
character_skills_localised_name_att_skill_background_general_handler_nomadic	Mentor	true
character_skills_localised_description_att_trad_army_barbarian_2_ruin_rome	Their gaudy standards become no more than tattered cloth before us.	true
character_skills_localised_name_att_skill_background_wife_roman_former_vestal	Ex-Vestal	true
character_skills_localised_description_att_trad_army_nomadic_4_terror	Fear precedes these men, for death follows in their wake.	true
character_skills_localised_name_att_trad_navy_barbarian_1_master_shipwrights	Master Shipwrights	true
character_skills_localised_name_att_trad_army_barbarian_4_berserkers	Berserkers	true
character_skills_localised_description_att_skill_background_champion_medic_eastern	Physician, heal thyself.	true
character_skills_localised_name_cha_skill_general_bureaucrat	Bureaucrat	true
character_skills_localised_description_att_trad_navy_barbarian_2_ruin_rome	Their homes burned, their cities razed; Rome has everything to fear from these men.	true
character_skills_localised_description_mk_trad_army_cavalry_training	Only from the great aristocratic families are the best generals from.	true
character_skills_localised_description_att_trad_army_nomadic_3_defenders_camp	Make sure that, when the fighting is done, there is something to return to.	true
character_skills_localised_name_att_trad_navy_eastern_1_naval_support	Naval Support	true
character_skills_localised_name_cha_skill_priest_belief_islam	Beliefs	true
character_skills_localised_name_cha_skill_priest_belief_pagan	Beliefs	true
character_skills_localised_description_att_trad_army_barbarian_1_guerrilla_warfare	Columns and formations are not the only ways of war.	true
character_skills_localised_name_att_skill_background_general_entrepreneur_barbarian	Overseer	true
character_skills_localised_name_mk_skill_general_commander	Commander	true
character_skills_localised_name_att_agent_skills_spy_bribery	Bribery	true
character_skills_localised_description_att_general_skills_barbarian_2_raven	Dark wings hold dark thoughts and speak dark words.	true
character_skills_localised_description_att_skill_background_general_marksman_nomadic	Through fire, and wind, and death, his shot flies true to its target every time.	true
character_skills_localised_description_att_skill_background_wife_all_poisoner	The next banquet, dear: would you put one of my special sauces on the menu?	true
character_skills_localised_description_att_skill_background_champion_war_hero_nomadic	This man lives for war. His time is done, his battles won, yet he remains.	true
character_skills_localised_name_att_general_skills_barbarian_5_legend	Legend	true
character_skills_localised_name_mk_skill_assassin_back_legend	Legend	true
character_skills_localised_name_att_trad_army_roman_5_defenders_virtue	Defenders of Virtue	true
character_skills_localised_description_att_skill_background_champion_watchman_eastern	He waits. That's what he does. 	true
character_skills_localised_name_mk_skill_spy_arsonist	Arsonist	true
character_skills_localised_name_att_skill_background_wife_barbarian_midwife	Tribal Midwife	true
character_skills_localised_description_att_trad_navy_roman_4_barbarian_subjugators	A rabble of mudmen on rafts cannot stand against the Roman fleet!	true
character_skills_localised_description_att_skill_background_general_warrior_nomadic	I move for no man.	true
character_skills_localised_description_mk_trad_army_marksman_training	You know how to fight six men. We can teach you how to engage six hundred.	true
character_skills_localised_name_att_trad_army_eastern_1_occupation_force	Occupation Force	true
character_skills_localised_description_att_general_skills_nomadic_5_scourge	Blackened lands and misery follow in this man's wake.	true
character_skills_localised_description_att_general_skills_nomadic_2_hunter	From sea to sky, across the endless plains, this man will find his prey.	true
character_skills_localised_name_att_skill_background_champion_quartermaster_eastern	Quartermaster	true
character_skills_localised_description_cha_trad_army_hunters	Keep quiet. Draw the bow. Breathe. Shoot.	true
character_skills_localised_description_att_skill_background_general_marksman_roman	Through fire, and wind, and death, his shot flies true to its target every time.	true
character_skills_localised_description_att_skill_background_general_attacker_nomadic	Renowned for dogmatic belligerence, this man will not stop until his enemies are trampled beneath him.	true
character_skills_localised_name_att_skill_background_spy_spymaster_eastern	Eyes & Ears	true
character_skills_localised_name_att_skill_background_spy_conspirator_eastern	Conspirator	true
character_skills_localised_description_mk_skill_assassin_back_scout	The road ahead is shrouded in darkness. I am the light.	true
character_skills_localised_description_att_general_skills_barbarian_3_judge	The arbiter of judiciary dispensation, provided with absolute authority.	true
character_skills_localised_name_att_trad_army_barbarian_2_domestic_devotion	Domestic Devotion	true
character_skills_localised_name_mk_skill_spy_practice	Practice	true
character_skills_localised_description_att_skill_background_champion_engineer_nomadic	To the warmaker, artillery is a weapon of war. To this man, it is a work of art.	true
character_skills_localised_name_att_trad_army_nomadic_1_raider_band	Raider Band	true
character_skills_localised_name_att_trad_army_roman_5_palatini	Palatini	true
character_skills_localised_name_mk_skill_assassin_back_scout	Scout	true
character_skills_localised_name_att_general_skills_barbarian_3_judge	Judge	true
character_skills_localised_description_att_skill_background_spy_conspirator_eastern	Chicanery, machinations and a fair deal of skulduggery.	true
character_skills_localised_description_att_skill_background_general_defender_eastern	A wall, upon which enemies crash in multitudes and are dashed and broken.	true
character_skills_localised_name_mk_trad_navy_steady	Steady	true
character_skills_localised_description_att_trad_navy_eastern_3_pirate_hunters	These men are determined to wipe out the blight of the seas.	true
character_skills_localised_name_mk_skill_spy_sabotage	Sabotage	true
character_skills_localised_description_att_trad_army_nomadic_4_steppe_warfare	Your definition of war does not apply on the steppes. There are different rules.	true
character_skills_localised_description_att_skill_background_priest_elder_barbarian	Honeyed words and wisdom make sweetness of intelligence.	true
character_skills_localised_name_att_skill_background_champion_medic_nomadic	Healer	true
character_skills_localised_name_att_skill_background_spy_racketeer_eastern	Racketeer	true
character_skills_localised_name_att_skill_background_general_warrior_nomadic	Fearless Warrior	true
character_skills_localised_name_att_trad_navy_barbarian_4_bane_east	Bane of the East	true
character_skills_localised_description_att_skill_background_spy_mole_nomadic	A man in the right places, hearing the right things, is more valuable than a thousand lancers.	true
character_skills_localised_name_mk_trad_navy_stores	Stores	true
character_skills_localised_description_att_trad_army_eastern_1_occupation_force	This place is ours, and they will learn that - one way or another.	true
character_skills_localised_name_att_trad_navy_eastern_2_barbarian_subjugators	Barbarian Subjugators	true
character_skills_localised_name_att_general_skills_nomadic_5_scourge	Scourge	true
character_skills_localised_name_bel_trad_army_roman_4_sieging	Besiegers	true
character_skills_localised_name_att_skill_background_spy_mole_roman	Speculator	true
character_skills_localised_name_cha_skill_spy_black_market	Black Market	true
character_skills_localised_description_att_agent_skills_spy_bribery	Perhaps my good friend Flavius could change your mind…?	true
character_skills_localised_description_cha_skill_general_commander	Follow, men, and I will lead you to everlasting glory!	true
character_skills_localised_description_att_skill_background_champion_quartermaster_nomadic	The matter of procurement, and suitable equipment, is this man's expertise.	true
character_skills_localised_name_att_general_skills_barbarian_2_raven	Raven	true
character_skills_localised_name_att_trad_army_roman_3_medium_training	Medium Training	true
character_skills_localised_description_att_skill_background_general_handler_barbarian	Just and fair in all things, this man provides tutelage and advice to those who seek it.	true
character_skills_localised_description_mk_skill_assassin_misdirection	A dropped coin, a broken vase. All that is needed is eyes to look elsewhere.	true
character_skills_localised_description_att_trad_army_roman_3_foederati_corps	The state has protected these outliers. Now it expects their services.	true
character_skills_localised_description_att_trad_army_barbarian_3_epic_camp_following	An entourage, although cumbersome, brings a touch of the familiar.	true
character_skills_localised_name_att_general_skills_roman_4_strategist	Strategist	true
character_skills_localised_description_att_skill_background_wife_all_cunning	I see more than you, dear, because no one notices a woman watching…	true
character_skills_localised_name_att_skill_background_general_defender_roman	Steadfast Defender	true
character_skills_localised_description_cha_skill_general_bureaucrat	Yes, war, an excellent choice. However, there IS some paperwork…	true
character_skills_localised_description_att_general_skills_roman_2_dux	A man above men. Born to command. A leader.	true
character_skills_localised_name_mk_skill_priest_provocation	Provocation	true
character_skills_localised_description_att_trad_army_barbarian_4_berserkers	There is no reason, and there is no mercy. There is only death.	true
character_skills_localised_description_att_trad_navy_barbarian_1_master_shipwrights	Some ships bob on the waters, other float. The best ships glide.	true
character_skills_localised_description_att_skill_background_wife_civilised_protective	I've hired six new bodyguards, dear. All strapping fellows.	true
character_skills_localised_description_att_skill_background_priest_advisor_nomadic	What the king dreams, the hand will build.	true
character_skills_localised_name_cha_skill_back_cat_reflexes	Feline Reflexes	true
character_skills_localised_description_att_trad_army_roman_3_comitatenses	Fight! Win! Prevail!	true
character_skills_localised_name_mk_skill_assassin_back_aide	Aide	true
character_skills_localised_description_att_trad_army_roman_4_military_engineering	Weapons of war can be fine-tuned for even greater devastation.	true
character_skills_localised_description_att_skill_background_general_supply_barbarian	Feeding one man a day is feat enough. Feeding an entire army is prodigious.	true
character_skills_localised_name_att_skill_background_general_rider_barbarian	Champion Rider	true
character_skills_localised_name_att_agent_skills_priest_imposition	Imposition	true
character_skills_localised_description_mk_skill_assassin_determined	To strive, to seek, to find, and not to yield.	true
character_skills_localised_description_cha_skill_assassin_opportunism	When the cat's away, the mice will probably kill someone.	true
character_skills_localised_name_cha_skill_general_back_leader	Leader	true
character_skills_localised_description_att_general_skills_barbarian_4_warchief	His men have bowed to his strength and resolve - he has earned his title.	true
character_skills_localised_description_att_general_skills_eastern_3_cavalry_commander	Charge! Hold formation, punch a hole through their line!	true
character_skills_localised_name_att_agent_skills_spy_tracking	Tracking	true
character_skills_localised_description_att_skill_background_general_leader_eastern	Courage is not the absence of fear, but triumph over it.	true
character_skills_localised_name_cha_trad_army_steady_troops	Steady	true
character_skills_localised_description_att_skill_background_champion_drillmaster_barbarian	You will listen, and you will learn, or you will die.	true
character_skills_localised_description_cha_skill_assassin_practice	It takes 10,000 hours to master something, they say. You better get started.	true
character_skills_localised_name_att_general_skills_nomadic_3_wind	Wind	true
character_skills_localised_name_cha_trad_navy_raiders	Raiders	true
character_skills_localised_name_att_skill_background_champion_standard_bearer_nomadic	Flag-bearer	true
character_skills_localised_description_att_skill_background_general_landowner_nomadic	Ah, it's good to herd.	true
character_skills_localised_name_att_trad_navy_eastern_5_defence_fleet	Defence Fleet	true
character_skills_localised_description_att_skill_background_wife_roman_former_vestal	Any flames I have burn for my husband!	true
character_skills_localised_description_att_skill_background_general_supply_nomadic	Feeding one man a day is feat enough. Feeding an entire army is prodigious.	true
character_skills_localised_description_att_skill_background_champion_engineer_roman	To the warmaker, artillery is a weapon of war. To this man, it is a work of art.	true
character_skills_localised_description_att_skill_background_general_administrator_barbarian	This man's seal is respected throughout the world.	true
character_skills_localised_name_cha_skill_general_back_rider	Rider	true
character_skills_localised_name_mk_skill_spy_back_racketeer	Racketeer	true
character_skills_localised_name_cha_skill_general_back_melee	Melee	true
character_skills_localised_name_att_trad_army_nomadic_5_royal_host	Royal Host	true
character_skills_localised_name_mk_trad_navy_scourge_pirates	Pirate Scourge	true
character_skills_localised_name_cha_skill_priest_back_advisor	Advisor	true
character_skills_localised_description_att_trad_army_eastern_5_army_immortals	The best of the best; each one fights with the strength of ten men.	true
character_skills_localised_description_cha_skill_general_back_warrior	This man was born to fight. Nothing more; war brings honour enough.	true
character_skills_localised_description_att_general_skills_barbarian_2_hunter	From sea to sky, through vale and murk, this man will find his mark.	true
character_skills_localised_name_att_skill_background_priest_strategy_gaming_nomadic	Strategic Thinker	true
character_skills_localised_name_cha_skill_assassin_eyes_ears	Eyes & Ears	true
character_skills_localised_description_mk_skill_spy_tracking	Through the wilderness, over hill and vale, through dark and light, he will follow.	true
character_skills_localised_description_att_skill_background_priest_benefactor_roman	When the cat is away, this man makes sure the mice stay entirely where they should.	true
character_skills_localised_description_mk_skill_general_sweet_talker	Honeyed words can be as deadly as the finest blade.	true
character_skills_localised_name_att_skill_background_spy_agriculture_roman	Agricola	true
character_skills_localised_name_att_skill_background_general_merchant_nomadic	Merchant	true
character_skills_localised_name_att_agent_skills_spy_violence	Murder	true
character_skills_localised_name_att_trad_army_nomadic_2_foreign_contingent	Foreign Contingent	true
character_skills_localised_name_att_skill_background_general_leader_nomadic	Leader	true
character_skills_localised_name_att_skill_background_priest_benefactor_roman	Curator	true
character_skills_localised_name_att_skill_background_wife_civilised_social_climber	Social Climber	true
character_skills_localised_description_att_skill_background_general_patron_barbarian	This is a glorious building. Yes. Beautiful. I'll take ten.	true
character_skills_localised_description_cha_skill_assassin_eyes_ears	This man sees all, and hears all. He misses nothing.	true
character_skills_localised_name_att_skill_background_wife_all_harridan_nag	Harridan	true
character_skills_localised_name_mk_skill_assassin_bodyguard	Bodyguard	true
character_skills_localised_name_att_trad_navy_eastern_4_naval_marksmanship	Naval Marksmanship	true
character_skills_localised_name_mk_skill_spy_back_spymaster	Spymaster	true
character_skills_localised_description_cha_skill_spy_smuggler	Never tell me the odds!	true
character_skills_localised_name_att_skill_background_priest_strategy_gaming_barbarian	Tafl Player	true
character_skills_localised_description_cha_skill_general_back_rider	This man is at his best and his happiest when at a gallop.	true
character_skills_localised_description_mk_trad_navy_scourge_pirates	Black sails know better than to trade blows with these sailors.	true
character_skills_localised_name_att_agent_skills_priest_instigation	Instigation	true
character_skills_localised_description_cha_skill_general_back_melee	Arrows and javelins are for the mealy. REAL men get so close they can smell the sweat!	true
character_skills_localised_name_cha_trad_army_dread	Dread	true
character_skills_localised_name_cha_trad_army_loyal	Loyal	true
character_skills_localised_name_att_skill_background_priest_advisor_eastern	Advisor	true
character_skills_localised_name_att_skill_background_champion_officer_roman	Centurion	true
character_skills_localised_name_att_skill_background_general_administrator_barbarian	Dignitary	true
character_skills_localised_name_att_skill_background_wife_all_great_beauty	Beautiful	true
character_skills_localised_name_att_skill_background_champion_martial_arts_eastern	Pahlavani Master	true
character_skills_localised_name_att_skill_background_priest_public_speaker_eastern	Public Speaker	true
character_skills_localised_name_att_skill_background_champion_engineer_roman	Architectus	true
character_skills_localised_name_att_skill_background_champion_officer_eastern	Gondsalar	true
character_skills_localised_description_mk_skill_general_back_merchant	This man cares little for nation, allegiance or creed. Only for coin.	true
character_skills_localised_name_att_agent_skills_spy_coercion	Coercion	true
character_skills_localised_description_att_skill_background_priest_strategy_gaming_eastern	A good player is not one who is five moves ahead, but one who wins from the first.	true
character_skills_localised_description_att_trad_army_nomadic_3_barbarian_subjugators	May the odds be ever in your favour.	true
character_skills_localised_description_mk_skill_assassin_back_master	This one has spent a lifetime perfecting, and then employing, his skills. 	true
character_skills_localised_name_att_trad_navy_roman_5_defenders_mediterranean	Defenders of the Mediterranean	true
character_skills_localised_description_mk_skill_spy_back_conspirator	Chicanery, machinations and a fair deal of skulduggery.	true
character_skills_localised_name_mk_skill_assassin_practice	Practice	true
character_skills_localised_description_mk_skill_assassin_provision	Some things will never change; an army always marches on its stomach.	true
character_skills_localised_description_att_agent_skills_spy_diversion	Look at me, I'm a distraction!	true
character_skills_localised_name_mk_skill_assassin_determined	Determined	true
character_skills_localised_name_att_skill_background_general_supply_eastern	Logistics Expert	true
character_skills_localised_description_att_skill_background_general_rider_barbarian	There are men who ride, and there are riders.	true
character_skills_localised_name_att_skill_background_general_patron_eastern	Patron	true
character_skills_localised_description_att_skill_background_general_strategist_roman	Every possibility accounted for, every breath explained.	true
character_skills_localised_name_att_skill_background_champion_standard_bearer_roman	Signifer	true
character_skills_localised_description_att_skill_background_spy_hunter_roman	They hunt so that they do not become the hunted themselves…	true
character_skills_localised_description_att_skill_background_priest_scribe_barbarian_barbarian	The written word, though unintelligible to most, is the history of the world laid down.	true
character_skills_localised_name_att_skill_background_priest_progressive_roman	Progressive	true
character_skills_localised_description_att_trad_army_barbarian_5_furor_barbaricus	The world derides this fury and chaos out of fear.	true
character_skills_localised_description_cha_skill_spy_back_racketeer	I'm gonna make him an offer he can't refuse.	true
character_skills_localised_description_att_trad_navy_eastern_2_barbarian_subjugators	Men of the earth and soil are powerless against our fleet.	true
character_skills_localised_description_mk_skill_general_back_administrator	This man's seal is respected throughout the world.	true
character_skills_localised_description_mk_trad_navy_double_planking	What if, instead of one plank of wood, they had to get past… two!	true
character_skills_localised_name_att_skill_background_spy_racketeer_barbarian	Criminal	true
character_skills_localised_description_att_general_skills_roman_3_cavalry_commander	The sound of thundering hooves rouses this man to great deeds.	true
character_skills_localised_description_mk_skill_general_back_attacker	This man knows only the endless charge, the relentless push of battle.	true
character_skills_localised_name_att_skill_background_spy_mole_nomadic	Mole	true
character_skills_localised_description_mk_skill_priest_spiritual_leadership	The blind will see! The deaf will hear!	true
character_skills_localised_name_cha_skill_back_natural_gift	Natural Gift	true
character_skills_localised_description_att_skill_background_priest_scholar_nomadic	Stay a while and listen.	true
character_skills_localised_description_mk_skill_general_back_supply	Food and weapons win wars as much as any soldier.	true
character_skills_localised_description_cha_skill_assassin_coercion	What good is a missive if you are unable to speak?	true
character_skills_localised_description_mk_skill_general_back_patron	This is a glorious building. Yes. Beautiful. I'll take ten.	true
character_skills_localised_description_mk_skill_spy_sabotage	Sabotage is art. The art of spoiling the enemy's plans.	true
character_skills_localised_name_cha_skill_spy_back_spymaster	Spymaster	true
character_skills_localised_name_att_skill_background_general_warrior_roman	Fearless Warrior	true
character_skills_localised_name_att_skill_background_champion_martial_arts_barbarian	Glima Master	true
character_skills_localised_name_cha_skill_assassin_assassin	Assassin	true
character_skills_localised_name_cha_skill_assassin_bodyguard	Bodyguard	true
character_skills_localised_name_att_skill_background_general_defender_eastern	Steadfast Defender	true
character_skills_localised_name_cha_skill_priest_determined	Determined	true
character_skills_localised_name_cha_trad_navy_loyal	Loyal	true
character_skills_localised_description_cha_skill_assassin_back_aide	It is only right for someone of stature to have someone wait on them.	true
character_skills_localised_description_mk_skill_general_back_marksman	Through fire, and wind, and death, his shot flies true to its target every time.	true
character_skills_localised_name_att_skill_background_wife_all_cunning	Cunning	true
character_skills_localised_description_att_trad_navy_eastern_2_blockade_runners	This is a consular ship, we're on a diplomatic mission…	true
character_skills_localised_name_att_trad_army_roman_3_foederati_corps	Foederati Corps	true
character_skills_localised_description_att_skill_background_wife_all_flirt	He has eyes for me. This will work to our advantage, my darling…	true
character_skills_localised_description_att_skill_background_general_melee_barbarian	The weapon is no mere tool, but an extension of the very arm itself.	true
character_skills_localised_name_mk_skill_spy_sapping	Sapping	true
character_skills_localised_description_att_general_skills_roman_4_strategist	In victory, this man takes all the credit. In defeat, silence. That is strategy.	true
character_skills_localised_name_att_trad_army_barbarian_3_epic_camp_following	Epic Camp Following	true
character_skills_localised_name_att_agent_skills_priest_retribution	Retribution	true
character_skills_localised_name_mk_skill_priest_conviction	Conviction	true
character_skills_localised_description_mk_trad_army_looters	Leave nothing behind but flesh for the carrion.	true
character_skills_localised_name_att_skill_background_priest_scribe_eastern_eastern	Dibherbadh	true
character_skills_localised_name_att_skill_background_priest_scribe_nomadic_nomadic	Scribe	true
character_skills_localised_name_mk_skill_assassin_training	Training	true
character_skills_localised_description_bel_trad_army_roman_4_sieging	“Once more, unto the breach, dear friends, once more.”	true
character_skills_localised_description_att_trad_army_eastern_3_dailamite_regime	The very best heavy infantry, famed for their prodigious skill at melee.	true
character_skills_localised_name_att_trad_army_eastern_2_self_sufficiency	Self-Sufficiency	true
character_skills_localised_description_att_trad_army_roman_3_medium_training	You will learn discipline, then combat, then you will be deadly.	true
character_skills_localised_name_att_skill_background_wife_all_quiet	Quiet	true
character_skills_localised_description_att_trad_navy_barbarian_3_cuthroat_raiders	Now is not the time for fear - That comes later.	true
character_skills_localised_name_att_skill_background_wife_all_shrew	Shrewish	true
character_skills_localised_name_att_skill_background_priest_scholar_eastern	Mentor	true
character_skills_localised_description_att_general_skills_barbarian_5_legend	This man became history. History became legend. Legend becomes myth.	true
character_skills_localised_description_cha_skill_priest_conviction	Dark and sinister man, have at thee!	true
character_skills_localised_description_mk_skill_assassin_back_legend	This man became history. History became legend. Legend becomes myth.	true
character_skills_localised_name_att_skill_background_general_melee_barbarian	Fighter	true
character_skills_localised_description_mk_skill_spy_sapping	A wall is just another obstacle for this man to undermine.	true
character_skills_localised_name_mk_trad_army_looters	Looters	true
character_skills_localised_name_att_skill_background_spy_conspirator_roman	Conspirator	true
character_skills_localised_description_cha_skill_assassin_training	Discipline, strength, skill. Mastery of these brings victory.	true
character_skills_localised_description_mk_skill_spy_arsonist	Don't you want to know why I keep starting fires? It's my desire.	true
character_skills_localised_name_att_skill_background_champion_team_sports_barbarian	Competitor	true
character_skills_localised_description_att_trad_army_eastern_2_self_sufficiency	The open sky above, and a spear in hand. Nothing more is needed.	true
character_skills_localised_name_att_trad_army_eastern_3_dailamite_regime	Shock Troops	true
character_skills_localised_name_att_skill_background_general_marksman_nomadic	Marksman	true
character_skills_localised_name_att_general_skills_barbarian_4_sentinel	Sentinel	true
character_skills_localised_description_att_skill_background_priest_radical_eastern_eastern	The status-quo is stagnation, and stagnation is the enemy.	true
character_skills_localised_description_att_skill_background_priest_radical_nomadic_nomadic	The status-quo is stagnation, and stagnation is the enemy.	true
character_skills_localised_description_att_trad_navy_eastern_1_naval_support	A powerful battery of arrows is ideal backup for naval sorties.	true
character_skills_localised_name_cha_skill_assassin_back_aide	Aide	true
character_skills_localised_description_cha_skill_priest_belief_islam	Belief includes obligations. Whoever fulfills all of them has perfected his belief.	true
character_skills_localised_description_att_agent_skills_priest_provocation	Swords will not avail you. I am guarded by a heavenly host.	true
character_skills_localised_description_cha_skill_priest_belief_pagan	The Earth does not belong to us. We belong to the Earth.	true
character_skills_localised_description_att_general_skills_barbarian_3_fleet_commander	The sway of the swell and the waft of sea breeze gives this man purpose.	true
character_skills_localised_name_mk_trad_army_cavalry_training	Noble Commander	true
character_skills_localised_name_att_trad_navy_eastern_2_blockade_runners	Blockade Runners	true
character_skills_localised_description_cha_skill_assassin_bodyguard	To the last, determined, gasping breath, he will defend.	true
character_skills_localised_name_mk_skill_assassin_eyes_ears	Eyes & Ears	true
character_skills_localised_description_att_skill_background_champion_martial_arts_barbarian	Okay, I want a good clean fight. No kicks in the tassets.	true
character_skills_localised_description_cha_skill_spy_back_spymaster	This man sees all, and hears all. He misses nothing.	true
character_skills_localised_name_mk_skill_general_back_supply	Supply	true
character_skills_localised_name_mk_skill_general_back_patron	Patron	true
character_skills_localised_description_mk_skill_spy_practice	It takes 10,000 hours to master something, they say. You better get started.	true
character_skills_localised_name_mk_skill_assassin_coercion	Coercion	true
character_skills_localised_name_att_skill_background_spy_courier_barbarian	Courier	true
character_skills_localised_name_mk_skill_priest_spiritual_leadership	Spiritual Leadership	true
character_skills_localised_name_cha_trad_army_hunters	Hunters	true
character_skills_localised_name_att_skill_background_general_attacker_nomadic	Relentless Attacker	true
character_skills_localised_description_cha_skill_general_back_scholar	Books are the mightiest weapon in the war against ignorance.	true
character_skills_localised_description_att_skill_background_spy_racketeer_barbarian	I'm gonna make him an offer he can't refuse.	true
character_skills_localised_name_att_general_skills_roman_3_cavalry_commander	Cavalry Commander	true
character_skills_localised_name_mk_trad_navy_double_planking	Double Planking	true
character_skills_localised_name_cha_trad_army_siege_experts	Siege Experts	true
character_skills_localised_name_cha_skill_spy_back_racketeer	Racketeer	true
character_skills_localised_name_mk_skill_general_back_melee	Melee	true
character_skills_localised_name_mk_skill_general_back_rider	Rider	true
character_skills_localised_description_att_skill_background_champion_elite_barbarian	Trusted servant and fearful fighter, this man has earned respect.	true
character_skills_localised_name_att_skill_background_priest_advisor_nomadic	Right Hand	true
character_skills_localised_description_cha_skill_back_cat_reflexes	The agility of a leopard; the power of a lion.	true
character_skills_localised_description_mk_skill_assassin_back_aide	It is only right for someone of stature to have someone wait on them.	true
character_skills_localised_description_att_skill_background_wife_civilised_efficient	Within these doors, I run the household. You have enough with everything else!	true
character_skills_localised_description_att_trad_navy_barbarian_1_naval_expedition	Bring me that horizon.	true
character_skills_localised_name_att_skill_background_priest_public_speaker_nomadic	Public Speaker	true
character_skills_localised_description_att_trad_army_eastern_3_parthian_horsemanship	Ancient tactics, preserved and practiced by today’s cavalrymen.	true
character_skills_localised_name_att_agent_skills_priest_conviction	Conviction	true
character_skills_localised_description_att_skill_background_priest_militarist_roman	Well, I suppose peace is AN option, but so is bloody dancing!	true
character_skills_localised_name_att_skill_background_champion_martial_arts_nomadic	Wrestling Master	true
character_skills_localised_name_att_skill_background_spy_builder_barbarian	Builder	true
character_skills_localised_description_mk_skill_spy_back_mole	Being in the right place, at the right time - hearing the right things - is of greater value than a thousand swordsmen.	true
character_skills_localised_name_att_skill_background_champion_officer_nomadic	Warband Leader	true
character_skills_localised_name_att_general_skills_barbarian_4_warchief	Warchief	true
character_skills_localised_name_att_skill_background_general_leader_eastern	Leader	true
character_skills_localised_name_att_skill_background_champion_drillmaster_barbarian	Warmaster	true
character_skills_localised_description_cha_trad_army_steady_troops	Hold firm, lads, and we'll live to see this day end!	true
character_skills_localised_description_mk_trad_army_hunters	Keep quiet. Draw the bow. Breathe. Shoot.	true
character_skills_localised_name_cha_skill_priest_prejudice	Prejudice	true
character_skills_localised_description_cha_skill_assassin_back_scout	The road ahead is shrouded in darkness. I am the light.	true
character_skills_localised_name_att_skill_background_champion_war_hero_roman	Evocatus	true
character_skills_localised_description_att_skill_background_general_leader_barbarian	Courage is not the absence of fear, but triumph over it.	true
character_skills_localised_name_cha_skill_assassin_practice	Practice	true
character_skills_localised_name_att_skill_background_champion_watchman_roman	Vigile	true
character_skills_localised_description_cha_skill_spy_sabotage	Sabotage is art. The art of spoiling the enemy's plans.	true
character_skills_localised_description_att_skill_background_champion_marine_barbarian	Victory on land, victory on sea. Victory above all.	true
character_skills_localised_name_mk_trad_army_dread	Dread	true
character_skills_localised_name_mk_trad_army_loyal	Loyal	true
character_skills_localised_name_att_general_skills_eastern_4_judge	Judge	true
character_skills_localised_description_att_skill_background_wife_barbarian_priestess	I have prayed for your success, husband. And sacrificed.	true
character_skills_localised_description_cha_skill_general_back_administrator	This man's seal is respected throughout the world.	true
character_skills_localised_name_att_skill_background_general_supply_nomadic	Logistics Expert	true
character_skills_localised_description_att_skill_background_general_taskmaster_roman	No feat nor effort can truly please this man.	true
character_skills_localised_description_mk_skill_spy_back_racketeer	I'm gonna make him an offer he can't refuse.	true
character_skills_localised_description_att_skill_background_priest_spiritual_leader_barbarian	Look to your own sins; the night is dark and full of terrors.	true
character_skills_localised_description_att_skill_background_priest_strategy_gaming_nomadic	A good player is not one who is five moves ahead, but who has won from the first.	true
character_skills_localised_description_att_trad_army_eastern_4_barbarian_subjugators	Those that trampled Rome will find no purchase here.	true
character_skills_localised_name_cha_skill_spy_sapping	Sapping	true
character_skills_localised_name_bel_trad_army_roman_3_attacking_enemy	Enemy Territory	true
character_skills_localised_description_att_skill_background_wife_roman_noble	My forefathers built this city. You, my dear, will save it!	true
character_skills_localised_description_att_skill_background_general_leader_nomadic	Courage is not the absence of fear, but triumph over it.	true
character_skills_localised_description_att_skill_background_champion_aide_camp_roman	This man has worked his way up over many years, inspiring greatness as he aspires to greatness.	true
character_skills_localised_description_mk_skill_assassin_bodyguard	To the last, determined, gasping breath, he will defend.	true
character_skills_localised_name_att_skill_background_general_scholar_roman	Scholar	true
character_skills_localised_description_mk_skill_spy_back_spymaster	This man sees all, and hears all. He misses nothing.	true
character_skills_localised_name_cha_trad_army_looters	Looters	true
character_skills_localised_description_att_skill_background_general_landowner_eastern	Ah, it's good to own land.	true
character_skills_localised_name_att_agent_skills_champion_skirmishing	Skirmishing	true
character_skills_localised_description_cha_skill_assassin_back_legend	This man became history. History became legend. Legend becomes myth.	true
character_skills_localised_name_att_skill_background_champion_standard_bearer_eastern	Standard-Bearer	true
character_skills_localised_description_cha_skill_spy_arsonist	Don't you want to know why I keep starting fires? It's my desire.	true
character_skills_localised_description_cha_trad_army_dread	The chill that the enemy feels when they see these men approaching is entirely justified.	true
character_skills_localised_description_cha_trad_army_loyal	Not a man here would dissent. They go with their commander to death and glory, then beyond.	true
character_skills_localised_description_att_agent_skills_priest_instigation	One more thing…	true
character_skills_localised_description_att_skill_background_priest_advisor_eastern	What the king dreams, the hand will build.	true
character_skills_localised_description_bel_trad_army_roman_2_home_defence	To defend one’s home is both a duty and the greatest of honours.	true
character_skills_localised_description_att_skill_background_champion_officer_roman	Leaders of men. Warriors. Covered in blood, battle and glory.	true
character_skills_localised_name_att_skill_background_spy_artisan_barbarian	Artisan	true
character_skills_localised_name_att_agent_skills_priest_admonition	Admonition	true
character_skills_localised_name_cha_skill_general_back_administrator	Administrator	true
character_skills_localised_description_att_general_skills_nomadic_3_cavalry_commander	There, to the flank! Lances ready!	true
character_skills_localised_description_att_skill_background_champion_war_hero_roman	This man lives for war. His time is done, his battles won, yet he remains.	true
character_skills_localised_name_att_skill_background_priest_strategy_gaming_eastern	Chatrang Player	true
character_skills_localised_description_att_skill_background_champion_watchman_roman	He waits. That's what he does. 	true
character_skills_localised_description_att_trad_army_eastern_2_nomad_hunters	Steppe horses are quick, but Persian horses are quicker.	true
character_skills_localised_name_mk_trad_army_steady_troops	Steady	true
character_skills_localised_name_att_trad_navy_roman_2_naval_logistics	Naval Logistics	true
character_skills_localised_name_att_agent_skills_champion_sabotage	Sabotage	true
character_skills_localised_name_mk_trad_army_hunters	Hunters	true
character_skills_localised_description_mk_skill_general_back_scholar	Books are the mightiest weapon in the war against ignorance.	true
character_skills_localised_name_mk_skill_assassin_provision	Provision	true
character_skills_localised_name_att_trad_army_nomadic_5_scourge_world	Scourge of the World	true
character_skills_localised_name_cha_skill_priest_spiritual_leadership	Spiritual Leadership	true
character_skills_localised_description_cha_skill_spy_practice	It takes 10,000 hours to master something, they say. You better get started.	true
character_skills_localised_name_att_skill_background_general_merchant_eastern	Merchant	true
character_skills_localised_name_cha_skill_general_back_patron	Patron	true
character_skills_localised_name_cha_skill_general_back_supply	Supply	true
character_skills_localised_name_mk_skill_back_cat_reflexes	Feline Reflexes	true
character_skills_localised_name_att_skill_background_priest_militarist_roman	Militarist	true
character_skills_localised_description_att_skill_background_general_patron_eastern	This is a glorious building. Yes. Beautiful. I'll take ten.	true
character_skills_localised_description_att_skill_background_general_supply_eastern	Feeding one man a day is feat enough. Feeding an entire army is prodigious.	true
character_skills_localised_description_att_skill_background_champion_standard_bearer_roman	The banner of victory, proud and resplendent in this man's hands.	true
character_skills_localised_description_att_skill_background_wife_roman_well_connected	I will write to my cousin, of course. And grandfather. And my uncles…	true
character_skills_localised_name_cha_trad_navy_double_planking	Double Planking	true
character_skills_localised_description_att_agent_skills_priest_dogma	I will succeed because I believe it.	true
character_skills_localised_name_mk_skill_general_back_leader	Leader	true
character_skills_localised_name_mk_trad_army_siege_experts	Siege Experts	true
character_skills_localised_description_mk_skill_assassin_opportunism	When the cat's away, the mice will probably kill someone.	true
character_skills_localised_name_mk_skill_general_back_administrator	Administrator	true
character_skills_localised_name_cha_skill_priest_pessimism	Pessimism	true
character_skills_localised_name_mk_trad_army_supplies	Supplies	true
character_skills_localised_name_att_skill_background_wife_all_fertile	Fertile	true
character_skills_localised_name_att_skill_background_priest_advisor_barbarian	Legislator	true
character_skills_localised_description_att_skill_background_spy_informant_barbarian	You're actually working for us but they think you're working for them? This espionage business is terribly confusing…	true
character_skills_localised_name_cha_skill_priest_eyes_ears	Eyes & Ears	true
character_skills_localised_description_att_skill_background_champion_medic_barbarian	Physician, heal thyself.	true
character_skills_localised_description_att_skill_background_spy_spymaster_barbarian	This man sees all, and hears all. He misses nothing.	true
character_skills_localised_description_cha_skill_back_natural_gift	Maybe they're born with it…?	true
character_skills_localised_name_att_skill_background_priest_scholar_nomadic	Loremaster	true
character_skills_localised_name_cha_skill_assassin_coercion	Coercion	true
character_skills_localised_name_cha_skill_priest_damnation	Damnation	true
character_skills_localised_name_mk_trad_navy_raiders	Raiders	true
character_skills_localised_description_att_skill_background_priest_accountant_roman	A man with a gift for numbers is valuable amongst a crowd of warmongers.	true
character_skills_localised_description_cha_skill_assassin_assassin	The art of the kill is drawn in blood.	true
character_skills_localised_description_att_skill_background_priest_scribe_roman_roman	The written word, though unintelligible to most, is the history of the world laid down.	true
character_skills_localised_name_att_general_skills_roman_1_legatus	Legatus	true
character_skills_localised_name_att_skill_background_general_marksman_eastern	Marksman	true
character_skills_localised_description_att_skill_background_general_landowner_roman	In a world wracked by abject poverty, the landowner is king.	true
character_skills_localised_description_cha_trad_navy_loyal	Not a man here would dissent. They go with their commander to death and glory, then beyond.	true
character_skills_localised_name_att_general_skills_barbarian_celts_brethid	Brethid	true
character_skills_localised_description_cha_skill_priest_determined	To strive, to seek, to find, and not to yield.	true
character_skills_localised_description_mk_skill_general_back_warrior	This man was born to fight. Nothing more; war brings honour enough.	true
character_skills_localised_name_mk_skill_priest_back_advisor	Advisor	true
character_skills_localised_name_att_trad_navy_eastern_5_pride_east	Pride of the East	true
character_skills_localised_name_cha_trad_navy_scourge_pirates	Pirate Scourge	true
character_skills_localised_description_mk_skill_general_back_defender	To hold the line, to weather the storm; these are skills that win battles.	true
character_skills_localised_name_att_general_skills_roman_2_infantry_commander	Infantry Commander	true
character_skills_localised_description_att_skill_background_champion_assassin_roman	I will be your champion.	true
character_skills_localised_name_att_skill_background_wife_all_flirt	Flirtatious	true
character_skills_localised_description_att_agent_skills_priest_retribution	And you will know my name is the Lord, when I lay my vengeance upon thee.	true
character_skills_localised_name_cha_skill_assassin_provision	Provision	true
character_skills_localised_name_mk_skill_priest_dogma	Dogma	true
character_skills_localised_name_att_skill_background_champion_horse_vet_roman	Veterinarius	true
character_skills_localised_description_cha_skill_spy_tracking	Through the wilderness, over hill and vale, through dark and light, he will follow.	true
character_skills_localised_name_att_skill_background_general_attacker_eastern	Relentless Attacker	true
character_skills_localised_description_cha_skill_general_sweet_talker	Honeyed words can be as deadly as the finest blade.	true
character_skills_localised_description_att_skill_background_wife_all_shrew	And what time do you call this to get in from campaigning? Bah! More drinking! Don't you dare be sick!	true
character_skills_localised_description_att_skill_background_wife_all_quiet	It's the quiet ones who need watching.	true
character_skills_localised_description_att_skill_background_priest_scholar_eastern	Stay a while and listen.	true
character_skills_localised_description_cha_skill_assassin_provision	Some things will never change; an army always marches on its stomach.	true
character_skills_localised_name_cha_skill_priest_conviction	Conviction	true
character_skills_localised_name_att_agent_skills_champion_training	Training	true
character_skills_localised_name_att_skill_background_wife_civilised_brutal	Brutal	true
character_skills_localised_name_att_skill_background_champion_assassin_roman	Propugnator	true
character_skills_localised_name_cha_skill_assassin_training	Training	true
character_skills_localised_description_mk_skill_spy_smuggler	Never tell me the odds!	true
character_skills_localised_description_att_skill_background_champion_team_sports_barbarian	Faster. Higher. Stronger.	true
character_skills_localised_name_att_skill_background_general_defender_nomadic	Steadfast Defender	true
character_skills_localised_description_att_general_skills_barbarian_4_sentinel	He will stand, and watch, and guard. No more is asked, and he can do no better.	true
character_skills_localised_name_att_skill_background_priest_radical_eastern_eastern	Radical	true
character_skills_localised_name_att_skill_background_priest_radical_nomadic_nomadic	Radical	true
character_skills_localised_name_mk_trad_navy_loyal	Loyal	true
character_skills_localised_description_mk_skill_priest_back_advisor	What the king dreams, the hand will build.	true
character_skills_localised_name_mk_skill_priest_determined	Determined	true
character_skills_localised_name_att_agent_skills_priest_provocation	Provocation	true
character_skills_localised_description_att_skill_background_general_politician_roman	That's how you devour a whale; one bite at a time.	true
character_skills_localised_name_att_skill_background_general_landowner_roman	Landowner	true
character_skills_localised_name_att_skill_background_spy_mole_eastern	Infiltrator	true
character_skills_localised_description_mk_skill_assassin_eyes_ears	This man sees all, and hears all. He misses nothing.	true
character_skills_localised_name_att_skill_background_priest_accountant_roman	Numerarius	true
character_skills_localised_name_mk_skill_back_natural_gift	Natural Gift	true
character_skills_localised_description_mk_trad_navy_raiders	Success on the seas is not always about victory in battle.	true
character_skills_localised_description_att_trad_navy_barbarian_5_naval_conquerors	From coast to coast, they speak the name of this fleet in fearful tones.	true
character_skills_localised_name_att_skill_background_spy_informant_barbarian	Double Agent	true
character_skills_localised_name_mk_skill_assassin_assassin	Assassin	true
character_skills_localised_name_att_skill_background_spy_spymaster_barbarian	Spymaster	true
character_skills_localised_name_mk_trad_navy_boarders	Boarders	true
character_skills_localised_description_cha_skill_assassin_back_master	This one has spent a lifetime perfecting, and then employing, his skills. 	true
character_skills_localised_name_att_skill_background_priest_scholar_barbarian	Loremaster	true
character_skills_localised_description_cha_skill_spy_back_conspirator	Chicanery, machinations and a fair deal of skulduggery.	true
character_skills_localised_description_att_skill_background_champion_scout_barbarian	The road ahead is shrouded in darkness. I am the light.	true
character_skills_localised_description_att_skill_background_wife_barbarian_swordmaid	Come on, love. Admit it. I could cut you in two in a proper fight!	true
character_skills_localised_description_att_skill_background_wife_civilised_political	No. No friends. Everyone at table tonight can be used. It will help us to better things.	true
character_skills_localised_description_att_skill_background_champion_quartermaster_barbarian	The matter of procurement, and suitable equipment, is this man's expertise.	true
character_skills_localised_description_cha_trad_army_siege_experts	Whether breaking down walls, or holding out behind them, these men are versed in the skills needed to endure and rise.	true
character_skills_localised_description_mk_skill_general_back_melee	Arrows and javelins are for the mealy. REAL men get so close they can smell the sweat!	true
character_skills_localised_name_att_skill_background_general_handler_roman	Handler	true
character_skills_localised_description_mk_skill_general_back_rider	This man is at his best and his happiest when at a gallop.	true
character_skills_localised_description_mk_skill_general_back_leader	Courage is not the absence of fear, but triumph over it.	true
character_skills_localised_name_cha_skill_assassin_determined	Determined	true
character_skills_localised_name_mk_skill_priest_back_militant	Militant	true
character_skills_localised_name_att_general_skills_roman_3_vicarius	Vicarius	true
character_skills_localised_description_mk_skill_general_trainer	It is the duty of the man who knows to teach the man who does not.	true
character_skills_localised_name_mk_skill_general_builder	Builder	true
character_skills_localised_description_att_skill_background_general_administrator_roman	This man's seal is respected throughout the world.	true
character_skills_localised_name_att_skill_background_champion_assassin_nomadic	Brute	true
character_skills_localised_name_att_agent_skills_champion_ruse	Ruse	true
character_skills_localised_description_att_skill_background_champion_engineer_barbarian	To the warmaker, artillery is a weapon of war. To this man, it is a work of art.	true
character_skills_localised_name_att_general_skills_barbarian_3_stag	Stag	true
character_skills_localised_name_cha_trad_navy_bombardment	Bombardment	true
character_skills_localised_name_att_skill_background_spy_agriculture_barbarian	Farmer	true
character_skills_localised_description_att_skill_background_priest_benefactor_barbarian	When the cat is away, this man makes sure the mice stay entirely where they should.	true
character_skills_localised_name_att_trad_army_barbarian_3_champions_north_slavs	Champions of the North	true
character_skills_localised_description_att_trad_navy_barbarian_3_dauntless_navigators	The ocean favours the brave! Full bore and into the abyss!	true
character_skills_localised_description_cha_skill_general_back_landowner	He has found favour by an oath of vassalage, and his loyalty to it.	true
character_skills_localised_description_att_skill_background_general_taskmaster_nomadic	No feat nor effort can truly please this man.	true
character_skills_localised_description_cha_skill_spy_local_agents	The right contacts in the right place, and at the right time, can make all the difference.	true
character_skills_localised_name_cha_skill_back_watchman	Watchman	true
character_skills_localised_description_mk_skill_general_back_strategist	Knowing when to attack, when to defend, and when to utterly destroy. That is strategy.	true
character_skills_localised_description_mk_skill_general_inspired_leader	Ah, well; who wants to live forever? 	true
character_skills_localised_name_att_skill_background_priest_benefactor_eastern	Custodian	true
character_skills_localised_description_cha_skill_assassin_fear	I move for no man.	true
character_skills_localised_description_att_skill_background_general_supply_roman	Feeding one man a day is feat enough. Feeding an entire army is prodigious.	true
character_skills_localised_name_att_skill_background_general_rider_roman	Champion Rider	true
character_skills_localised_name_att_agent_skills_spy_subterfuge	Subterfuge	true
character_skills_localised_description_cha_skill_assassin_thugs	Getting others to do things for you is a skill in its own right.	true
character_skills_localised_name_att_trad_army_eastern_4_savaran_regime	Noble Cavalry Elite	true
character_skills_localised_description_att_trad_army_eastern_2_self_sufficiency_eos	The open sky above, and a spear in hand. Nothing more is needed.	true
character_skills_localised_name_att_skill_background_priest_militarist_eastern	Militarist	true
character_skills_localised_name_att_general_skills_eastern_5_zhayedan	Elite Warrior	true
character_skills_localised_description_cha_trad_army_infantry_training	Even craftsmen can turn an army back from their city with proper training.	true
character_skills_localised_description_att_skill_background_spy_hunter_eastern	They hunt so that they do not become the hunted themselves…	true
character_skills_localised_name_cha_trad_army_cavalry_training	Noble Commander	true
character_skills_localised_description_att_skill_background_champion_drillmaster_roman	You will listen, and you will learn, or you will surely die.	true
character_skills_localised_description_att_general_skills_eastern_3_archer_commander	Don't fire until you see the whites of their eyes!	true
character_skills_localised_name_att_trad_army_eastern_2_self_sufficiency_eos	Self-Sufficiency	true
character_skills_localised_description_att_skill_background_spy_informant_nomadic	You're actually working for us but they think you're working for them? This espionage business is terribly confusing…	true
character_skills_localised_name_att_skill_background_champion_team_sports_eastern	Chougan Champion	true
character_skills_localised_name_mk_trad_army_weak_spots	Weak Spots	true
character_skills_localised_name_att_general_skills_eastern_2_overseer	Overseer	true
character_skills_localised_name_mk_trad_army_infantry_training	Militia Drilling	true
character_skills_localised_description_cha_skill_assassin_back_extortion	My friend had five fingers. He only used three.	true
character_skills_localised_name_att_skill_background_general_taskmaster_eastern	Taskmaster	true
character_skills_localised_name_cha_skill_general_thinker	Thinker	true
character_skills_localised_name_att_skill_background_priest_progressive_barbarian	Progressive	true
character_skills_localised_description_att_skill_background_general_melee_nomadic	The weapon is no mere tool, but an extension of the very arm itself.	true
character_skills_localised_description_att_skill_background_general_rider_nomadic	There are men who ride, and there are riders.	true
character_skills_localised_description_att_skill_background_spy_hunter_barbarian	They hunt so that they do not become the hunted themselves…	true
character_skills_localised_name_mk_skill_assassin_fear	Fear	true
character_skills_localised_name_cha_skill_assassin_thugs	Thugs	true
character_skills_localised_description_mk_skill_spy_black_market	What cannot be found by normal means can surely be… 'acquired' another way...	true
character_skills_localised_description_att_skill_background_general_strategist_barbarian	Every possibility accounted for, every breath explained.	true
character_skills_localised_name_att_skill_background_champion_standard_bearer_barbarian	Flag-bearer	true
character_skills_localised_description_att_skill_background_wife_all_ambitious	No, my love. The others are holding you back because they are jealous…	true
character_skills_localised_description_att_skill_background_wife_all_religious	The omens are always in your favour, my dear. Always. My prayers see to that.	true
character_skills_localised_description_att_trad_navy_roman_3_military_escorts	Safeguarding precious cargo to its destination.	true
character_skills_localised_description_att_skill_background_general_rider_roman	There are men who ride, and there are riders.	true
character_skills_localised_description_att_trad_army_nomadic_2_extortion	My friend had five fingers. He only used three	true
character_skills_localised_description_att_trad_navy_roman_5_interdictor_fleet	Good. Our first catch of the day.	true
character_skills_localised_name_mk_skill_general_inspired_leader	Inspired Leader	true
character_skills_localised_name_mk_skill_general_back_strategist	Strategist	true
character_skills_localised_name_att_general_skills_eastern_2_infantry_commander	Infantry Commander	true
character_skills_localised_description_att_general_skills_roman_3_overseer	There is no aspect, nor minutiae or scrap that escapes this man's attention.	true
character_skills_localised_name_att_skill_background_priest_strategy_gaming_roman	Latrunculi Player	true
character_skills_localised_name_cha_skill_priest_rhetoric	Rhetoric	true
character_skills_localised_name_cha_skill_general_back_landowner	Landowner	true
character_skills_localised_description_att_skill_background_general_patron_roman	This is a glorious basilica. Yes. Beautiful. I'll take ten.	true
character_skills_localised_name_att_skill_background_priest_accountant_nomadic	Treasurer	true
character_skills_localised_description_att_trad_army_nomadic_4_ruin_rome	Eagles dare not fly where these horses ride.	true
character_skills_localised_name_att_general_skills_nomadic_1_lightning	Lightning	true
character_skills_localised_name_att_skill_background_priest_benefactor_barbarian	Steward	true
character_skills_localised_name_att_skill_background_spy_hunter_nomadic	Bowhunter	true
character_skills_localised_description_cha_skill_general_back_entrepeneur	Pull yourself up by the sandal straps. Face the day. Then seize it.	true
character_skills_localised_description_mk_skill_general_tactician	The tactician is the master of the gameboard, always thinking many moves ahead.	true
character_skills_localised_description_att_agent_skills_spy_military_infiltration	To a master of concealment, locked doors and barred passages are of no concern.	true
character_skills_localised_description_att_skill_background_general_administrator_eastern	This man's seal is respected throughout the world.	true
character_skills_localised_name_att_skill_background_champion_engineer_barbarian	Builder	true
character_skills_localised_description_mk_trad_navy_weak_spots	Any weakness, any chink in the armour, will be exploited by these men.	true
character_skills_localised_description_mk_skill_general_builder	One brick follows another. The greatest buildings start with the smallest objects.	true
character_skills_localised_name_att_general_skills_eastern_1_shahrdar	Viceroy	true
character_skills_localised_name_att_skill_background_general_administrator_roman	Administrator	true
character_skills_localised_description_att_trad_navy_barbarian_5_scourge_seas	The enemy see the sails and know their end approaches.	true
character_skills_localised_name_att_skill_background_champion_officer_barbarian	Warband Leader	true
character_skills_localised_name_mk_skill_general_trainer	Trainer	true
character_skills_localised_description_att_trad_army_nomadic_1_nomadic_horsemanship	When you have nowhere to settle the saddle becomes your home.	true
character_skills_localised_name_cha_skill_priest_practice	Practice	true
character_skills_localised_name_cha_skill_priest_back_progressive	Progressive	true
character_skills_localised_description_mk_skill_assassin_terror	No man is safe. Everyone is a target.	true
character_skills_localised_name_mk_skill_assassin_thugs	Thugs	true
character_skills_localised_description_att_trad_navy_eastern_4_ruin_rome	Rome's navies, like its once-vaunted Empire, will sink into nothingness.	true
character_skills_localised_description_mk_skill_spy_back_rumours	What is whispered in the shadows may find its way to the right ear…	true
character_skills_localised_description_mk_skill_back_dice_roller	Oh, the sound of rolling dice to me is music in the air.	true
character_skills_localised_name_att_skill_background_general_politician_nomadic	Powermonger	true
character_skills_localised_name_att_trad_army_barbarian_4_great_migrators	Great Migrators	true
character_skills_localised_name_att_general_skills_nomadic_4_warmaster	Warmaster	true
character_skills_localised_name_att_agent_skills_priest_mystery	Mystery	true
character_skills_localised_description_cha_skill_spy_surveillance	Watch. Wait. See. Then act.	true
character_skills_localised_name_att_skill_background_champion_drillmaster_nomadic	Warmaster	true
character_skills_localised_name_cha_trad_army_weak_spots	Weak Spots	true
character_skills_localised_description_att_skill_background_general_strategist_nomadic	Every possibility accounted for, every breath explained.	true
character_skills_localised_description_att_skill_background_general_melee_roman	The weapon is no mere tool, but an extension of the very arm itself.	true
character_skills_localised_description_att_general_skills_barbarian_celts_bandit	The land has wealth, what passes through it even more so.	true
character_skills_localised_name_mk_trad_army_ferocious	Ferocious	true
character_skills_localised_name_mk_skill_priest_belief	Belief	true
character_skills_localised_description_att_trad_army_nomadic_3_nomadic_marksmanship	Every bow makes its own tune.	true
character_skills_localised_description_cha_trad_navy_placed_shots	Timing, accuracy, resolve. Master all three and your shots will always fly true.	true
character_skills_localised_description_cha_trad_army_placed_shots	Timing, accuracy, resolve. Master all three and your shots will always fly true.	true
character_skills_localised_name_att_skill_background_spy_racketeer_roman	Exactor	true
character_skills_localised_description_att_general_skills_barbarian_3_cavalry_commander	Half a league, half a league, half a league onward!	true
character_skills_localised_name_att_skill_background_wife_all_faithful	Faithful	true
character_skills_localised_name_att_skill_background_wife_all_arrogant	Arrogant	true
character_skills_localised_name_cha_skill_assassin_misdirection	Misdirection	true
character_skills_localised_description_mk_skill_general_back_taskmaster	No feat nor effort can truly please this man.	true
character_skills_localised_name_att_agent_skills_spy_corruption	Corruption	true
character_skills_localised_description_att_skill_background_priest_progressive_nomadic	Stay on the cliff too long and you'll be washed away.	true
character_skills_localised_name_att_general_skills_barbarian_2_infantry_commander	Infantry Commander	true
character_skills_localised_description_att_skill_background_spy_racketeer_nomadic	I'm gonna make him an offer he can't refuse.	true
character_skills_localised_name_att_trad_army_eastern_4_guardians_royal_road	Border Guards	true
character_skills_localised_name_att_skill_background_general_warrior_barbarian	Fearless Warrior	true
character_skills_localised_name_att_skill_background_champion_martial_arts_roman	Pankration Master	true
character_skills_localised_name_mk_skill_general_back_landowner	Landowner	true
character_skills_localised_description_mk_skill_back_vengeance	The single-minded quest for revenge drives man beyond the point of reason…	true
character_skills_localised_description_att_trad_army_eastern_4_guardians_royal_road	The frontiers have been guarded for many years. These men ensure they will continue to be.	true
character_skills_localised_name_att_skill_background_general_entrepreneur_nomadic	Treasurer	true
character_skills_localised_description_att_general_skills_roman_2_sentinel	I am the sword that guards the people.	true
character_skills_localised_name_cha_skill_general_back_politician	Politician	true
character_skills_localised_name_att_skill_background_spy_courier_roman	Veredarius	true
character_skills_localised_name_att_agent_skills_champion_intimidation	Intimidation	true
character_skills_localised_name_att_skill_background_general_strategist_eastern	Master Planner	true
character_skills_localised_description_att_skill_background_champion_martial_arts_roman	Okay, I want a good clean fight. No kicks in the tassets.	true
character_skills_localised_description_cha_skill_spy_misdirection	A dropped coin, a broken vase. All that is needed is eyes to look elsewhere.	true
character_skills_localised_name_att_general_skills_roman_4_vanguard	Vanguard	true
character_skills_localised_name_att_trad_army_nomadic_3_nomadic_marksmanship	Nomadic Marksmanship	true
character_skills_localised_description_att_skill_background_spy_spymaster_nomadic	This man sees all, and hears all. He misses nothing.	true
character_skills_localised_name_mk_skill_general_back_taskmaster	Taskmaster	true
character_skills_localised_name_att_skill_background_champion_engineer_eastern	Engineer	true
character_skills_localised_description_att_trad_army_barbarian_1_wardens_tribe	The safe, guiding hand of the tribe.	true
character_skills_localised_description_att_skill_background_spy_racketeer_roman	I'm gonna make him an offer he can't refuse.	true
character_skills_localised_name_att_general_skills_barbarian_3_cavalry_commander	Cavalry Commander	true
character_skills_localised_description_att_skill_background_general_politician_eastern	That's how you devour a whale; one bite at a time.	true
character_skills_localised_description_att_general_skills_nomadic_3_archer_commander	Don't fire until you see the whites of their eyes!	true
character_skills_localised_name_att_general_skills_barbarian_1_wolf	Wolf	true
character_skills_localised_name_cha_trad_army_marksman_training	Marksmen	true
character_skills_localised_name_att_skill_background_champion_team_sports_roman	Athleta	true
character_skills_localised_name_att_skill_background_general_melee_roman	Fighter	true
character_skills_localised_name_att_skill_background_spy_conspirator_barbarian	Conspirator	true
character_skills_localised_description_cha_trad_army_weak_spots	Any weakness, any chink in the armour, will be exploited by these men.	true
character_skills_localised_description_att_skill_background_priest_elder_eastern	Honeyed words and wisdom make sweetness of intelligence.	true
character_skills_localised_description_cha_skill_priest_belief	Be on your guard; stand firm in the faith; be men of courage; be strong.	true
character_skills_localised_description_cha_trad_army_ferocious	Howling, slobbering, gnashing; these men are fury personified.	true
character_skills_localised_name_att_trad_army_nomadic_1_nomadic_horsemanship	Nomadic Horsemanship	true
character_skills_localised_name_att_skill_background_champion_war_hero_eastern	War Hero	true
character_skills_localised_name_att_general_skills_eastern_3_elephant_commander	Elephant Commander	true
character_skills_localised_name_att_skill_background_champion_watchman_nomadic	Sentinel	true
character_skills_localised_name_att_skill_background_priest_progressive_eastern	Progressive	true
character_skills_localised_name_mk_skill_assassin_terror	Terror	true
character_skills_localised_name_att_trad_army_barbarian_3_champions_north	Champions of the North	true
character_skills_localised_name_att_skill_background_wife_civilised_unsuitable	Unsuitable	true
character_skills_localised_description_att_agent_skills_spy_civilian_infiltration	A wolf among sheep. 	true
character_skills_localised_description_att_trad_army_eastern_1_persian_marksmanship	I could kill you from a metre away, but forty metres is more impressive.	true
character_skills_localised_description_att_general_skills_roman_3_vicarius	I answer to one man, and that is not you.	true
character_skills_localised_description_att_skill_background_priest_spiritual_leader_roman	In nomine Patris et Filii et Spiritus Sancti.	true
character_skills_localised_description_cha_skill_spy_back_rumours	What is whispered in the shadows may find its way to the right ear…	true
character_skills_localised_description_att_trad_army_barbarian_3_dreaded_reavers	We are your salvation through destruction.	true
character_skills_localised_description_cha_skill_back_dice_roller	Oh, the sound of rolling dice to me is music in the air.	true
character_skills_localised_description_att_skill_background_general_melee_eastern	The weapon is no mere tool, but an extension of the very arm itself.	true
character_skills_localised_description_att_skill_background_general_rider_eastern	There are men who ride, and there are riders.	true
character_skills_localised_name_mk_skill_priest_practice	Practice	true
character_skills_localised_description_att_skill_background_general_taskmaster_barbarian	No feat nor effort can truly please this man.	true
character_skills_localised_name_cha_trad_navy_boarders	Boarders	true
character_skills_localised_name_mk_skill_priest_back_progressive	Progressive	true
character_skills_localised_description_att_trad_navy_barbarian_2_seafaring_traditions	We have sailed these oceans for hundreds of years. Sailing is in the blood.	true
character_skills_localised_description_att_general_skills_barbarian_3_stag	Majestic and proud, he stands in the face of adversity, unbowed.	true
character_skills_localised_name_att_agent_skills_champion_personal_combat	Personal Combat	true
character_skills_localised_name_att_trad_army_eastern_5_keepers_fort	Keepers of the Fort	true
character_skills_localised_name_att_skill_background_champion_team_sports_nomadic	Competitor	true
character_skills_localised_description_att_skill_background_spy_informant_eastern	You're actually working for us but they think you're working for them? This espionage business is terribly confusing…	true
character_skills_localised_description_att_general_skills_roman_3_fleet_commander	The wind at his back, and the fleet at his call; this man needs nothing else.	true
character_skills_localised_description_mk_skill_spy_surveillance	Watch. Wait. See. Then act.	true
character_skills_localised_name_att_skill_background_wife_all_drunkard	Drunkard	true
character_skills_localised_description_att_trad_army_barbarian_3_champions_north_slavs	These men gained glory in the northlands; strong and redoubtable.	true
character_skills_localised_name_cha_skill_priest_back_militant	Militant	true
character_skills_localised_name_att_skill_background_general_taskmaster_nomadic	Taskmaster	true
character_skills_localised_description_cha_skill_back_vengeance	The single-minded quest for revenge drives man beyond the point of reason…	true
character_skills_localised_name_att_agent_skills_spy_surveillance	Surveillance	true
character_skills_localised_description_mk_skill_spy_eyes_and_ears	This man sees all, and hears all. He misses nothing.	true
character_skills_localised_description_att_skill_background_general_administrator_nomadic	This man's seal is respected throughout the world.	true
character_skills_localised_name_att_general_skill_sands_tanukhid_elephant	Imperial Fervour	true
character_skills_localised_description_cha_skill_back_watchman	He waits and watches. Every move is carefully considered.	true
character_skills_localised_name_cha_skill_assassin_fear	Fear	true
character_skills_localised_description_att_skill_background_priest_militarist_barbarian	Well, I suppose peace is AN option, but so is bloody dancing!	true
character_skills_localised_name_att_skill_background_spy_builder_roman	Fabricator	true
character_skills_localised_name_att_trad_navy_eastern_1_persian_naval_heritage	Eastern Naval Heritage	true
character_skills_localised_name_att_general_skills_nomadic_2_vanguard	Vanguard	true
character_skills_localised_description_att_agent_skills_spy_subterfuge	It's a messy business. Dirty hands are an occupational hazard.	true
character_skills_localised_description_mk_trad_navy_placed_shots	Timing, accuracy, resolve. Master all three and your shots will always fly true.	true
character_skills_localised_description_mk_trad_army_placed_shots	Timing, accuracy, resolve. Master all three and your shots will always fly true.	true
character_skills_localised_description_att_skill_background_champion_elite_roman	A trusted servant, this man has earned respect.	true
character_skills_localised_name_att_trad_army_nomadic_3_unconventional_warfare	Unconventional Warfare	true
character_skills_localised_description_att_skill_background_champion_marine_roman	Victory on land, victory on sea. Victory above all.	true
character_skills_localised_name_att_general_skills_roman_3_logistician	Logistician	true
character_skills_localised_name_att_skill_background_priest_accountant_eastern	Clerk	true
character_skills_localised_description_mk_skill_general_back_politician	What wars men fight on the battlefield must also be fought at the hearth.	true
character_skills_localised_name_att_skill_background_champion_war_hero_barbarian	War Hero	true
character_skills_localised_description_att_skill_background_general_leader_roman	Courage is not the absence of fear, but triumph over it.	true
character_skills_localised_name_att_skill_background_champion_watchman_barbarian	Sentinel	true
character_skills_localised_description_att_trad_army_eastern_3_ruin_rome	The vainglorious conquerors, laid low by the might of these men.	true
character_skills_localised_name_cha_trad_army_infantry_training	Militia Drilling	true
character_skills_localised_description_att_trad_army_nomadic_2_bane_east	Eastern cavalry are no match for the overpowering, thunderous horde.	true
character_skills_localised_name_att_skill_background_spy_hunter_eastern	Royal Archer	true
character_skills_localised_name_att_skill_background_champion_drillmaster_roman	Campidoctor	true
character_skills_localised_description_mk_skill_general_motivator	I believe in you. Don't believe in you, believe in ME who believes in you!	true
character_skills_localised_description_mk_trad_army_weak_spots	Any weakness, any chink in the armour, will be exploited by these men.	true
character_skills_localised_description_att_agent_skills_priest_damnation	They will choose salvation or the stake.	true
character_skills_localised_description_att_skill_background_general_taskmaster_eastern	No feat nor effort can truly please this man.	true
character_skills_localised_name_att_trad_army_nomadic_4_terror	Terror	true
character_skills_localised_description_att_skill_background_champion_war_hero_barbarian	This man lives for war. His time is done, his battles won, yet he remains.	true
character_skills_localised_name_mk_skill_general_back_politician	Politician	true
character_skills_localised_description_att_skill_background_champion_watchman_barbarian	He waits. That's what he does. 	true
character_skills_localised_name_cha_skill_general_back_taskmaster	Taskmaster	true
character_skills_localised_description_mk_skill_priest_back_elder	Honeyed words and wisdom make sweetness of intelligence.	true
character_skills_localised_name_cha_skill_priest_dogma	Dogma	true
character_skills_localised_description_mk_skill_spy_misdirection	A dropped coin, a broken vase. All that is needed is eyes to look elsewhere.	true
character_skills_localised_name_mk_skill_back_watchman	Watchman	true
character_skills_localised_description_att_skill_background_champion_standard_bearer_barbarian	The flag of a victorious, resplendent nation is raised proudly in this man's hands.	true
character_skills_localised_name_att_general_skills_nomadic_3_despoiler	Despoiler	true
character_skills_localised_name_att_skill_background_wife_all_ambitious	Ambitious	true
character_skills_localised_name_att_skill_background_wife_all_religious	Religious	true
character_skills_localised_name_att_trad_navy_roman_5_interdictor_fleet	Interdictor Fleet	true
character_skills_localised_name_att_skill_background_champion_assassin_eastern	Enforcer	true
character_skills_localised_name_att_skill_background_priest_militarist_barbarian	Warhawk	true
character_skills_localised_description_att_general_skills_eastern_2_infantry_commander	This man was born to lead others, marching at the head of a column.	true
character_skills_localised_description_att_agent_skills_priest_pessimism	With every step, you inch yourself closer to your inevitable demise!	true
character_skills_localised_name_att_general_skills_roman_3_overseer	Overseer	true
character_skills_localised_description_att_trad_army_eastern_5_keepers_fort	The empire may crumble, the world may burn, but by God this fort will stand!	true
character_skills_localised_name_att_agent_skills_spy_misdirection	Misdirection	true
character_skills_localised_name_mk_skill_priest_pessimism	Pessimism	true
character_skills_localised_name_att_skill_background_general_scholar_barbarian	Sage	true
character_skills_localised_name_cha_skill_back_vengeance	Vengeance	true
character_skills_localised_name_att_skill_background_priest_militarist_nomadic	Warhawk	true
character_skills_localised_name_cha_trad_army_supplies	Supplies	true
character_skills_localised_description_att_trad_navy_roman_1_mediterranean_seamanship	They're hardly ever sick at sea.	true
character_skills_localised_description_att_skill_background_champion_aide_camp_barbarian	This man worked his way up over many years, inspiring greatness as he aspires to greatness.	true
character_skills_localised_name_att_skill_background_wife_civilised_unfaithful	Unfaithful	true
character_skills_localised_description_att_skill_background_spy_hunter_nomadic	They hunt so that they do not become the hunted themselves…	true
character_skills_localised_name_cha_skill_assassin_terror	Terror	true
character_skills_localised_name_mk_skill_priest_eyes_ears	Eyes & Ears	true
character_skills_localised_name_att_trad_army_eastern_1_persian_marksmanship	Persian Marksmanship	true
character_skills_localised_description_att_trad_army_barbarian_2_hunters	Keep quiet. Draw the bow. Breathe. Shoot.	true
character_skills_localised_name_att_agent_skills_champion_sapping	Sapping	true
character_skills_localised_name_mk_skill_priest_damnation	Damnation	true
character_skills_localised_name_mk_trad_navy_weak_spots	Weak Spots	true
character_skills_localised_name_att_skill_background_spy_artisan_roman	Artitianus	true
character_skills_localised_name_att_skill_background_priest_benefactor_nomadic	Steward	true
character_skills_localised_name_att_skill_background_wife_barbarian_shieldmaid	Shieldmaiden	true
character_skills_localised_description_mk_skill_priest_back_progressive	Stay on the cliff too long and you'll be washed away.	true
character_skills_localised_description_att_skill_background_champion_officer_barbarian	Leaders of men. Warriors. Covered in blood, battle and glory.	true
character_skills_localised_description_mk_skill_priest_practice	It takes 10,000 hours to master something, they say. You better get started.	true
character_skills_localised_name_cha_skill_general_builder	Builder	true
character_skills_localised_description_att_skill_background_spy_spymaster_eastern	This man sees all, and hears all. He misses nothing.	true
character_skills_localised_description_mk_skill_assassin_thugs	Getting others to do things for you is a skill in its own right.	true
character_skills_localised_name_att_general_skills_nomadic_3_warchief	Warchief	true
character_skills_localised_description_att_trad_army_roman_5_palatini	In defence of Rome, in defence of its ruler!	true
character_skills_localised_description_att_skill_background_general_politician_nomadic	That's how you devour a whale; one bite at a time.	true
character_skills_localised_description_att_skill_background_general_landowner_barbarian	Ah, it's good to own land.	true
character_skills_localised_description_att_agent_skills_priest_mystery	A conundrum, wrapped in a puzzle, shrouded in secrecy.	true
character_skills_localised_name_att_skill_background_champion_engineer_nomadic	Builder	true
character_skills_localised_name_att_skill_background_general_entrepreneur_eastern	Magnate	true
character_skills_localised_name_att_skill_background_champion_horse_vet_barbarian	Groom	true
character_skills_localised_name_mk_trad_navy_bombardment	Bombardment	true
character_skills_localised_name_mk_trad_army_marksman_training	Marksmen	true
character_skills_localised_name_att_skill_background_general_strategist_nomadic	Master Planner	true
character_skills_localised_description_mk_skill_priest_rhetoric	Words have power. They offer the means to a meaning.	true
character_skills_localised_description_att_skill_background_champion_assassin_barbarian	I will be your champion.	true
character_skills_localised_description_mk_skill_general_commander	Follow, men, and I will lead you to everlasting glory!	true
character_skills_localised_name_att_trad_army_eastern_2_conscription	Conscription	true
character_skills_localised_name_att_skill_background_priest_advisor_roman	Consiliarius	true
character_skills_localised_name_att_agent_skills_champion_tactics	Tactics	true
character_skills_localised_name_cha_trad_navy_weak_spots	Weak Spots	true
character_skills_localised_name_att_skill_background_wife_all_poisoner	Poisoner	true
character_skills_localised_description_cha_skill_assassin_misdirection	A dropped coin, a broken vase. All that is needed is eyes to look elsewhere.	true
character_skills_localised_description_mk_skill_general_thinker	A sharp mind is at least as useful as a sharp sword.	true
character_skills_localised_name_att_skill_background_champion_war_hero_nomadic	War Hero	true
character_skills_localised_description_mk_skill_spy_local_agents	The right contacts in the right place, and at the right time, can make all the difference.	true
character_skills_localised_name_att_general_skills_roman_5_vir_illustris	Vir Illustris	true
character_skills_localised_description_att_trad_army_roman_5_defenders_virtue	Honour requires satisfaction. This satisfaction will be had, by force.	true
character_skills_localised_description_att_agent_skills_spy_corruption	One for me, none for you.	true
character_skills_localised_name_att_skill_background_priest_progressive_nomadic	Progressive	true
character_skills_localised_name_att_skill_background_champion_watchman_eastern	Watchman	true
character_skills_localised_description_att_skill_background_priest_accountant_barbarian	A man with a gift for numbers is valuable amongst a crowd of warmongers.	true
character_skills_localised_name_att_trad_army_nomadic_3_defenders_camp	Defenders of the Camp	true
character_skills_localised_name_mk_skill_back_vengeance	Vengeance	true
character_skills_localised_description_mk_skill_general_back_landowner	He has found favour by an oath of vassalage, and his loyalty to it.	true
character_skills_localised_description_att_skill_background_spy_informant_roman	You're actually working for us but they think you're working for them? This espionage business is terribly confusing…	true
character_skills_localised_description_att_skill_background_priest_elder_nomadic	Honeyed words and wisdom make sweetness of intelligence.	true
character_skills_localised_description_att_skill_background_spy_spymaster_roman	This man sees all, and hears all. He misses nothing.	true
character_skills_localised_description_att_skill_background_champion_medic_roman	Physician, heal thyself.	true
character_skills_localised_name_att_general_skills_roman_2_sentinel	Sentinel	true
character_skills_localised_name_att_skill_background_priest_scholar_roman	Scholaris	true
character_skills_localised_name_att_skill_background_champion_drillmaster_eastern	Drillmaster	true
character_skills_localised_name_att_general_skills_roman_2_dux	Dux	true
character_skills_localised_name_att_skill_background_spy_informant_roman	Proditor	true
character_skills_localised_name_att_skill_background_spy_spymaster_roman	Agens in Rebus	true
character_skills_localised_description_att_agent_skills_priest_prejudice	An evil, unnatural demon must be damned and destroyed.	true
character_skills_localised_description_att_skill_background_general_strategist_eastern	Every possibility accounted for, every breath explained.	true
character_skills_localised_name_att_skill_background_priest_accountant_barbarian	Chamberlain	true
character_skills_localised_name_att_skill_background_wife_civilised_protective	Protective	true
character_skills_localised_description_att_general_skills_roman_4_vanguard	Look to the fore, at the head of the charge; you will doubtless find this man.	true
character_skills_localised_name_cha_skill_general_back_strategist	Strategist	true
character_skills_localised_name_cha_skill_general_inspired_leader	Inspired Leader	true
character_skills_localised_description_cha_skill_spy_black_market	What cannot be found by normal means can surely be… 'acquired' another way...	true
character_skills_localised_description_att_trad_army_eastern_2_conscription	The empire does not require you to think, it requires you to fight.	true
character_skills_localised_name_att_skill_background_wife_all_intelligent	Intelligent	true
character_skills_localised_description_att_general_skills_roman_5_vir_illustris	Do you know who I am!?	true
character_skills_localised_name_att_skill_background_general_handler_barbarian	Mentor	true
character_skills_localised_name_mk_skill_assassin_misdirection	Misdirection	true
character_skills_localised_name_mk_skill_general_thinker	Thinker	true
character_skills_localised_description_att_skill_background_champion_scout_roman	The road ahead is shrouded in darkness. I am the light.	true
character_skills_localised_name_att_trad_army_barbarian_1_wardens_tribe	Wardens of the Tribe	true
character_skills_localised_name_att_skill_background_general_politician_eastern	Political Animal	true
character_skills_localised_description_cha_trad_navy_weak_spots	Any weakness, any chink in the armour, will be exploited by these men.	true
character_skills_localised_description_att_skill_background_champion_quartermaster_roman	The matter of procurement, and suitable equipment, is this man's expertise.	true
character_skills_localised_description_att_skill_background_wife_barbarian_superstitious	Spells I have cast against your enemies, husband. Terrible spells...	true
character_skills_localised_description_cha_trad_army_block_parry	Blocking keeps you alive a moment longer. Parrying exposes, buying you opportunity.	true
character_skills_localised_description_att_general_skills_barbarian_1_wolf	Reading the ground, stalking, with the scent of prey and the taste of blood.	true
character_skills_localised_description_att_skill_background_spy_racketeer_eastern	I'm gonna make him an offer he can't refuse.	true
character_skills_localised_name_att_skill_background_champion_assassin_barbarian	Brute	true
character_skills_localised_description_cha_trad_army_marksman_training	You know how to fight six men. We can teach you how to engage six hundred.	true
character_skills_localised_description_att_skill_background_champion_team_sports_roman	Faster. Higher. Stronger.	true
character_skills_localised_name_mk_skill_priest_rhetoric	Rhetoric	true
character_skills_localised_name_cha_skill_priest_belief	Belief	true
character_skills_localised_name_cha_trad_army_ferocious	Ferocious	true
character_skills_localised_description_mk_trad_navy_bombardment	The fire rains from above, like a fury from heaven, to smite the undeserving.	true
character_skills_localised_name_cha_skill_general_trainer	Trainer	true
character_skills_localised_name_mk_skill_priest_prejudice	Prejudice	true
character_skills_localised_description_mk_skill_general_back_entrepeneur	Pull yourself up by the sandal straps. Face the day. Then seize it.	true
character_skills_localised_name_att_skill_background_general_landowner_barbarian	Lord	true
character_skills_localised_name_att_general_skills_nomadic_4_overlord	Overlord	true
character_skills_localised_description_att_skill_background_general_politician_barbarian	That's how you devour a whale; one bite at a time.	true
character_skills_localised_description_att_skill_background_priest_progressive_eastern	Stay on the cliff too long and you'll be washed away.	true
character_skills_localised_description_att_general_skills_eastern_3_elephant_commander	Into the fray, my thunderous beauties! Crush our enemies beneath you!	true
character_skills_localised_name_att_trad_navy_eastern_3_pirate_hunters	Pirate Hunters	true
character_skills_localised_name_att_trad_army_nomadic_4_steppe_warfare	Steppe Warfare	true
character_skills_localised_name_mk_skill_spy_misdirection	Misdirection	true
character_skills_localised_description_att_skill_background_spy_agriculture_roman	Some animals are more equal than others.	true
character_skills_localised_name_att_agent_skills_priest_pessimism	Pessimism	true
character_skills_localised_name_cha_trad_navy_navigation	Navigation	true
character_skills_localised_description_cha_skill_general_back_taskmaster	No feat nor effort can truly please this man.	true
character_skills_localised_description_att_trad_army_roman_3_bane_east	The claimants to Parthian power will fall before us!	true
character_skills_localised_description_mk_trad_navy_seamanship	The greatest of swells and the roughest of storms are no more than a flutter to these sailors.	true
character_skills_localised_name_mk_skill_spy_subterfuge	Subterfuge	true
character_skills_localised_description_att_trad_army_roman_2_civil_duty	Every man should feel compelled to aid his state.	true
character_skills_localised_name_att_agent_skills_priest_damnation	Damnation	true
character_skills_localised_description_att_trad_army_nomadic_5_royal_host	The terrible horde is led by one man. They fight in his name.	true
character_skills_localised_description_cha_skill_general_back_merchant	This man cares little for nation, allegiance or creed. Only for coin.	true
character_skills_localised_name_att_skill_background_spy_artisan_eastern	Hutokhsh	true
character_skills_localised_name_att_general_skills_eastern_4_strategist	Strategist	true
character_skills_localised_name_att_trad_army_eastern_5_army_immortals	Warrior Elite	true
character_skills_localised_name_cha_skill_general_back_warrior	Warrior	true
character_skills_localised_name_att_agent_skills_spy_observation	Observation	true
character_skills_localised_name_att_skill_background_general_landowner_nomadic	Herder	true
character_skills_localised_name_mk_skill_spy_determined	Determined	true
character_skills_localised_description_cha_skill_assassin_terror	No man is safe. Everyone is a target.	true
character_skills_localised_name_mk_skill_general_zealot	Zealot	true
character_skills_localised_description_mk_skill_priest_eyes_ears	This man sees all, and hears all. He misses nothing.	true
character_skills_localised_name_att_skill_background_spy_builder_eastern	Builder	true
character_skills_localised_name_att_trad_army_barbarian_3_nomad_hunters	Nomad Hunters	true
character_skills_localised_description_att_skill_background_general_merchant_barbarian	This man cares little for nation, allegiance or creed. Only for coin.	true
character_skills_localised_name_att_trad_army_barbarian_2_hunters	Hunters	true
character_skills_localised_name_att_trad_army_roman_1_limatinei	Limitanei	true
character_skills_localised_description_att_skill_background_priest_radical_barbarian_barbarian	The status-quo is stagnation, and stagnation is the enemy.	true
character_skills_localised_description_mk_skill_priest_damnation	They will choose salvation or the stake.	true
character_skills_localised_description_att_agent_skills_champion_sapping	A wall is just another obstacle for this man to undermine.	true
character_skills_localised_name_att_skill_background_champion_horse_vet_nomadic	Horsebreaker	true
character_skills_localised_name_att_trad_army_roman_3_comitatenses	Comitatenses	true
character_skills_localised_name_att_trad_army_roman_4_military_engineering	Military Engineering	true
character_skills_localised_description_att_agent_skills_priest_imposition	Do you have a moment to talk about…	true
character_skills_localised_name_att_skill_background_champion_aide_camp_barbarian	Military Advisor	true
character_skills_localised_name_cha_skill_assassin_opportunism	Opportunism	true
character_skills_localised_description_att_agent_skills_spy_misdirection	A dropped coin, a broken vase. All that is needed is eyes to look elsewhere.	true
character_skills_localised_description_mk_skill_priest_pessimism	With every step man inches closer to his inevitable demise!	true
character_skills_localised_description_bel_trad_navy_roman_2_defending	“If you can keep your balance, when all around are losing theirs…”	true
character_skills_localised_name_att_agent_skills_priest_rhetoric	Rhetoric	true
character_skills_localised_name_att_general_skills_eastern_3_cavalry_commander	Cavalry Commander	true
character_skills_localised_name_mk_skill_spy_surveillance	Surveillance	true
character_skills_localised_description_mk_skill_priest_back_strategist	In victory, this man takes all the credit. In defeat, silence. That is strategy.	true
character_skills_localised_name_att_skill_background_priest_scribe_barbarian_barbarian	Scribe	true
character_skills_localised_description_att_agent_skills_priest_rhetoric	Words have power. They offer the means to a meaning.	true
character_skills_localised_name_cha_skill_spy_back_mole	Mole	true
character_skills_localised_description_att_agent_skills_champion_personal_combat	We could engage each other in unarmed combat. Then I would snap your spine.	true
character_skills_localised_description_att_skill_background_champion_team_sports_nomadic	Faster. Higher. Stronger.	true
character_skills_localised_name_att_skill_background_general_taskmaster_barbarian	Taskmaster	true
character_skills_localised_description_mk_skill_assassin_practice	It takes 10,000 hours to master something, they say. You better get started.	true
character_skills_localised_description_mk_skill_general_legend	This man became history. History became legend. Legend becomes myth.	true
character_skills_localised_name_att_agent_skills_spy_diversion	Diversion	true
character_skills_localised_name_att_trad_army_barbarian_3_dreaded_reavers	Dreaded Reavers	true
character_skills_localised_description_att_skill_background_spy_builder_eastern	One brick follows another. The greatest buildings start with the smallest objects.	true
character_skills_localised_description_att_skill_background_general_attacker_barbarian	Renowned for dogmatic belligerence, this man will not stop until his enemies are trampled beneath him.	true
character_skills_localised_description_att_agent_skills_spy_observation	The shift changes twice a day. There is a five-minute window. That's when I strike.	true
character_skills_localised_name_att_skill_background_general_leader_roman	Leader	true
character_skills_localised_name_att_trad_army_eastern_3_ruin_rome	Ruin of Rome	true
character_skills_localised_name_att_trad_army_nomadic_2_bane_east	Bane of the East	true
character_skills_localised_description_att_skill_background_priest_public_speaker_eastern	Friends, brothers, countrymen! Lend me your ears!	true
character_skills_localised_description_att_skill_background_wife_all_great_beauty	Beauty is a blessing in an ugly world.	true
character_skills_localised_description_att_skill_background_champion_martial_arts_eastern	Okay, I want a good clean fight. No kicks in the tassets.	true
character_skills_localised_name_mk_skill_general_back_merchant	Merchant	true
character_skills_localised_description_att_skill_background_spy_artisan_eastern	My hands are my tools; with them I create great and beautiful things.	true
character_skills_localised_description_att_skill_background_wife_civilised_social_climber	You get over there and you say something NICE to HIS wife! Ingratiate yourself, fool!	true
character_skills_localised_description_att_trad_army_nomadic_2_foreign_contingent	These men are not native to our lands, but fight with our fervour all the same.	true
character_skills_localised_description_att_general_skills_nomadic_2_vanguard	At the head of the charge, sword in hand, shouting for glory; he is there.	true
character_skills_localised_name_mk_trad_navy_placed_shots	True Aim	true
character_skills_localised_name_mk_trad_army_placed_shots	True Aim	true
character_skills_localised_name_att_skill_background_champion_elite_roman	Domesticus	true
character_skills_localised_description_att_skill_background_wife_all_harridan_nag	Mother always said I was too good for you. Poor mother…	true
character_skills_localised_description_att_trad_navy_eastern_4_naval_marksmanship	On the rolling waves, the ability to hold one's aim is valuable indeed.	true
character_skills_localised_description_att_agent_skills_spy_surveillance	Watch. Wait. See. Then act.	true
character_skills_localised_name_att_trad_army_roman_2_civil_duty	Civil Duty	true
character_skills_localised_description_mk_skill_priest_justice	In the sight of man and all that is holy, you stand accused!	true
character_skills_localised_description_att_general_skill_sands_tanukhid_elephant	Unwavering, unflinching, and loyal to the last, this man's integrity is way beyond doubt.	true
character_skills_localised_description_att_skill_background_champion_horse_vet_eastern	Open wide and say 'neigh'.	true
character_skills_localised_description_bel_trad_navy_roman_4_attacking	Surprise is half the battle. The other half is sheer gumption.	true
character_skills_localised_name_cha_skill_spy_smuggler	Smuggler	true
character_skills_localised_description_cha_trad_navy_navigation	The straight line between A and B is not always the best option.	true
character_skills_localised_description_mk_skill_priest_conviction	Dark and sinister man, have at thee!	true
character_skills_localised_description_mk_skill_assassin_training	Discipline, strength, skill. Mastery of these brings victory.	true
character_skills_localised_description_att_skill_background_priest_scribe_eastern_eastern	The written word, though unintelligible to most, is the history of the world laid down.	true
character_skills_localised_description_att_skill_background_priest_scribe_nomadic_nomadic	The written word, though unintelligible to most, is the history of the world laid down.	true
character_skills_localised_name_att_skill_background_champion_scout_roman	Explorator	true
character_skills_localised_name_cha_trad_army_block_parry	Block & Parry	true
character_skills_localised_name_att_skill_background_champion_quartermaster_roman	Armicustos	true
character_skills_localised_name_att_skill_background_wife_barbarian_superstitious	Superstitious	true
character_skills_localised_description_cha_skill_general_back_strategist	Knowing when to attack, when to defend, and when to utterly destroy. That is strategy.	true
character_skills_localised_description_cha_skill_general_inspired_leader	Ah, well; who wants to live forever? 	true
character_skills_localised_description_att_skill_background_wife_all_intelligent	We can turn this to advantage, my love. Just let me think…	true
character_skills_localised_description_cha_skill_general_zealot	This man sees only the goal, the final desire. He will pursue it endlessly.	true
character_skills_localised_description_att_skill_background_wife_civilised_spendthrift	What do you mean? Of course it's your money. You're in charge! Really! Men!	true
character_skills_localised_description_cha_skill_spy_determined	To strive, to seek, to find, and not to yield.	true
character_skills_localised_name_att_agent_skills_priest_prejudice	Prejudice	true
character_skills_localised_description_att_general_skills_barbarian_3_despoiler	No inch of land, nor acre of property, is safe from his irascible greed.	true
character_skills_localised_name_mk_skill_general_back_marksman	Marksman	true
character_skills_localised_name_att_skill_background_champion_aide_camp_eastern	Aide-de-Camp	true
character_skills_localised_description_att_skill_background_champion_drillmaster_eastern	You will listen, and you will learn, or you will die.	true
character_skills_localised_description_att_skill_background_priest_scholar_roman	Stay a while and listen.	true
character_skills_localised_description_att_agent_skills_spy_opportunism	When the cat's away, the mice will probably kill someone.	true
character_skills_localised_name_att_skill_background_general_marksman_barbarian	Marksman	true
character_skills_localised_name_mk_skill_assassin_back_extortion	Extortion	true
character_skills_localised_name_mk_skill_general_back_entrepeneur	Entrepeneur	true
character_skills_localised_description_att_general_skills_nomadic_4_overlord	Not only was he born to command, but he likes it. It suits him.	true
character_skills_localised_name_att_skill_background_general_politician_barbarian	Powermonger	true
character_skills_localised_description_att_skill_background_general_warrior_roman	I move for no man.	true
character_skills_localised_description_cha_skill_general_trainer	It is the duty of the man who knows to teach the man who does not.	true
character_skills_localised_description_att_skill_background_spy_courier_nomadic	Fleet of foot and swift of tongue.	true
character_skills_localised_description_cha_skill_spy_subterfuge	It's a messy business. Dirty hands are an occupational hazard.	true
character_skills_localised_description_mk_skill_priest_prejudice	The unnatural, the evil - the demonic - must be rooted out.	true
character_skills_localised_name_att_trad_army_barbarian_5_furor_barbaricus	Furor Barbaricus	true
character_skills_localised_name_mk_skill_general_back_attacker	Attacker	true
character_skills_localised_description_att_trad_navy_barbarian_4_ship_warriors	Once the breach is crossed, these men are dealers in chaos and death.	true
character_skills_localised_name_att_trad_navy_roman_4_destroyers	Destroyers	true
character_skills_localised_description_att_skill_background_general_entrepreneur_roman	The world finds important whatever this man deems to be important.	true
character_skills_localised_description_att_trad_navy_eastern_3_merchant_allies	Money is more powerful than any sword.	true
character_skills_localised_description_att_skill_background_general_entrepreneur_eastern	The world finds important whatever this man deems to be important.	true
character_skills_localised_description_cha_skill_general_back_attacker	This man knows only the endless charge, the relentless push of battle.	true
character_skills_localised_description_att_skill_background_champion_aide_camp_nomadic	This man worked his way up over many years, inspiring greatness as he aspires to greatness.	true
character_skills_localised_description_att_trad_navy_roman_4_destroyers	Nothing stands against us. Send them to the deep!	true
character_skills_localised_name_att_trad_army_roman_1_logistics	Logistics	true
character_skills_localised_description_att_skill_background_champion_horse_vet_barbarian	Open wide and say 'neigh'.	true
character_skills_localised_name_att_skill_background_priest_radical_roman_roman	Radical	true
character_skills_localised_description_att_skill_background_spy_mole_barbarian	A man in the right places, hearing the right things, is more valuable than a thousand swordsmen.	true
character_skills_localised_description_att_general_skills_nomadic_3_warchief	Battle is in this man's blood - it drives him to greatness.	true
character_skills_localised_description_att_skill_background_spy_courier_barbarian	Fleet of foot and swift of tongue.	true
character_skills_localised_description_mk_skill_assassin_coercion	What good is a missive if you are unable to speak?	true
character_skills_localised_name_cha_skill_spy_subterfuge	Subterfuge	true
character_skills_localised_description_cha_skill_general_builder	One brick follows another. The greatest buildings start with the smallest objects.	true
character_skills_localised_name_att_skill_background_spy_courier_nomadic	Courier	true
character_skills_localised_name_mk_trad_navy_navigation	Navigation	true
character_skills_localised_description_att_skill_background_general_defender_barbarian	A wall, upon which enemies crash in multitudes and are dashed and broken.	true
character_skills_localised_name_cha_skill_general_back_scholar	Scholar	true
character_skills_localised_name_att_general_skills_barbarian_3_fleet_commander	Fleet Commander	true
character_skills_localised_name_att_skill_background_priest_elder_nomadic	Elder	true
character_skills_localised_name_att_skill_background_champion_medic_roman	Medicus	true
character_skills_localised_name_cha_skill_general_back_defender	Defender	true
character_skills_localised_description_mk_skill_assassin_back_extortion	My friend had five fingers. He only used three.	true
character_skills_localised_description_cha_skill_general_back_marksman	Through fire, and wind, and death, his shot flies true to its target every time.	true
character_skills_localised_name_att_agent_skills_spy_opportunism	Opportunism	true
character_skills_localised_description_att_agent_skills_champion_glory	They shall cover themselves in gore, and blood and, ultimately, victory.	true
character_skills_localised_name_att_general_skills_barbarian_3_despoiler	Despoiler	true
character_skills_localised_name_att_trad_navy_barbarian_3_cuthroat_raiders	Cutthroat Raiders	true
character_skills_localised_name_mk_skill_spy_local_agents	Local Agents	true
character_skills_localised_description_att_skill_background_spy_conspirator_roman	Chicanery, machinations and a fair deal of skulduggery.	true
character_skills_localised_name_cha_skill_general_zealot	Zealot	true
character_skills_localised_name_cha_skill_spy_determined	Determined	true
character_skills_localised_description_att_trad_navy_roman_2_bane_east	Eastern navies are shiny, but they rightly fear Roman power.	true
character_skills_localised_description_att_skill_background_priest_advisor_roman	What his lord dreams, this man will build.	true
character_skills_localised_name_att_skill_background_priest_elder_roman	Senator	true
character_skills_localised_description_att_agent_skills_champion_tactics	There is a right way to deal with this, and a less right way…	true
character_skills_localised_name_att_skill_background_spy_hunter_barbarian	Hunter	true
character_skills_localised_name_att_skill_background_general_strategist_barbarian	Master Planner	true
character_skills_localised_name_mk_skill_spy_black_market	Black Market	true
character_skills_localised_name_att_trad_army_nomadic_2_extortion	Extortion	true
character_skills_localised_name_mk_trad_navy_seamanship	Seamanship	true
character_skills_localised_description_cha_skill_general_thinker	A sharp mind is at least as useful as a sharp sword.	true
character_skills_localised_name_att_trad_army_roman_3_bane_east	Bane of the East	true
character_skills_localised_name_mk_trad_army_block_parry	Block & Parry	true
character_skills_localised_description_mk_skill_spy_subterfuge	It's a messy business. Dirty hands are an occupational hazard.	true
character_skills_localised_description_att_skill_background_priest_progressive_barbarian	Stay on the cliff too long and you'll be washed away.	true
character_skills_localised_description_att_skill_background_spy_builder_nomadic	One brick follows another. The greatest buildings start with the smallest objects.	true
character_skills_localised_description_att_general_skills_eastern_3_logistician	Food in mouths, and armour on bodies, is what concerns this man.	true
character_skills_localised_description_att_general_skills_eastern_2_overseer	In his mind, he sees the greater picture sprawled before him, and understands it.	true
character_skills_localised_description_mk_trad_army_dread	The chill that the enemy feels when they see these men approaching is entirely justified.	true
character_skills_localised_description_mk_trad_army_loyal	Not a man here would dissent. They go with their commander to death and glory, then beyond.	true
character_skills_localised_description_att_general_skills_eastern_4_judge	The arbiter of judiciary dispensation, provided with absolute authority.	true
character_skills_localised_name_cha_skill_assassin_back_extortion	Extortion	true
character_skills_localised_name_cha_skill_general_back_merchant	Merchant	true
character_skills_localised_name_att_general_skills_eastern_3_archer_commander	Archer Commander	true
character_skills_localised_description_att_general_skills_eastern_4_strategist	Knowing when to attack, when to defend, and when to utterly destroy. That is strategy.	true
character_skills_localised_name_att_skill_background_priest_spiritual_leader_barbarian	Spiritual Leader	true
character_skills_localised_description_att_skill_background_champion_team_sports_eastern	Faster. Higher. Stronger.	true
character_skills_localised_description_att_general_skills_eastern_1_shahrdar	The blood in this man's veins is of royal stock; noble and leaderly.	true
character_skills_localised_description_cha_skill_priest_prejudice	The unnatural, the evil - the demonic - must be rooted out.	true
character_skills_localised_description_att_skill_background_priest_public_speaker_roman	Friends, Romans, countrymen! Lend me your ears!	true
character_skills_localised_description_mk_skill_spy_determined	To strive, to seek, to find, and not to yield.	true
character_skills_localised_description_mk_skill_general_zealot	This man sees only the goal, the final desire. He will pursue it endlessly.	true
character_skills_localised_name_att_skill_background_general_merchant_barbarian	Merchant	true
character_skills_localised_description_att_trad_army_barbarian_3_nomad_hunters	A mulch of galloping ponies, nothing more.	true
character_skills_localised_name_att_skill_background_wife_roman_decorous	Decorous	true
character_skills_localised_name_att_skill_background_champion_marine_barbarian	Sea-Rover	true
character_skills_localised_name_att_skill_background_priest_radical_barbarian_barbarian	Radical	true
character_skills_localised_name_cha_skill_spy_sabotage	Sabotage	true
character_skills_localised_description_att_trad_army_roman_1_limatinei	A man will always fight for his home. He may as well make it his duty.	true
character_skills_localised_name_att_skill_background_wife_civilised_mean	Mean	true
character_skills_localised_description_att_skill_background_champion_horse_vet_nomadic	Open wide and say 'neigh'.	true
character_skills_localised_name_att_trad_navy_barbarian_1_naval_expedition	Naval Expedition	true
character_skills_localised_name_att_skill_background_general_patron_roman	Patron	true
character_skills_localised_name_att_trad_army_nomadic_4_ruin_rome	Ruin of Rome	true
character_skills_localised_description_att_agent_skills_priest_conviction	Dark and sinister man, have at thee!	true
character_skills_localised_description_att_skill_background_champion_martial_arts_nomadic	Okay, I want a good clean fight. No kicks in the tassets.	true
character_skills_localised_description_att_skill_background_spy_builder_barbarian	One brick follows another. The greatest buildings start with the smallest objects.	true
character_skills_localised_description_att_skill_background_priest_public_speaker_nomadic	Friends, brothers, countrymen! Lend me your ears!	true
character_skills_localised_description_att_skill_background_priest_strategy_gaming_roman	A good player is not one who is five moves ahead, but who has won from the first.	true
character_skills_localised_description_att_trad_navy_roman_3_blockaders	Intensify the forward firepower, I don't want anything to get through!	true
character_skills_localised_name_mk_skill_spy_back_mole	Mole	true
character_skills_localised_name_att_general_skill_sands_elephant	Desert Power	true
character_skills_localised_name_att_agent_skills_champion_terror	Terror	true
character_skills_localised_name_att_skill_background_wife_civilised_sharp_tongue	Acid Tongue	true
character_skills_localised_name_bel_trad_navy_roman_2_defending	Naval Defenders	true
character_skills_localised_description_cha_skill_priest_rhetoric	Words have power. They offer the means to a meaning.	true
character_skills_localised_description_att_skill_background_spy_artisan_nomadic	My hands are my tools; with them I create great and beautiful things.	true
character_skills_localised_description_mk_skill_back_cat_reflexes	The agility of a leopard; the power of a lion.	true
character_skills_localised_name_mk_skill_priest_back_strategist	Strategist	true
character_skills_localised_name_att_skill_background_spy_artisan_nomadic	Artisan	true
character_skills_localised_description_att_skill_background_wife_civilised_sharp_tongue	He may be a general, but he's still an indolent, pathetic, little, horse-dung excuse of a man.	true
character_skills_localised_description_cha_skill_spy_back_mole	Being in the right place, at the right time - hearing the right things - is of greater value than a thousand swordsmen.	true
character_skills_localised_description_att_general_skill_sands_elephant	When the situation is desperate, this man's tribal connections serve him well.	true
character_skills_localised_description_att_agent_skills_champion_terror	No man is safe. Everyone is a target.	true
character_skills_localised_name_att_trad_navy_roman_3_blockaders	Blockaders	true
character_skills_localised_description_cha_trad_navy_bombardment	The fire rains from above, like a fury from heaven, to smite the undeserving.	true
character_skills_localised_name_att_skill_background_wife_roman_well_connected	Well Connected	true
character_skills_localised_description_mk_trad_army_steady_troops	Hold firm, lads, and we'll live to see this day end!	true
character_skills_localised_description_att_agent_skills_champion_sabotage	Sabotage is art. The art of spoiling the enemy's plans.	true
character_skills_localised_description_att_skill_background_wife_civilised_mean	Your men do not need new boots. They had some three years ago. Are they eating the things?	true
character_skills_localised_name_mk_skill_general_legend	Legend	true
character_skills_localised_description_att_skill_background_wife_roman_decorous	Husband, home, hearth. What more need there be for a lady?	true
character_skills_localised_name_att_skill_background_priest_public_speaker_roman	Orator	true
character_skills_localised_name_cha_skill_spy_practice	Practice	true
character_skills_localised_name_att_skill_background_general_attacker_barbarian	Relentless Attacker	true
character_skills_localised_name_bel_trad_army_roman_2_home_defence	Home Fires	true
character_skills_localised_description_att_general_skills_eastern_5_zhayedan	Only the finest warrior may lead the elite.	true
character_skills_localised_description_att_agent_skills_priest_admonition	Strong words sometimes cut deeper than a blade. Not often, but sometimes.	true
character_skills_localised_description_att_skill_background_spy_artisan_barbarian	My hands are my tools; with them I create great and beautiful things.	true
character_skills_localised_name_att_general_skills_eastern_3_logistician	Logistician	true
character_skills_localised_name_att_general_skills_nomadic_3_cavalry_commander	Cavalry Commander	true
character_skills_localised_name_att_skill_background_general_supply_roman	Logistics Expert	true
character_skills_localised_description_att_skill_background_general_scholar_roman	Books are the mightiest weapon in the war against ignorance.	true
character_skills_localised_name_cha_skill_assassin_back_legend	Legend	true
character_skills_localised_name_att_skill_background_spy_builder_nomadic	Builder	true
character_skills_localised_name_mk_skill_priest_justice	Justice	true
character_skills_localised_name_att_skill_background_general_landowner_eastern	Landowner	true
character_skills_localised_name_cha_skill_spy_arsonist	Arsonist	true
character_skills_localised_description_mk_trad_army_block_parry	Blocking keeps you alive a moment longer. Parrying exposes, buying you opportunity.	true
character_skills_localised_name_bel_trad_navy_roman_4_attacking	Naval Attackers	true
character_skills_localised_name_att_skill_background_champion_horse_vet_eastern	Stor Bezashk	true
character_skills_localised_name_att_skill_background_spy_courier_eastern	Barid	true
character_skills_localised_name_cha_skill_general_legend	Legend	true
character_skills_localised_description_att_general_skills_barbarian_celts_ollam	If the job is worth doing, get the right man for it.	true
character_skills_localised_name_cha_skill_general_sweet_talker	Sweet Talker	true
character_skills_localised_name_att_skill_background_wife_civilised_spendthrift	Spendthrift	true
character_skills_localised_name_cha_skill_spy_tracking	Tracking	true
character_skills_localised_description_att_general_skills_barbarian_celts_brethid	In the Gaelic world, this man's word is law.	true
character_skills_localised_description_att_trad_navy_eastern_5_pride_east	Wherever this fleet sails, they do their king proud.	true
character_skills_localised_name_mk_skill_general_back_defender	Defender	true
character_skills_localised_name_cha_skill_priest_back_strategist	Strategist	true
character_skills_localised_description_att_skill_background_general_entrepreneur_nomadic	The world finds important whatever this man deems to be important.	true
character_skills_localised_description_att_skill_background_champion_aide_camp_eastern	This man worked his way up over many years, inspiring greatness as he aspires to greatness.	true
character_skills_localised_description_cha_skill_general_back_politician	What wars men fight on the battlefield must also be fought at the hearth.	true
character_skills_localised_description_att_skill_background_general_marksman_barbarian	Through fire, and wind, and death, his shot flies true to its target every time.	true
character_skills_localised_description_cha_skill_priest_eyes_ears	This man sees all, and hears all. He misses nothing.	true
character_skills_localised_description_att_trad_army_barbarian_3_champions_north	These men gained glory in the northlands; strong and redoubtable.	true
character_skills_localised_description_cha_skill_priest_damnation	They will choose salvation or the stake.	true
character_skills_localised_name_cha_skill_priest_justice	Justice	true
character_skills_localised_description_att_general_skills_roman_1_legatus	Commander of an army, appointed by the ruler himself.	true
character_skills_localised_name_att_skill_background_priest_scribe_roman_roman	Scriniarius	true
character_skills_localised_description_cha_trad_navy_seamanship	The greatest of swells and the roughest of storms are no more than a flutter to these sailors.	true
character_skills_localised_description_mk_trad_army_siege_experts	Whether breaking down walls, or holding out behind them, these men are versed in the skills needed to endure and rise.	true
character_skills_localised_description_cha_skill_priest_pessimism	With every step man inches closer to his inevitable demise!	true
character_skills_localised_name_att_skill_background_priest_elder_eastern	Wuzurgan	true
character_skills_localised_name_att_general_skills_nomadic_3_archer_commander	Archer Commander	true
character_skills_localised_name_att_trad_navy_barbarian_4_ship_warriors	Boarding Experts	true
character_skills_localised_name_att_skill_background_general_entrepreneur_roman	Magnate	true
character_skills_localised_name_att_general_skills_barbarian_celts_bandit	Bandit	true
character_skills_localised_description_att_skill_background_general_handler_roman	Just and fair in all things, this man provides tutelage and advice to those who seek it.	true
character_skills_localised_name_att_trad_navy_eastern_3_merchant_allies	Merchant Allies	true
character_skills_localised_name_att_skill_background_champion_aide_camp_nomadic	Military Advisor	true
character_skills_localised_name_cha_skill_general_back_attacker	Attacker	true
character_skills_localised_description_att_trad_army_roman_1_logistics	The right man in the right place makes all the difference.	true
character_skills_localised_description_att_skill_background_priest_radical_roman_roman	The status quo is stagnation, and stagnation is the enemy.	true
character_skills_localised_description_att_skill_background_champion_drillmaster_nomadic	You will listen, and you will learn, or you will die.	true
character_skills_localised_name_att_skill_background_spy_mole_barbarian	Mole	true
character_skills_localised_description_mk_skill_back_natural_gift	Maybe they're born with it…?	true
character_skills_localised_name_att_trad_navy_barbarian_5_naval_conquerors	Naval Conquerors	true
character_skills_localised_name_att_trad_navy_eastern_4_ruin_rome	Ruin of Rome	true
character_skills_localised_name_mk_skill_spy_back_rumours	Rumours	true
character_skills_localised_name_mk_skill_back_dice_roller	Dice Roller	true
character_skills_localised_description_mk_skill_assassin_assassin	The art of the kill is drawn in blood.	true
character_skills_localised_description_att_trad_army_barbarian_4_great_migrators	They have travelled very far, and learned much on the journey.	true
character_skills_localised_name_cha_trad_navy_seamanship	Seamanship	true
character_skills_localised_description_mk_trad_navy_navigation	The straight line between A and B is not always the best option.	true
character_skills_localised_name_cha_skill_assassin_back_master	Master	true
character_skills_localised_name_att_skill_background_general_defender_barbarian	Steadfast Defender	true
character_skills_localised_description_cha_skill_priest_practice	It takes 10,000 hours to master something, they say. You better get started.	true
character_skills_localised_description_cha_skill_priest_back_progressive	Stay on the cliff too long and you'll be washed away.	true
character_skills_localised_description_cha_skill_priest_justice	In the sight of man and all that is holy, you stand accused!	true
character_skills_localised_name_cha_skill_spy_back_conspirator	Conspirator	true
character_skills_localised_description_mk_trad_navy_loyal	Not a man here would dissent. They go with their commander to death and glory, then beyond.	true
character_skills_localised_description_mk_skill_priest_determined	To strive, to seek, to find, and not to yield.	true
character_skills_localised_description_cha_skill_general_back_defender	To hold the line, to weather the storm; these are skills that win battles.	true
character_skills_localised_name_cha_skill_general_back_marksman	Marksman	true
character_skills_localised_description_cha_skill_priest_back_strategist	In victory, this man takes all the credit. In defeat, silence. That is strategy.	true
character_skills_localised_description_att_general_skills_barbarian_2_infantry_commander	This man was born to lead others, marching at the head of a column.	true
character_skills_localised_name_att_agent_skills_champion_glory	Glory	true
character_skills_localised_description_att_agent_skills_champion_training	Discipline, strength, skill. Mastery of these brings victory.	true
character_skills_localised_description_att_skill_background_wife_civilised_brutal	I've had all the slaves flogged. One died out of sheer spite. I need money, dear. I'm off to the slavers'.	true
character_skills_localised_name_att_trad_navy_roman_2_bane_east	Bane of the East	true
character_skills_localised_description_cha_skill_general_legend	This man became history. History became legend. Legend becomes myth.	true
character_skills_localised_name_att_general_skills_barbarian_celts_ollam	Ollam	true
character_skills_localised_description_att_skill_background_priest_elder_roman	Honeyed words and wisdom make sweetness of intelligence.	true
character_skills_localised_description_att_skill_background_spy_courier_eastern	Fleet of foot and swift of tongue.	true
