key	text	tooltip
#Loc;1;text/db/random_localisation_strings.loc		
random_localisation_strings_string_finances_vassal_income_breakdown_faction	%S	true
random_localisation_strings_string_building_construction_requires_main_slot_upgrade	You must rebuild your city first.	true
random_localisation_strings_string_sea_region_control_status_hostile	Hostile	true
random_localisation_strings_string_siege_suffering_attrition	Garrison has run out of supplies and is suffering attrition	true
random_localisation_strings_string_finances_tribute_income_breakdown_other	From others	true
random_localisation_strings_string_cancel_construction_confirmation	This building is being constructed, are you sure you wish to dismantle it?	true
random_localisation_strings_string_unit_stat_bonus_morale_superior	Superior morale	true
random_localisation_strings_string_unit_stat_bonus_armour_improved	Improved armour	true
random_localisation_strings_string_famous_battle_battle_of	Battle of	true
random_localisation_strings_string_round_id_august	August	true
random_localisation_strings_string_round_id_late_july	Late July	true
random_localisation_strings_string_difficulty_level_4	Very Hard	true
random_localisation_strings_string_difficulty_level_5	Legendary	true
random_localisation_strings_string_difficulty_level_2	Normal	true
random_localisation_strings_string_difficulty_level_3	Hard	true
random_localisation_strings_string_difficulty_level_1	Easy	true
random_localisation_strings_string_siege_turns_to_attrition	Turns remaining before garrison will run out of supplies:	true
random_localisation_strings_string_character_role_daughter	Daughter	true
random_localisation_strings_string_cannot_build_insufficient_funds	You have insufficient funds to order this construction.	true
random_localisation_strings_string_StratHud_Building_Card_Recruit_Selection	Left-click to construct this building, right-click for further information.	true
random_localisation_strings_string_finance_header_liege_lord	Overlord	true
random_localisation_strings_string_character_role_retainer	Retainer	true
random_localisation_strings_string_stats_clan_naval_ranked_games_won	text_rejected	true
random_localisation_strings_string_character_situation_conversion_catholic	Province Conversion	true
random_localisation_strings_string_click_to_mark_current_selection_for_dismantling	Click to mark current selection for dismantling. Dismanting a building will return some funds to your treasury.	true
random_localisation_strings_string_opponent_accepts_surrender_title	Surrender Accepted	true
random_localisation_strings_string_replenish_prerequisites_not_met	You must be able to recruit the unit types locally and have sufficient funds to replenish this army. Cost:	true
random_localisation_strings_string_unknown_ship_state	Some of this squadron's details are unknown. Moving closer may reveal more information.	true
random_localisation_strings_string_round_id_late_june	Late June	true
random_localisation_strings_string_StratHudbutton_Construction_Site	Undeveloped land||You can create new construction sites here.	true
random_localisation_strings_string_mission_text_text_mis_activity_attain_fame_level_specific	PLACEHOLDER %d	true
random_localisation_strings_string_unit_upgrade_insufficient_funds	You do not have enough funds in your treasury to upgrade this unit.	true
random_localisation_strings_string_trade_node_tooltip_supply_to_other	supplied to their capital	true
random_localisation_strings_string_resource_exporting_percentage_zero	A trade route is required to export this resource.	true
random_localisation_strings_string_AUA_LOCKED_HEAVILY_DAMAGED	text_rejected	true
random_localisation_strings_string_stats_clan_land_ranked_games_lost	text_rejected	true
random_localisation_strings_string_mp_ready_error_invalid_army_index	The selected army is already taken.  Please select another before declaring ready.	true
random_localisation_strings_string_character_panel_loyalty_honour_negative	Negative Factors	true
random_localisation_strings_string_player_stats_decisive_victories	Number of decisive victories	true
random_localisation_strings_string_fe_unit_card_tooltip_navy	Left-click to select.\\nDouble left-click to remove.\\nRight-click for information.||Unit cards can be dragged to a new location to reorder them within the fleet.	true
random_localisation_strings_string_attacker_direction_south	South	true
random_localisation_strings_string_encourage_fleet	Encourage||Some command ships can encourage other vessels within their area of influence, increasing their melee attack, reload skill and accuracy.||Once this ability has been activated, you will have to wait a while before using it again.	true
random_localisation_strings_string_attacker_direction_north	North	true
random_localisation_strings_string_unknown_unit_state	Some of this unit's details are unknown. Moving closer may reveal more information. Spies have a higher chance of discerning army details.	true
random_localisation_strings_string_round_id_early_may	Early May	true
random_localisation_strings_string_invalid_army_setup_local	Your army setup is invalid.	true
random_localisation_strings_string_unit_stat_bonus_charge_superior	Superior charge	true
random_localisation_strings_string_trade_route_state_neutral	(Neutral)	true
random_localisation_strings_string_building_under_construction_damaged_cannot	No unfinished buildings are damaged 	true
random_localisation_strings_string_mp_ready_error_no_land_defender_for_coastal_battle	The defender in a coastal battle must have at least one land unit.	true
random_localisation_strings_string_morale_confident	Confident	true
random_localisation_strings_string_repair_selection	Repair damaged ships in this selection. Cost:	true
random_localisation_strings_string_sea_region_control_status_neutral	Neutral	true
random_localisation_strings_string_stats_clan_most_clan_map_regions_held_simultaneous	text_rejected	true
random_localisation_strings_string_FACTION_FOOD_FACTOR_ARMIES	Enemy Armies in your Provinces	true
random_localisation_strings_string_siege_turns_to_surrender	\\nTurns remaining before surrender:	true
random_localisation_strings_string_player_stats_mp_consecutive_land	Number of consecutive land battles won	true
random_localisation_strings_string_diplomacy_button_cannot_hostage	text_rejected	true
random_localisation_strings_string_unit_generic_left_click	Left-click to select	true
random_localisation_strings_string_no_path_available	There is no path available from this unit's place of recruitment to the recruiting force.	true
random_localisation_strings_string_gfx_filtering_ani16x	Anisotropic 16x	true
random_localisation_strings_string_unit_stat_bonus_armour_exceptional	Exceptional armour	true
random_localisation_strings_string_round_id_early_december	Early December	true
random_localisation_strings_string_expedition_cannot_trade	Expeditions cannot trade	true
random_localisation_strings_string_network_error_join_failed	Failed to join the selected game	true
random_localisation_strings_string_bribe_nonhostile_cancel	Cancel	true
random_localisation_strings_string_network_error_host_failed	Failed to host game	true
random_localisation_strings_string_must_negotiate_with_master	Can only request this action through this faction's master: 	true
random_localisation_strings_string_error_twitch_login	Failed to log in to Twitch.tv. \\n\\nPlease check your user name and password are correct.	true
random_localisation_strings_string_conversion_factor_events_christian	Recent events	true
random_localisation_strings_string_demo_save_disabled	Saving is temporarily disabled.||The game will auto-save throughout the campaign.	true
random_localisation_strings_string_cannot_reinforce_at_night	This force cannot reinforce during a night battle.	true
random_localisation_strings_string_setup_cost_high	text_rejected	true
random_localisation_strings_string_StratHudbutton_Damaged_Building	Damaged Building||Until repaired, its effects are diminished and it cannot be upgraded. It will repair slowly at no extra cost or may be repaired within one turn at cost via the Repair button above.	true
random_localisation_strings_string_character_role_candidate	Candidate	true
random_localisation_strings_string_mission_issued_infiltrate	text_rejected	true
random_localisation_strings_string_unit_stat_bonus_morale_improved	Improved morale	true
random_localisation_strings_string_player_stats_campaign_naval_battles_won	Campaign naval battles won	true
random_localisation_strings_string_unit_stat_bonus_armour_superior	Superior armour	true
random_localisation_strings_string_character_role_governor	Governor	true
random_localisation_strings_string_settlement_colon	Settlement:	true
random_localisation_strings_string_unit_concerned_recent_casualties	Recent casualties	true
random_localisation_strings_string_ability_phase_mask_freeze_fatigue	Freeze fatigue	true
random_localisation_strings_string_no_slot_available	No slot available	true
random_localisation_strings_string_stat_bonus_cavalry	Bonus vs cavalry	true
random_localisation_strings_string_cancel_demolish_building_once_settled_expedition	This expedition must settle to finish dismantling this building. Left-click to cancel the demolish order.	true
random_localisation_strings_string_unit_stat_bonus_charge_improved	Improved charge	true
random_localisation_strings_string_the_selected_item_may_not_be_dismantled	The selected item may not be dismantled.	true
random_localisation_strings_string_postbattle_public_order_reduction	Provincial instability	true
random_localisation_strings_string_prebattle_popup_defection_04	Some of the enemy's armies have defected and will join you on the battlefield, however some of yours have also defected and will now oppose you!	true
random_localisation_strings_string_prebattle_popup_defection_02	Some of your armies have defected and will now oppose you on the battlefield!	true
random_localisation_strings_string_prebattle_popup_defection_03	Some of the enemy's armies have defected and will now join you on the battlefield!	true
random_localisation_strings_string_prebattle_popup_defection_01	Defection!	true
random_localisation_strings_string_finances_background_income	Base income	true
random_localisation_strings_string_fatigue_very_tired	Very Tired	true
random_localisation_strings_string_StratHudbutton_Cannot_Recruit_Missionary1	You have the maximum number of missionaries already	true
random_localisation_strings_string_StratHudbutton_Cannot_Recruit_Missionary2	You cannot afford to recruit this agent. Cost:	true
random_localisation_strings_string_StratHudbutton_Cannot_Recruit_Missionary3	You can only recruit a maximum of one missionary per province each turn	true
random_localisation_strings_string_resource_long_term	Long term partnership	true
random_localisation_strings_string_diplomacy_undiscovered_clan_mon	Undiscovered Faction	true
random_localisation_strings_string_victory_conditions_turns_to_hold	Hold for %n turns.	true
random_localisation_strings_string_unit_concerned_frightened_horses	Frightened horses	true
random_localisation_strings_string_StratHudbutton_Naval_Cancel_Repair	Cancel repair of selected ships. Recouping:	true
random_localisation_strings_string_MILITARY_FORCE_FOOD_FACTOR_RAIDING	Raiding	true
random_localisation_strings_string_prebattle_legendary_cannot_save	You cannot save before a battle on legendary difficulty.	true
random_localisation_strings_string_TechTree_Tech_Available_Function_Tooltip	Left-click to research this technology.	true
random_localisation_strings_string_character_situation_land_attack	Field Attacks	true
random_localisation_strings_string_mp_ready_error_no_units	You must select some units before declaring ready.	true
random_localisation_strings_string_mp_coop_partner_defeated	Your co-op partner has been defeated, the game will end now.	true
random_localisation_strings_string_character_situation_requesting_allegiance	Requesting Allegiance	true
random_localisation_strings_string_character_situation_sea_defence	Naval Defence	true
random_localisation_strings_string_campaign_type_co_op_short	Co-operative Short	true
random_localisation_strings_string_network_message_vac_player_kicked	has been kicked from the game due to VAC authentication failure.	true
random_localisation_strings_string_dlc_purchase_title	DLC acquired	true
random_localisation_strings_string_error_legendary_save_load_disabled	Quick save/load is disabled on legendary difficulty	true
random_localisation_strings_string_power_category_1	Terrifying	true
random_localisation_strings_string_power_category_3	Strong	true
random_localisation_strings_string_power_category_2	Mighty	true
random_localisation_strings_string_power_category_5	Weak	true
random_localisation_strings_string_power_category_4	Moderate	true
random_localisation_strings_string_power_category_6	Feeble	true
random_localisation_strings_string_FACTION_FOOD_FACTOR_HORDES	Hordes in your Provinces	true
random_localisation_strings_string_trade_agreement_tooltip_export_route_count	Sea export routes remaining - You: %d/%d  Them: %d/%d ||This is based on trade ports in the capital's province.	true
random_localisation_strings_string_unit_stat_bonus_melee_exceptional	Exceptional melee	true
random_localisation_strings_string_reduced_unit_limit_msg_sp	You have reduced the maximum unit setting causing some to be removed from your setup.	true
random_localisation_strings_string_unit_encouraged_settlement_plaza	Capture point(s)	true
random_localisation_strings_string_gfx_ultra	Maximum Quality	true
random_localisation_strings_string_audio_provider_stereo_headphones	Stereo headphones	true
random_localisation_strings_string_town_factor_events	Events	true
random_localisation_strings_string_morale_1	Mutinous	true
random_localisation_strings_string_morale_0	Rebellion	true
random_localisation_strings_string_agent_help_cannot_sabotage_damaged_castle_gates	You cannot sabotage settlement gates that are already damaged.	true
random_localisation_strings_string_ability_change_formation_spacing	Loose Spacing||Loose spacing minimises casualties when under heavy fire, but makes the unit more vulnerable in melee and to charges. 	true
random_localisation_strings_string_limited_unit_type	The amount of these items you can own is limited. You currently have %d of %d.	true
random_localisation_strings_string_player_is_mp_co_op_ally_and_cannot_attack	Cannot attack your multiplayer cooperative ally.	true
random_localisation_strings_string_technology_status_stolen	text_rejected	true
random_localisation_strings_string_fatigue_exhausted	Exhausted	true
random_localisation_strings_string_land_combatant_winning_big	Unit winning decisively	true
random_localisation_strings_string_battle_title_olbia	Battle of Olbia	true
random_localisation_strings_string_unit_concerned_outnumbered	Forces outnumbered by the enemy	true
random_localisation_strings_string_network_error_join_failed_no_stats	Failed to join game:  Player statistics unavailable	true
random_localisation_strings_string_diplomacy_button_need_peace_with_other_allies_to_a	text_rejected	true
random_localisation_strings_string_character_panel_loyalty_honour_positive	Positive Factors	true
random_localisation_strings_string_player_stats_campaign_land_battles_lost	Campaign land battles lost	true
random_localisation_strings_string_pre_battle_siege_equipment_totals_tooltip	Siege items under construction: %d\\nSiege items constructed: %d	true
random_localisation_strings_string_decline_breaks_alliance_defender	Decline (breaks alliance with defender)	true
random_localisation_strings_string_round_id_early_september	Early September	true
random_localisation_strings_string_player_stats_total_mp_naval_battles_won	Total multiplayer naval battles won	true
random_localisation_strings_string_building_under_construction_damaged_repair	Click here to repair the unfinished building so construction can continue.	true
random_localisation_strings_string_battle_victory_minor_close	Close Victory||The enemy is broken! Death and dishonour are theirs today, but only by a single sword stroke!	true
random_localisation_strings_string_fe_unit_card_tooltip_minimal_naval	Left-click to select. \\nRight-click for information.||Cards can be dragged to a new location to re-order them within the fleet.	true
random_localisation_strings_string_stats_clan_number_of_active_seasons_since_creation	text_rejected	true
random_localisation_strings_string_error_chat_room_invalid	Chat Error||Invalid chat room.	true
random_localisation_strings_string_character_type_title_sonandheir	Son & Heir	true
random_localisation_strings_string_unit_generic_right_click	Right-click for further information	true
random_localisation_strings_string_fe_recruitment_card_tooltip_category_clamp_reached	You cannot add this unit as only one siege engine can be used at a time.	true
random_localisation_strings_string_unit_encouraged_settlement	Defending a city	true
random_localisation_strings_string_stats_clan_naval_ranked_games_lost	text_rejected	true
random_localisation_strings_string_FACTION_FOOD_FACTOR_EDICTS	Edicts	true
random_localisation_strings_string_unit_concerned_discouraged_by_unit_ability	Discouraged by ability	true
random_localisation_strings_string_stats_clan_current_highest_ranked_4v4_clan_team	text_rejected	true
random_localisation_strings_string_stats_clan_current_highest_ranked_3v3_clan_team	text_rejected	true
random_localisation_strings_string_stats_clan_current_highest_ranked_2v2_clan_team	text_rejected	true
random_localisation_strings_string_FACTION_FOOD_FACTOR_EVENTS	Events	true
random_localisation_strings_string_network_error_incompatible_data	Incompatible data	true
random_localisation_strings_string_cancel_demolish_building	This building will be dismantled once your turn has ended. Left-click to cancel demolish order.	true
random_localisation_strings_string_cancel_demolish_building_once_expedition	This expedition must settle to finish dismantling this building. Left-click to cancel the demolish order.	true
random_localisation_strings_string_hudbutton_studying_name	Studying:	true
random_localisation_strings_string_multiplayer_dialog_expire	This dialogue will expire in:	true
random_localisation_strings_string_technology_status_available_no_facility	text_rejected	true
random_localisation_strings_string_character_role_deceased	Deceased	true
random_localisation_strings_string_button_cancel_slot_instruction_inactive	You must select an item before using this button.	true
random_localisation_strings_string_battle_time_limit	%d Minutes	true
random_localisation_strings_string_overwrite_title	Overwrite File?	true
random_localisation_strings_string_unit_stat_bonus_accuracy_superior	Superior accuracy	true
random_localisation_strings_string_opponent_refuses_surrender_title	Surrender Refused	true
random_localisation_strings_string_agent_help_str_request_allegiance_faction_leader_present	text_rejected	true
random_localisation_strings_string_faction_leader_tooltip_honour_5	text_rejected	true
random_localisation_strings_string_faction_leader_tooltip_honour_4	text_rejected	true
random_localisation_strings_string_faction_leader_tooltip_honour_6	text_rejected	true
random_localisation_strings_string_faction_leader_tooltip_honour_1	text_rejected	true
random_localisation_strings_string_faction_leader_tooltip_honour_3	text_rejected	true
random_localisation_strings_string_faction_leader_tooltip_honour_2	text_rejected	true
random_localisation_strings_string_network_error_host_disconnected	The host has left the game	true
random_localisation_strings_string_mission_reward_grant_unit	Grants a unit of:	true
random_localisation_strings_string_gfx_filtering_tri	Trilinear	true
random_localisation_strings_string_character_situation_entertaining_nobles	Entertaining nobles	true
random_localisation_strings_string_opponent_demands_surrender_title	Surrender Demanded	true
random_localisation_strings_string_wealth_category_4	Moderate	true
random_localisation_strings_string_wealth_category_5	Meagre	true
random_localisation_strings_string_REGION_FOOD_FACTOR_RAIDING	Raiding	true
random_localisation_strings_string_wealth_category_6	Destitute	true
random_localisation_strings_string_wealth_category_1	Spectacular	true
random_localisation_strings_string_wealth_category_2	Rich	true
random_localisation_strings_string_wealth_category_3	Affluent	true
random_localisation_strings_string_cannot_recruit_insufficient_funds	You have insufficient funds to recruit this unit.	true
random_localisation_strings_string_player_stats_campaign_naval_battles_lost	Campaign naval battles lost	true
random_localisation_strings_string_battle_defeat_minor_close	Close Defeat||Victory has eluded your grasp. The enemy triumphs, but by little.	true
random_localisation_strings_string_setup_error_title	text_rejected	true
random_localisation_strings_string_stats_clan_current_clan_members	text_rejected	true
random_localisation_strings_string_diplomacy_button_need_alliance_to_request_alliance	There is no alliance to cancel.	true
random_localisation_strings_string_unit_concerned_extended_casualties	Recent casualties sustained 	true
random_localisation_strings_string_player_stats_most_men_lost	Most men lost in a battle	true
random_localisation_strings_string_StratHudbutton_Cannot_Embark/Disembark0	Cannot embark/disembark	true
random_localisation_strings_string_StratHudbutton_Cannot_Embark/Disembark1	The land here is inaccessible.	true
random_localisation_strings_string_StratHudbutton_Cannot_Embark/Disembark2	This fleet is too far from the shore or port.	true
random_localisation_strings_string_tacmap_inactive_filter_expedition	Not available for expeditions	true
random_localisation_strings_string_character_details_rank_5	Current rank: 5 (maximum 6)||A character's rank shows their overall level of skill, with each star representing one rank level.||New rank levels are achieved by gaining experience. With each new level you will be able to pick additional skills.	true
random_localisation_strings_string_character_details_rank_4	Current rank: 4 (maximum 6)||A character's rank shows their overall level of skill, with each star representing one rank level.||New rank levels are achieved by gaining experience. With each new level you will be able to pick additional skills.	true
random_localisation_strings_string_character_details_rank_6	Current rank: 6 (maximum 6)||A character's rank shows their overall level of skill, with each star representing one rank level.||New rank levels are achieved by gaining experience. With each new level you will be able to pick additional skills.	true
random_localisation_strings_string_character_details_rank_1	Current rank: 1 (maximum 6)||A character's rank shows their overall level of skill, with each star representing one rank level.||New rank levels are achieved by gaining experience. With each new level you will be able to pick additional skills.	true
random_localisation_strings_string_character_details_rank_3	Current rank: 3 (maximum 6)||A character's rank shows their overall level of skill, with each star representing one rank level.||New rank levels are achieved by gaining experience. With each new level you will be able to pick additional skills.	true
random_localisation_strings_string_character_details_rank_2	Current rank: 2 (maximum 6)||A character's rank shows their overall level of skill, with each star representing one rank level.||New rank levels are achieved by gaining experience. With each new level you will be able to pick additional skills.	true
random_localisation_strings_string_campaign_type_long	Long Campaign	true
random_localisation_strings_string_network_message_confirm_quit_host	Confirm quit? The game will end for everyone.	true
random_localisation_strings_string_StratHudbutton_Naval_Repair_Not_Required	No repairs required for ships in this selection.	true
random_localisation_strings_string_finance_header_diplomacy	Diplomacy	true
random_localisation_strings_string_mp_ready_error_ai_no_siege_units	AI players must have some infantry or artillery units capable of assaulting fortifications.	true
random_localisation_strings_string_finances_tribute_income_breakdown_faction	%S (turns remaining %d)	true
random_localisation_strings_string_time_hours	hours	true
random_localisation_strings_string_player_stats_enemy_generals_killed	Enemy generals killed	true
random_localisation_strings_string_unit_stat_bonus_charge_exceptional	Exceptional charge	true
random_localisation_strings_string_conversion_factor_state_religion_christian	text_rejected	true
random_localisation_strings_string_diplomacy_button_need_war_to_request_peace	text_rejected	true
random_localisation_strings_string_battle_victory_major_close	Close Victory||Almost they defeated you, but you have snatched victory! The enemy dead are testament to that!	true
random_localisation_strings_string_MILITARY_FORCE_FOOD_FACTOR_RIVALRY	Rivalry	true
random_localisation_strings_string_round_id_september	September	true
random_localisation_strings_string_TechTree_Tech_Unavailable_Function_Tooltip	Unavailable. You have not met the construction or technology requirements.	true
random_localisation_strings_string_campaign_radar_sort_by_speciality	Sort by speciality	true
random_localisation_strings_string_stats_clan_clan_total_ranked_game_losses	text_rejected	true
random_localisation_strings_string_StratHudbutton_demolish	Demolish building	true
random_localisation_strings_string_audio_provider_5_1	5.1 discrete	true
random_localisation_strings_string_audio_provider_6_1	6.1 discrete	true
random_localisation_strings_string_audio_provider_7_1	7.1 discrete	true
random_localisation_strings_string_audio_provider_8_1	8.1 discrete	true
random_localisation_strings_string_audio_provider_4_0	4.0 discrete	true
random_localisation_strings_string_character_situation_land_amphibious_attack	Coastal Assaults	true
random_localisation_strings_string_player_stats_generals_lost	Generals lost	true
random_localisation_strings_string_unit_concerned_fatigue_very_tired	Very tired	true
random_localisation_strings_string_auto_save_filename	auto_save	true
random_localisation_strings_string_FACTION_FOOD_FACTOR_RECENT_BATTLES	Devastation from Battles	true
random_localisation_strings_string_cannot_build_tech_required	Required technology needs to be researched before this building can be constructed.	true
random_localisation_strings_string_effect_bundle_target_local	Province:	true
random_localisation_strings_string_round_id_early_november	Early November	true
random_localisation_strings_string_unit_concerned_surprised	Surprised by revealed enemy	true
random_localisation_strings_string_player_stat_battles_lost	Battles lost	true
random_localisation_strings_string_technology_tooltip_stealing_functionality	Left-click to attempt to steal, right-click for further information.	true
random_localisation_strings_string_ability_phase_mask_poison	Poison	true
random_localisation_strings_string_fe_unit_card_tooltip_no_dupe_naval	Left-click to select.\\nDouble left-click to remove.||Unit cards can be dragged to a new location to reorder them within the fleet.	true
random_localisation_strings_string_predicted_with_units_added	predicted, if selected units are garrisoned	true
random_localisation_strings_string_captive_option_title_kill	Kill Captives	true
random_localisation_strings_string_victory_conditions_mp_co_op_long	Capture and hold %n provinces in conjunction with your cooperative ally, ensuring that one of you holds the provinces shown.	true
random_localisation_strings_string_technology_status_available_no_researcher	text_rejected	true
random_localisation_strings_string_fe_unit_card_tooltip_land	Left-click to select.\\nDouble left-click to remove.\\nRight-click for information.||Unit cards can be dragged to a new location to reorder them within the army.	true
random_localisation_strings_string_character_situation_subterfuge_sabotage_building	Building Sabotage	true
random_localisation_strings_string_religion_factor_in_decline	In decline 	true
random_localisation_strings_string_religion_factor_increasing	Growing	true
random_localisation_strings_string_unit_stat_bonus_morale_exceptional	Exceptional morale	true
random_localisation_strings_string_agent_help_string_request_allegiance_major_faction	text_rejected	true
random_localisation_strings_string_character_situation_entertaining_generals	Entertaining generals	true
random_localisation_strings_string_gdp_poor_fertility_bonus	Faction Trait	true
random_localisation_strings_string_battle_defeat_major_close	Close Defeat||Ah! The enemy have defeated you, but your valiant efforts were almost successful.	true
random_localisation_strings_string_at_peace	At Peace	true
random_localisation_strings_string_unit_stat_bonus_accuracy_improved	Improved accuracy	true
random_localisation_strings_string_character_situation_land_ambush	Ambushes	true
random_localisation_strings_string_morale_shattered	Shattered	true
random_localisation_strings_string_stat_can_target_buildings	Can damage buildings	true
random_localisation_strings_string_diplomacy_button_need_peace_to_request_war	text_rejected	true
random_localisation_strings_string_character_situation_subterfuge_field_scout	Scouting	true
random_localisation_strings_string_dlc_purchase_body	Thank you. Please restart Total War: ATTILA to download and play this DLC pack.	true
random_localisation_strings_string_fe_unit_card_tooltip_minimal_land	Left-click to select. \\nRight-click for information.||Cards can be dragged to a new location to re-order them within the army.	true
random_localisation_strings_string_round_id_early_february	Early February	true
random_localisation_strings_string_network_error_join_failed_game_not_found	Failed to join game: Game not found	true
random_localisation_strings_string_stat_base_value	Base value	true
random_localisation_strings_string_character_type_title_son	Son	true
random_localisation_strings_string_player_stats_best_streak	Best streak	true
random_localisation_strings_string_skill_next_level	Next level:	true
random_localisation_strings_string_morale_impetuous	Impetuous	true
random_localisation_strings_string_region_specialty_holy_site	text_rejected	true
random_localisation_strings_string_stats_clan_land_ranked_games_won	text_rejected	true
random_localisation_strings_string_win_chance_high	High	true
random_localisation_strings_string_trade_route_state_player	(Yours)	true
random_localisation_strings_string_StratHudbutton_cannot_repairShip_noport	Cannot repair||You can only repair ships at a port.	true
random_localisation_strings_string_network_message_player_left_end	has left the game; the game will now end.	true
random_localisation_strings_string_finance_header_military	Military	true
random_localisation_strings_string_trade_route_tooltip_local_neutral	(yours shared with others)	true
random_localisation_strings_string_gfx_med	Performance	true
random_localisation_strings_string_Campaign_button_end_turn_spring	Spring	true
random_localisation_strings_string_nav_not_in_combat	Not in combat	true
random_localisation_strings_string_date_bc	BC	true
random_localisation_strings_string_food_consumption	Consumption	true
random_localisation_strings_string_MILITARY_FORCE_FOOD_FACTOR_UNITS	Units	true
random_localisation_strings_string_recruitment_tab	Recruitment	true
random_localisation_strings_string_mk_dif_teu	[[col:red]]Hard[[/col]], Religious Unrest	true
random_localisation_strings_string_mk_dif_jer	[[col:dark_r]]Very Hard[[/col]], Powerful Enemy	true
random_localisation_strings_string_mk_dif_ser	[[col:red]]Hard[[/col]], Stronger Neighbours	true
random_localisation_strings_string_mk_dif_den	[[col:green]]Easy[[/col]], Strong Diplomacy	true
random_localisation_strings_string_mk_dif_gen	[[col:green]]Easy[[/col]], Strong Diplomacy	true
random_localisation_strings_string_mk_dif_ven	[[col:green]]Easy[[/col]], Strong Diplomacy	true
random_localisation_strings_string_mk_dif_zen	[[col:yellow]]Normal[[/col]]	true
random_localisation_strings_string_mk_dif_geo	[[col:green]]Easy[[/col]], Large Territory	true
random_localisation_strings_string_network_message_player_dropped_end	has been dropped from the game; the game will now end.	true
random_localisation_strings_string_land_combatant_losing_big	Unit losing decisively	true
random_localisation_strings_string_warning_graphics_upgrade	Some settings may not be applied until the next time a campaign or battle is launched. Continue?	true
random_localisation_strings_string_Enlightenment_Bar	text_rejected	true
random_localisation_strings_string_hudbutton_studying_turns_until_completion	Turns until completion:	true
random_localisation_strings_string_cancel_recruitment_confirmation	This unit is in the process of being recruited, are you sure you wish to cancel recruiting it?	true
random_localisation_strings_string_trade_route_tooltip_local_enemy	(yours shared with enemy)	true
random_localisation_strings_string_defender	Defender	true
random_localisation_strings_string_multiplayer_play_battle	Play Battle	true
random_localisation_strings_string_ability_release_animals	Release Animals||Unleash the beasts of war! The animals can only be released when you are close enough to the enemy, and will attack the closest unit to them.	true
random_localisation_strings_string_stat_base_damage	Base damage	true
random_localisation_strings_string_ability_naval_fire_at_will	Toggle Fire On/Off||When toggled off, the selected ship will stop firing and be unable to fire until toggled on again.	true
random_localisation_strings_string_Naval_Bar	Naval	true
random_localisation_strings_string_adjecency_points	adjacent points	true
random_localisation_strings_string_trade_status_tooltip_can	Can trade	true
random_localisation_strings_string_queued_building_blocked_by_stance	This horde needs to settle in order to finish completion of this building. Left-click to remove a building from the queue, right-click for further information.	true
random_localisation_strings_string_undecided	Undecided	true
random_localisation_strings_string_stats_clan_current_clan_map_rank	text_rejected	true
random_localisation_strings_string_morning	Morning	true
random_localisation_strings_string_file_load_failed	Load failed	true
random_localisation_strings_string_error_chat_room_connection_failure	Chat Error||Failed to connect to chat room.	true
random_localisation_strings_string_campaign_autoresolver_tooltip_stance_land_balanced	When using the balanced battle stance, units will receive no bonuses or penalties.	true
random_localisation_strings_string_character_situation_land_defence	Field Defence	true
random_localisation_strings_string_trade_route_state_shared	(Shared)	true
random_localisation_strings_string_army_trapped_in_enemy_ZOC	This force is inside an enemy zone of control and cannot move. Attacking the enemy is its only option.	true
random_localisation_strings_string_FACTION_PROVINCE_FOOD_FACTOR_BUILDINGS_IN_REGIONS	Buildings	true
random_localisation_strings_string_event_log_battle_victory_heroic_crushing	Heroic Victory	true
random_localisation_strings_string_agent_recruitment_insufficient_dev_points	[[col:red]]You do not have enough population surplus here to raise a new horde army.[[/col]]	true
random_localisation_strings_string_gfx_off	Off	true
random_localisation_strings_string_predicted	Predicted	true
random_localisation_strings_string_importing	Importing	true
random_localisation_strings_string_capital	Faction Capital	true
random_localisation_strings_string_exporting	Exporting	true
random_localisation_strings_string_date_ad	AD	true
random_localisation_strings_string_delayed	Delayed	true
random_localisation_strings_string_StratHudButton_Cannot_Recruit_Unit11	No recruitment points available	true
random_localisation_strings_string_StratHudbutton_Cannot_Recruit_Unit10	You haven't got the required resource for recruiting this unit.	true
random_localisation_strings_string_level_level_level_level	Level	true
random_localisation_strings_string_demo_battle_unavailable	This option is limited to key battles in the demo. You must autoresolve this battle.	true
random_localisation_strings_string_commerce_raiding	Trade route raiding:	true
random_localisation_strings_string_unit_encouraged_inspired_by_unit_ability	Inspired by ability	true
random_localisation_strings_string_player_stats_battles_drawn	Battles drawn	true
random_localisation_strings_string_Cannot_reinforce_artillery	Siege weapons cannot join the battle as reinforcements	true
random_localisation_strings_string_mission_issued_research_technology	Research Technology:	true
random_localisation_strings_string_increasing	Improving	true
random_localisation_strings_string_maximum_permitted_amount_of_this_unit_type_reached	Maximum permitted amount of this unit type reached	true
random_localisation_strings_string_trade_agreement_tooltip_sea_routes	A sea trade route will link your two capitals.	true
random_localisation_strings_string_trade_lost	Not exported. Upgrade your ports to earn more money by exporting these commodities.	true
random_localisation_strings_string_trade_post	Trade post	true
random_localisation_strings_string_Unit_Card_Generic_Function	Left-click to select, right-click for further information	true
random_localisation_strings_string_postbattle_money_gained	Money gained	true
random_localisation_strings_string_network_error_internal_controller_disconnection	There is a disconnection to the online service	true
random_localisation_strings_string_agent_help_string_bribe_capital	text_rejected	true
random_localisation_strings_string_Cancelled	Cancelled	true
random_localisation_strings_string_gunners	text_rejected	true
random_localisation_strings_string_unit_card_lost_general_disbanded	The general has been killed and his unit disbanded.	true
random_localisation_strings_string_error_chat_command_failed	Invalid chat command	true
random_localisation_strings_string_trade_agreement_tooltip_embargoed	Embargo prevents trade agreement	true
random_localisation_strings_string_December	text_rejected	true
random_localisation_strings_string_siege_tab	Siege	true
random_localisation_strings_string_skills_num_points	points in	true
random_localisation_strings_string_blockaded	Blockaded	true
random_localisation_strings_string_character_situation_cunning_bribe	Bribery	true
random_localisation_strings_string_mk_dif_lat	[[col:dark_r]]Very Hard[[/col]], Hostile Neighbours	true
random_localisation_strings_string_mk_dif_mar	[[col:yellow]]Normal[[/col]], Migrating	true
random_localisation_strings_string_mk_dif_cas	[[col:green]]Easy[[/col]], Strong Diplomacy	true
random_localisation_strings_string_prebattle_reinforcing_army	Reinforcing army	true
random_localisation_strings_string_mk_dif_haf	[[col:yellow]]Normal[[/col]], Vassal State	true
random_localisation_strings_string_mk_dif_zag	[[col:red]]Hard[[/col]], Isolated	true
random_localisation_strings_string_mk_dif_wal	[[col:dark_r]]Very Hard[[/col]], Vassal State	true
random_localisation_strings_string_mk_dif_mak	[[col:red]]Hard[[/col]], Isolated	true
random_localisation_strings_string_technology_status_being_researched	text_rejected	true
random_localisation_strings_string_network_error_host	Failed to host game	true
random_localisation_strings_string_agent_help_string_high_opposing_religion	text_rejected	true
random_localisation_strings_string_unit_encouraged_inspired	Encouraged by nearby unit	true
random_localisation_strings_string_agent_help_string_high_security_building	This building is very secure, making it difficult to sabotage. 	true
random_localisation_strings_string_network_message_no_clients_left	Client left the game	true
random_localisation_strings_string_multiplayer_autoresolve	Auto-resolve	true
random_localisation_strings_string_desolate	Desolate	true
random_localisation_strings_string_battle_invalid_ship_docking_point	Another ship is already heading to this destination. You will have to find an alternative landing place.	true
random_localisation_strings_string_October	text_rejected	true
random_localisation_strings_string_Scupper	Scupper||Scupper unused ships to save upkeep costs. 	true
random_localisation_strings_string_building_construction_blocked_by_character	Unable to expand. You must ensure you have a building in the previous slot, that this building is not ruined, and check there are no nearby characters blocking the expansion.	true
random_localisation_strings_string_end_migration_tooltip_expedition	If you occupy this settlement your expedition will end.	true
random_localisation_strings_string_mp_ready_error_battle_type_desync	The battle type selected doesn't match the map selected.	true
random_localisation_strings_string_mission_reward_prestige	Prestige	true
random_localisation_strings_string_mission_reward_naval_experience	Experience for all naval units	true
random_localisation_strings_string_attacker_direction_east	East	true
random_localisation_strings_string_attacker_direction_west	West	true
random_localisation_strings_string_character_situation_zeal_demoralise_army	Demoralising Armies	true
random_localisation_strings_string_unit_replacement_string	replace	true
random_localisation_strings_string_food_production	Production	true
random_localisation_strings_string_campaign_type_one_vs_one	Head to Head	true
random_localisation_strings_string_destroy_transported_title	Disbanding Units	true
random_localisation_strings_string_Classic	Land Battle	true
random_localisation_strings_string_finance_header_recruitment	Recruitment	true
random_localisation_strings_string_player_stat_miles_covered_campaign	Miles covered with your armies and fleets	true
random_localisation_strings_string_agent_recruitment_click_to_recruit	Click to recruit this agent at the current settlement.	true
random_localisation_strings_string_mk_dif_sco	[[col:yellow]]Normal[[/col]], Isolated	true
random_localisation_strings_string_diplomacy_button_cannot_request_join_war_warring_a	text_rejected	true
random_localisation_strings_string_pre-battle_multiplayer_undecided	Undecided	true
random_localisation_strings_string_ability_board_ship	Board Ship	true
random_localisation_strings_string_fe_unit_card_tooltip_no_dupe_land	Left-click to select.\\nDouble left-click to remove.||Unit cards can be dragged to a new location to reorder them within the army.	true
random_localisation_strings_string_resource_importing_from	Importing from:	true
random_localisation_strings_string_opponent_accepts_surrender_body	The defending force has complied with your demand of surrender!	true
random_localisation_strings_string_agent_help_string_family_member	The target is a well-protected family member and harder to assassinate.	true
random_localisation_strings_string_neutral	Neutral	true
random_localisation_strings_string_Married	text_rejected	true
random_localisation_strings_string_imperium	Imperium	true
random_localisation_strings_string_damaged	Damaged	true
random_localisation_strings_string_retreat	Retreat	true
random_localisation_strings_string_marines	text_rejected	true
random_localisation_strings_string_manoeuverability_medium	Medium	true
random_localisation_strings_string_mk_dif_abb	[[col:yellow]]Normal[[/col]], Strong Diplomacy	true
random_localisation_strings_string_stats_clan_current_highest_ranked_solo_clan_mbr_na	text_rejected	true
random_localisation_strings_string_audio_provider_srs_circle_surround	SRS Circle Surround	true
random_localisation_strings_string_mission_reward_enable_unit	Enables the recruitment of:	true
random_localisation_strings_string_ability_skirmish	Toggle Skirmish Mode||In skirmish mode units will keep a safe distance from the enemy. Skirmish tactics can be employed to slow an advancing enemy or distract specific units. Skirmish units are vulnerable to cavalry charges.	true
random_localisation_strings_string_chat_prefix_team	[to team]	true
random_localisation_strings_string_Construction_site	Construction Site	true
random_localisation_strings_string_trade_route_tooltip_enemy	(enemy)	true
random_localisation_strings_string_afternoon	Afternoon	true
random_localisation_strings_string_abandon_tooltip	Click to abandon this settlement on the next turn.\\n\\n[[col:green]]This will generate %d income.[[/col]]\\n\\n[[col:red]]Public order across your faction will be adversely affected by the resulting desolation.[[/col]]	true
random_localisation_strings_string_effect_bundle_from_event	Event:	true
random_localisation_strings_string_fe_recruitment_card_tooltip_land	Left-click to select.\\nRight-click for information.\\nDouble left-click or drag to force to add.	true
random_localisation_strings_string_mp_ready_error_overspend	Unable to declare ready as a player has spent too much on their army setup.	true
random_localisation_strings_string_producing	Producing	true
random_localisation_strings_string_error_leaderboard_search	text_rejected	true
random_localisation_strings_string_advisor	Advisor	true
random_localisation_strings_string_confirm_delete_msg	This will delete all selected files. Continue?	true
random_localisation_strings_string_stance_food_stolen	Food stolen: %n of the consumed amount	true
random_localisation_strings_string_action_result_type_success	Success	true
random_localisation_strings_string_trade_status_tooltip_value	\\nCurrent value:	true
random_localisation_strings_string_win_chance_none	None	true
random_localisation_strings_string_REGION_FOOD_FACTOR_RECENT_BATTLE	Devastation from Battles	true
random_localisation_strings_string_StratHudbutton_cannot_enlist_full	Cannot enlist a general||You already have a full quota of generals.	true
random_localisation_strings_string_sanitation	Sanitation	true
random_localisation_strings_string_mk_dif_fla	[[col:red]]Hard[[/col]]	true
random_localisation_strings_string_famous_battle_victory_over	Victory over:	true
random_localisation_strings_string_mk_dif_alm	[[col:red]]Hard[[/col]], Numerous Enemies	true
random_localisation_strings_string_mk_dif_ilk	[[col:yellow]]Normal[[/col]], Nomads	true
random_localisation_strings_string_campaign_ministers_effectiveness_effect	%+n to management level of ministers	true
random_localisation_strings_string_FACTION_PROVINCE_FOOD_FACTOR_POOR_FERTILITY_BONUS	Faction Trait	true
random_localisation_strings_string_player_stats_campaigns_completed	Campaigns completed	true
random_localisation_strings_string_mission_issued_make_peace	Make Peace:	true
random_localisation_strings_string_recruitment_unavailable	This unit is unavailable for the following reasons:	true
random_localisation_strings_string_trade_node_tooltip_supply_to_you	supplied to your capital	true
random_localisation_strings_string_gfx_low	Maximum Performance	true
random_localisation_strings_string_mk_dif_tou	[[col:red]]Hard[[/col]], Albigensian Crusade	true
random_localisation_strings_string_mk_dif_lor	[[col:yellow]]Normal[[/col]]	true
random_localisation_strings_string_mk_dif_nor	[[col:yellow]]Normal[[/col]], Migrating	true
random_localisation_strings_string_mk_dif_por	[[col:green]]Easy[[/col]], Strong Diplomacy	true
random_localisation_strings_string_gfx_custom	Customised	true
random_localisation_strings_string_mk_dif_gol	[[col:yellow]]Normal[[/col]], Nomads	true
random_localisation_strings_string_mk_dif_pol	[[col:yellow]]Normal[[/col]]	true
random_localisation_strings_string_mk_dif_vol	[[col:red]]Hard[[/col]], Mongol Invasion	true
random_localisation_strings_string_mk_dif_boh	[[col:yellow]]Normal[[/col]]	true
random_localisation_strings_string_right_click_info	Right-click for further information.	true
random_localisation_strings_string_ping_none	No ping	true
random_localisation_strings_string_finance_header_expenses	Expenses	true
random_localisation_strings_string_morale_fighting_to_death	Fighting to the death	true
random_localisation_strings_string_REGION_FOOD_FACTOR_HORDES	Hordes in this Region	true
random_localisation_strings_string_allied_mencount	Allied man count	true
random_localisation_strings_string_captive_option_description_kill	Leave none alive! Killing every last survivor may satisfy a thirst for blood, but your enemy and their allies will take grave exception to this.\\n\\nHowever, the enemy of your enemy will like you more for it.	true
random_localisation_strings_string_finances_commerce_raiding_income	From trade route raiding	true
random_localisation_strings_string_region_specialty_philosophical_tradition	text_rejected	true
random_localisation_strings_string_Campaign_button_end_turn_summer	Summer	true
random_localisation_strings_string_tile_upgrade_none	None	true
random_localisation_strings_string_town_commercial	Settlement (Commercial Centre)	true
random_localisation_strings_string_mk_dif_ant	[[col:dark_r]]Very Hard[[/col]], Powerful Enemy	true
random_localisation_strings_string_mk_dif_eng	[[col:dark_g]]Very Easy[[/col]], Island Hegemon	true
random_localisation_strings_string_campaign_type_co_op_long	Co-operative Long	true
random_localisation_strings_string_quick_battle_fail	Failed to connect to quick battle	true
random_localisation_strings_string_region_specialty_horses	text_rejected	true
random_localisation_strings_string_damaged_building	Damaged Building||Until repaired, its effects are diminished and it cannot be upgraded. It will repair slowly at no extra cost, or may be repaired within one turn at cost via the 'repair' button above.	true
random_localisation_strings_string_FACTION_PROVINCE_FOOD_FACTOR_TECHNOLOGIES	Technology	true
random_localisation_strings_string_FACTION_PROVINCE_FOOD_FACTOR_CHARACTERS	Characters	true
random_localisation_strings_string_finances_tribute_income	text_rejected	true
random_localisation_strings_string_formatted_minutes_plural	%d Minutes	true
random_localisation_strings_string_mk_dif_lit	[[col:red]]Hard[[/col]], Pagan	true
random_localisation_strings_string_stats_clan_current_highest_ranked_solo_clan_member	text_rejected	true
random_localisation_strings_string_mk_dif_pis	[[col:green]]Easy[[/col]], Strong Diplomacy	true
random_localisation_strings_string_mk_dif_kie	[[col:yellow]]Normal[[/col]]	true
random_localisation_strings_string_mk_dif_nic	[[col:yellow]]Normal[[/col]], Hostile Neighbours	true
random_localisation_strings_string_mk_dif_sic	[[col:yellow]]Normal[[/col]]	true
random_localisation_strings_string_mission_objectives	Objective:	true
random_localisation_strings_string_mk_dif_mil	[[col:yellow]]Normal[[/col]]	true
random_localisation_strings_string_mouse_over	Mouse-over	true
random_localisation_strings_string_victory_conditions_mp_co_op_short	Capture and hold %n provinces in conjunction with your cooperative ally, ensuring that one of you holds the provinces shown.	true
random_localisation_strings_string_StratHudbutton_Naval_Repair_No_Selection	Select damaged ships to use the repair function.	true
random_localisation_strings_string_military_force_legacy_name_garrison_army	Garrison Army	true
random_localisation_strings_string_influence	Influence:	true
random_localisation_strings_string_round_id_january	January	true
random_localisation_strings_string_StratHudbutton_cannot_navy_repair_nocash	Cannot repair||You have insufficient funds.||Disband an unused unit or increase taxes to raise funds. 	true
random_localisation_strings_string_mk_dif_khw	[[col:red]]Hard[[/col]], Mongol Invasion	true
random_localisation_strings_string_mk_dif_ghu	[[col:red]]Hard[[/col]], Isolated	true
random_localisation_strings_string_military_force_legacy_name_transport_fleet	Transport Fleet	true
random_localisation_strings_string_quick_save	Quick Save	true
random_localisation_strings_string_round_id_december	December	true
random_localisation_strings_string_function_construction_hud	Left-click to select, right-click for further information.	true
random_localisation_strings_string_recruitment_from	This unit can be recruited from:	true
random_localisation_strings_string_network_error_join_failed_error	Failed to join game: Unspecified error	true
random_localisation_strings_string_save_fail	Save Failed	true
random_localisation_strings_string_upload_complete	Upload complete	true
random_localisation_strings_string_army_tab	Army	true
random_localisation_strings_string_whisper	Private Message	true
random_localisation_strings_string_unlimited	Unlimited	true
random_localisation_strings_string_cancel_recruitment_header	Cancel Recruitment	true
random_localisation_strings_string_will_lose_at_end	You will lose if the time runs out	true
random_localisation_strings_string_Children	Children:	true
random_localisation_strings_string_fe_recruitment_card_tooltip_naval	Left-click to select.\\nRight-click for information.\\nDouble left-click or drag to force to add.	true
random_localisation_strings_string_decreasing	Deteriorating	true
random_localisation_strings_string_load_fail	Load failed	true
random_localisation_strings_string_character_situation_cunning_oversee_army	Overseeing Army	true
random_localisation_strings_string_skills_requires	Requires	true
random_localisation_strings_string_ability_dismount	Toggle Mount||It's a good idea to dismount if you need to engage spear units head on.	true
random_localisation_strings_string_region_specialty_smithing	text_rejected	true
random_localisation_strings_string_Campaign_button_end_turn_winter	Winter	true
random_localisation_strings_string_technology_tooltip_stealing_numeric_info	Chance of success:	true
random_localisation_strings_string_dlc_menu_button_offline	You must be online to view DLC packs.	true
random_localisation_strings_string_diplomacy_button_other_clan_no_alliances_to_break	text_rejected	true
random_localisation_strings_string_limited	Limited	true
random_localisation_strings_string_player_stats_ships_lost	Ships lost	true
random_localisation_strings_string_agent_help_string_request_allegiance_own_religion	text_rejected	true
random_localisation_strings_string_infrastructure_tab	Infrastructure	true
random_localisation_strings_string_land_not_in_combat	Not in combat	true
random_localisation_strings_string_no	No	true
random_localisation_strings_string_stance_food_consumption	Food consumed: %n from the local region	true
random_localisation_strings_string_agent_cannot_act_settlement_full	This settlement already has the maximum number of agents within it.	true
random_localisation_strings_string_network_message_desynch	A synchronisation error has occurred; the game will now end.	true
random_localisation_strings_string_January	text_rejected	true
random_localisation_strings_string_recharge_change	Ability Recharge Time	true
random_localisation_strings_string_ability_abandon_artillery_engines	Drop Siege Equipment||Drops your current siege equipment.	true
random_localisation_strings_string_famous_battle_defeated_by	Defeated by:	true
random_localisation_strings_string_mk_dif_bur	[[col:red]]Hard[[/col]], Vassal State	true
random_localisation_strings_string_mk_dif_aus	[[col:yellow]]Normal[[/col]], Strong Diplomacy	true
random_localisation_strings_string_captive_option_description_enslave	Take those willing to fight into your army, replenishing your ranks\\n\\nTheir inexperience in your forces, however, will affect your army's skill.	true
random_localisation_strings_string_technology_bonuses_tooltip	Research rate:	true
random_localisation_strings_string_technology_status_unavailable_tech	text_rejected	true
random_localisation_strings_string_mk_dif_hun	[[col:green]]Easy[[/col]], Strong Diplomacy	true
random_localisation_strings_string_mk_dif_bul	[[col:yellow]]Normal[[/col]]	true
random_localisation_strings_string_mk_dif_cum	[[col:dark_r]]Very Hard[[/col]], Mongol Invasion	true
random_localisation_strings_string_mk_dif_rum	[[col:red]]Hard[[/col]], Religious Unrest	true
random_localisation_strings_string_agent_help_string_incite_rebels	You cannot incite revolts in rebel provinces.	true
random_localisation_strings_string_unit_concerned_casualties	Casualties sustained	true
random_localisation_strings_string_morale_wavering	Wavering	true
random_localisation_strings_string_error_clan_search	text_rejected	true
random_localisation_strings_string_round_id_late_september	Late September	true
random_localisation_strings_string_Campaign_button_end_turn_autumn	Autumn	true
random_localisation_strings_string_November	text_rejected	true
random_localisation_strings_string_expedition_occupy	Declare Independence||Occupying this settlement is a declaration of your independence from the Roman Empire! 	true
random_localisation_strings_string_researcher_tooltip	Left-click to select. Once selected, left-clicking a valid technology icon will begin research.	true
random_localisation_strings_string_battle_defeat_minor_heroic	Crushing Defeat||There is nothing to take from this day but shame and dishonour. The enemy victory is remarkable.	true
random_localisation_strings_string_recruitment_travel_time	Once recruited, joining this army will take additional turns:	true
random_localisation_strings_string_recruitment_cost	Recruitment Cost	true
random_localisation_strings_string_region_specialty_artisans	text_rejected	true
random_localisation_strings_string_event_log_battle_victory_major_decisive	Decisive Victory	true
random_localisation_strings_string_sea_region_control_status_shared	Shared	true
random_localisation_strings_string_graphics_settings_require_restart	The new settings will be applied once the game has been re-started.	true
random_localisation_strings_string_Fixed_Artillery_Cannot_Reinforce	Fixed artillery units are stationary and therefore cannot be used as reinforcements.	true
random_localisation_strings_string_trade_agreement_tooltip_neighbour	An overland trade route will link your two capitals.	true
random_localisation_strings_string_technology_entity_tooltip	text_rejected	true
random_localisation_strings_string_will_win_at_end	You will win if the time runs out	true
random_localisation_strings_string_resource	Resource	true
random_localisation_strings_string_February	text_rejected	true
random_localisation_strings_string_state_religion_change_inactive_not_enough_support	Cannot change religion - not enough of your population follow this religion.\\n\\nAmount required: 	true
random_localisation_strings_string_population_too_low	Population too low	true
random_localisation_strings_string_mk_dif_swe	[[col:yellow]]Normal[[/col]]	true
random_localisation_strings_string_units_upgrade_no_upgrade_available	There are no upgrades for this unit available.	true
random_localisation_strings_string_mk_dif_swi	[[col:yellow]]Normal[[/col]]	true
random_localisation_strings_string_StratHudButton_Cannot_Demolish0	Cannot demolish	true
random_localisation_strings_string_StratHudButton_Cannot_Demolish1	You cannot demolish settlements and ports, roads, or speciality buildings at their base levels.	true
random_localisation_strings_string_unit_concerned_under_friendly_fire	Under friendly fire	true
random_localisation_strings_string_character_role_son	Son	true
random_localisation_strings_string_gfx_aoit_on_intel	Intel Accelerated	true
random_localisation_strings_string_ping_move	Move here!	true
random_localisation_strings_string_mission_reward_treasury	Treasury	true
random_localisation_strings_string_September	September	true
random_localisation_strings_string_cannot_recruit_queue_full	Your recruitment queue is full, remove other items in order to queue this unit.	true
random_localisation_strings_string_outbreak_chance	Outbreak chance	true
random_localisation_strings_string_will_draw_at_end	You will draw if the time runs out	true
random_localisation_strings_string_attacker	Attacker	true
random_localisation_strings_string_player_stats_best_4v4_placement	Best ladder placement 4v4 land	true
random_localisation_strings_string_player_stats_best_1v1_placement	Best ladder placement 1v1 land	true
random_localisation_strings_string_player_stats_best_2v2_placement	Best ladder placement 2v2 land	true
random_localisation_strings_string_player_stats_best_3v3_placement	Best ladder placement 3v3 land	true
random_localisation_strings_string_player_stats_enemy_units_wiped_out	Most enemy units wiped out	true
random_localisation_strings_string_gfx_downgraded_osx	WARNING! Graphics memory is running low, so graphics are being downgraded for this session. To avoid this in future reduce the texture quality setting.	true
random_localisation_strings_string_gfx_filtering_ani2x	Anisotropic 2x	true
random_localisation_strings_string_building_construction_requires_prereq_buildings	One of the following must be present in this settlement's primary building slot to construct this:[[col:yellow]]	true
random_localisation_strings_string_occupied_building	Occupied building	true
random_localisation_strings_string_stats_clan_current_clan_map_regions_held	text_rejected	true
random_localisation_strings_string_network_message_host_left	The host has left the game.	true
random_localisation_strings_string_tech_category_industrial	text_rejected	true
random_localisation_strings_string_copy_protection_message	text_rejected	true
random_localisation_strings_string_agent_recruitment_no_candidates	[[col:red]]There are no agent candidates available to recruit.[[/col]]	true
random_localisation_strings_string_agent_help_cannot_sabotage_fully_damaged_building	You cannot sabotage a ruined building.	true
random_localisation_strings_string_mission_penalty	Penalty:	true
random_localisation_strings_string_gatehouse	Gatehouse	true
random_localisation_strings_string_battlemap_regroup_position	Regroup position	true
random_localisation_strings_string_network_error_join_failed_rejected	Failed to join game: Rejected by host	true
random_localisation_strings_string_gfx_aa_16x16	16x	true
random_localisation_strings_string_trade_agreement_tooltip_no_borders	The ports in your home province are at full capacity.||A sea route from your capital cannot be established.	true
random_localisation_strings_string_agent_help_string_seduce_faction_leader	text_rejected	true
random_localisation_strings_string_unit_concerned_fighting_cavalry	Fighting cavalry	true
random_localisation_strings_string_character_situation_cunning_oversee_town	Overseeing Settlement	true
random_localisation_strings_string_chat_intro_text	Type /help for a list of available chat shortcuts for your current game area.	true
random_localisation_strings_string_friends	Friends	true
random_localisation_strings_string_navy_tab	Fleet	true
random_localisation_strings_string_legendary	Legendary	true
random_localisation_strings_string_c_tooltip_vassal	Vassal	true
random_localisation_strings_string_resource_tariffs	Tariffs	true
random_localisation_strings_string_trade_route_tooltip_other_factions	Others	true
random_localisation_strings_string_agents_tab	Agents	true
random_localisation_strings_string_gfx_filtering_ani4x	Anisotropic 4x	true
random_localisation_strings_string_mk_dif_epi	[[col:red]]Hard[[/col]], Hostile Neighbours	true
random_localisation_strings_string_battle_filter_clan	Clan Battles	true
random_localisation_strings_string_unit_concerned_enemy_controls_land	Enemy controls the land - must disembark!	true
random_localisation_strings_string_technology_not_yet_researched_for_this_unit_type	text_rejected	true
random_localisation_strings_string_military_force_legacy_name_garrison_navy	Garrison Fleet	true
random_localisation_strings_string_pre-battle_multiplayer_spectate	Spectate	true
random_localisation_strings_string_building_under_construction_damaged_cancel_repair	Cancelling the repair of this unfinished building will leave it in a damaged state. Construction on it will not start again until it has been repaired.	true
random_localisation_strings_string_REGION_FOOD_FACTOR_EVENTS	Events	true
random_localisation_strings_string_Completed	Completed	true
random_localisation_strings_string_gfx_shader_3_hi	Shader Model 3	true
random_localisation_strings_string_lclick_steal_tech	Left-click to attempt to steal this technology	true
random_localisation_strings_string_opponent_refuses_surrender_body	The defending force refuses to comply with your demand of surrender!	true
random_localisation_strings_string_player_stat_battles_won	Battles won	true
random_localisation_strings_string_construction_tab	Construction	true
random_localisation_strings_string_fatigue	fatigue	true
random_localisation_strings_string_predicted_income	Predicted income	true
random_localisation_strings_string_network_message_content_not_owned	You were kicked from the game due to the host selecting a DLC-specific map you do not own.	true
random_localisation_strings_string_town_industrial	text_rejected	true
random_localisation_strings_string_art_active	Left-click to research this technology. 	true
random_localisation_strings_string_mk_dif_hre	[[col:red]]Hard[[/col]], Hostile Neighbours	true
random_localisation_strings_string_mk_dif_tre	[[col:yellow]]Normal[[/col]]	true
random_localisation_strings_string_cpu_player	CPU %d	true
random_localisation_strings_string_mk_dif_ara	[[col:yellow]]Normal[[/col]], Strong Diplomacy	true
random_localisation_strings_string_mk_dif_bra	[[col:yellow]]Normal[[/col]]	true
random_localisation_strings_string_mk_dif_fra	[[col:green]]Easy[[/col]], Large Territory	true
random_localisation_strings_string_mk_dif_cro	[[col:red]]Hard[[/col]], Vassal State	true
random_localisation_strings_string_one_minute	1 Minute	true
random_localisation_strings_string_mk_dif_arm	[[col:red]]Hard[[/col]], Religious Unrest	true
random_localisation_strings_string_mk_dif_tri	[[col:yellow]]Normal[[/col]]	true
random_localisation_strings_string_character_situation_zeal_convert_character	Character Conversion	true
random_localisation_strings_string_gfx_v_high	Very High	true
random_localisation_strings_string_happiness_resistance_fame	text_rejected	true
random_localisation_strings_string_victory_conditions_conquest_best_before	text_rejected	true
random_localisation_strings_string_round_id_february	February	true
random_localisation_strings_string_victory	Victory	true
random_localisation_strings_string_REGION_FOOD_FACTOR_POOR_FERTILITY_BONUS	Faction Trait	true
random_localisation_strings_string_tile_upgrade_encampment	Encampment	true
random_localisation_strings_string_Cannot_build_fort	You are unable to build a fort.||You must be within your own province and have a general to built a fort.||You also need sufficient funds and enough open ground to build upon.||You must either raise enough funds or choose a clearer area to build upon.	true
random_localisation_strings_string_Historic	Historic Battle	true
random_localisation_strings_string_agent_help_string_nemesis	This target is naturally resistant toward your agent.	true
random_localisation_strings_string_region_specialty_naval_tradition	text_rejected	true
random_localisation_strings_string_limited_edition_required	text_rejected	true
random_localisation_strings_string_round_id_october	October	true
random_localisation_strings_string_unit_encouraged_general_rallying_nearby	General rallying nearby	true
random_localisation_strings_string_trade_agreement_tooltip_projected_value	Projected value:	true
random_localisation_strings_string_land_combatant_winning_slightly	Unit winning slightly	true
random_localisation_strings_string_campaign_difficulty_description_1	For players familiar with strategy games but new to Total War.	true
random_localisation_strings_string_campaign_difficulty_description_0	For players new to strategy games.	true
random_localisation_strings_string_campaign_difficulty_description_3	For experienced Total War players.	true
random_localisation_strings_string_campaign_difficulty_description_2	For players familiar with Total War.	true
random_localisation_strings_string_campaign_difficulty_description_4	Only for the truly hardcore! Manual saves are not allowed in campaign. Orders cannot be issued whilst a battle is paused.	true
random_localisation_strings_string_player_is_vassal_and_cannot_attack	As a puppet state you cannot declare war on another faction – only on your overlords, should you wish to break free of their suzerainty.	true
random_localisation_strings_string_agent_recruitment_no_settlment_selected	No settlement selected in which to recruit an agent.	true
random_localisation_strings_string_event_log_battle_defeat_heroic_crushing	Crushing Defeat	true
random_localisation_strings_string_finance_header_interest	Interest	true
random_localisation_strings_string_unit_upgrade_unit_damaged	This unit is not at full strength so cannot be upgraded.	true
random_localisation_strings_string_player_stats_best_clan_ladder_placement	text_rejected	true
random_localisation_strings_string_ship_card_red_destroyed	This ship was destroyed in battle.	true
random_localisation_strings_string_FACTION_FOOD_FACTOR_TECHNOLOGIES	Technology	true
random_localisation_strings_string_gfx_filtering_ani8x	Anisotropic 8x	true
random_localisation_strings_string_CAMPAIGN_POLITICS_ACTION_TYPE_ASSASSINATE	Assassinate	true
random_localisation_strings_string_unit_encouraged_rallied_by_unit_ability	Rallied by ability	true
random_localisation_strings_string_technology_status_available_to_steal_no_gentlemen	text_rejected	true
random_localisation_strings_string_art_unavailable	Left-click to set a goal for this technology.||The technologies required to unlock this will be researched automatically.	true
random_localisation_strings_string_unknown	Unknown	true
random_localisation_strings_string_diplomacy_button_cannot_request_join_war_when_at_w	text_rejected	true
random_localisation_strings_string_network_error_join_failed_password	Failed to join game:  Invalid password specified	true
random_localisation_strings_string_finance_header_unit_upkeep	Unit Upkeep	true
random_localisation_strings_string_ship_card_crew_lost_ship_scuppered	text_rejected	true
random_localisation_strings_string_battle_filter_land	Land Battles	true
random_localisation_strings_string_multiplayer_turn_begin2	Click to begin your turn.	true
random_localisation_strings_string_multiplayer_turn_begin1	Turn ended:	true
random_localisation_strings_string_character_situation_subterfuge_spy_network	Spy Networks	true
random_localisation_strings_string_effect_bundle_time	Seasons Remaining	true
random_localisation_strings_string_fe_recruitment_card_tooltip_not_unlocked	You cannot add this unit as it hasn't been unlocked yet.\\nKeep winning battles to unlock more units.	true
random_localisation_strings_string_mp_ready_error_no_faction	Player faction set	true
random_localisation_strings_string_round_id_november	November	true
random_localisation_strings_string_formatted_memory	%d Mb.	true
random_localisation_strings_string_evening	Evening	true
random_localisation_strings_string_unit_concerned_fatigue_exhausted	Exhaustion	true
random_localisation_strings_string_character_experience_progress_bar	Experience gained at this level:	true
random_localisation_strings_string_unit_encouraged_charging	Charging	true
random_localisation_strings_string_your_ally	Your ally: 	true
random_localisation_strings_string_opponent_demands_surrender_body	The attacking force demands that you surrender!	true
random_localisation_strings_string_town_intellectual	text_rejected	true
random_localisation_strings_string_StratHudbutton_limited_unit_type	You can only own a limited number of these items. You currently have %d of %d.	true
random_localisation_strings_string_MILITARY_FORCE_FOOD_FACTOR_EVENTS	Events	true
random_localisation_strings_string_building_insufficent_development_points	You don’t have enough population surplus.||Wait until this province has grown sufficiently, or upgrade and convert local buildings to help increase local growth rate.	true
random_localisation_strings_string_dlc_menu_button_own_all	You own all available DLC packs.	true
random_localisation_strings_string_trade_route_state_enemy	(Enemy)	true
random_localisation_strings_string_StratHud_Unit_Card_Recruit_Queued	Left-click to remove unit from queue, right-click for further information.	true
random_localisation_strings_string_mk_dif_ayy	[[col:green]]Easy[[/col]], Huge Territory	true
random_localisation_strings_string_player_stats_mp_consecutive_naval	Number of consecutive naval battles won	true
random_localisation_strings_string_MILITARY_FORCE_FOOD_FACTOR_STANCE	Stance	true
random_localisation_strings_string_round_id_late_may	Late May	true
random_localisation_strings_string_gfx_high	Quality	true
random_localisation_strings_string_ping_notification	Attention!	true
random_localisation_strings_string_gfx_filtering_bi	Bilinear	true
random_localisation_strings_string_unit_concerned_army_destruction	Army losses	true
random_localisation_strings_string_replenish_cancel	Cancel replenishment of selected units. Recouping:	true
random_localisation_strings_string_unhappy	Unhappy	true
random_localisation_strings_string_clan_season_end	Season Ended.	true
random_localisation_strings_string_autosaving	Auto-saving...	true
random_localisation_strings_string_pre-battle_multiplayer_play_battle	Play Battle	true
random_localisation_strings_string_mp_ready_error_no_ai_units	You must select units for the AI armies before declaring readiness.	true
random_localisation_strings_string_SkillTree_Skill_Available_Function_Tooltip	Left-click to add points, right-click to see more information. 	true
random_localisation_strings_string_action_result_type_failure	Failure	true
random_localisation_strings_string_cards_only	Cards Only	true
random_localisation_strings_string_time_days	days	true
random_localisation_strings_string_player_stats_campaign_battles_fought_personally	Campaign battles fought personally	true
random_localisation_strings_string_multiplayer_time_up_title	Time's up!	true
random_localisation_strings_string_REGION_FOOD_FACTOR_TECHNOLOGIES	Technology	true
random_localisation_strings_string_campaign_filter_friends	Friend's campaigns	true
random_localisation_strings_string_CAMPAIGN_POLITICS_ACTION_TYPE_GET_INTO_POSITION	Secure Promotion	true
random_localisation_strings_string_MILITARY_FORCE_FOOD_FACTOR_TECHNOLOGIES	Technology	true
random_localisation_strings_string_morale_surrendered	Surrendered	true
random_localisation_strings_string_cancel_construction_header	Cancel construction	true
random_localisation_strings_string_captive_option_description_release	Selling the enemy troops back to their commanders will net you profit, but will affect the integrity of your troops.	true
random_localisation_strings_string_gfx_aa_8x8	8x	true
random_localisation_strings_string_gfx_aa_4x4	4x	true
random_localisation_strings_string_finance_header_commerce_raiding	Commerce Raiding	true
random_localisation_strings_string_gfx_aa_2x2	2x	true
random_localisation_strings_string_battle_title_adrianople	Battle of Adrianople	true
random_localisation_strings_string_will_go_bankrupt	You are spending too much money and the upkeep of your armed forces is crippling your treasury. Unless taxes are raised or unnecessary units are disbanded, bankruptcy seems inevitable. Are you sure you wish to end turn?	true
random_localisation_strings_string_unit_encouraged_winning	Winning current combat	true
random_localisation_strings_string_file_io_error_not_found	File not found. Invalid filename specified.	true
random_localisation_strings_string_character_role_politician	Statesman	true
random_localisation_strings_string_FACTION_FOOD_FACTOR_POOR_FERTILITY_BONUS	Faction Trait	true
random_localisation_strings_string_leaderboard_no_entries_returned	No entries found.	true
random_localisation_strings_string_multiplayer_waiting_load	Waiting for other player to finish loading...	true
random_localisation_strings_string_mk_dif_aze	[[col:red]]Hard[[/col]], Hostile Neighbours	true
random_localisation_strings_string_CARD_STAT_BEST_4V4_LADDER_PLACEMENT_NAVAL	Best ladder placement 4v4 naval	true
random_localisation_strings_string_gfx_downgraded	WARNING! Graphics memory is running low, so your graphics are being downgraded. Check the Unlimited Video Memory box in the Advanced Graphics options to use system memory for graphics instead, but slowdowns may still occur. If this happens, un-check it and reduce the Texture Quality setting instead.	true
random_localisation_strings_string_morale	Morale	true
random_localisation_strings_string_rclick_terminate_steal_click	Right-click to cancel stealing of this technology	true
random_localisation_strings_string_pre-battle_multiplayer_auto_resolve	Auto-resolve	true
random_localisation_strings_string_building_culture_conversion	Conversion cost due to local culture	true
random_localisation_strings_string_ping_defend	Defend here!	true
random_localisation_strings_string_description	Description	true
random_localisation_strings_string_naval_recruitment_tab	Naval Recruitment	true
random_localisation_strings_string_unit_encouraged_fortification_breach	Position still defensible	true
random_localisation_strings_string_network_error_incompatible_exe	Incompatible executable version	true
random_localisation_strings_string_character_situation_cunning_counterspy	Counter-spying	true
random_localisation_strings_string_morale_routing	Routing	true
random_localisation_strings_string_at_war	At War	true
random_localisation_strings_string_destroy_transported_warning	Are you sure you wish to disband this selection?	true
random_localisation_strings_string_melee_defence	Melee Defence	true
random_localisation_strings_string_lists_tooltip2	Left-click to move to; right-click for further information	true
random_localisation_strings_string_episodic_restriction	Restricted for Prologue	true
random_localisation_strings_string_thief_tooltip	Left-click to select. Once selected, left-clicking a valid technology icon will cause an attempt to steal it.	true
random_localisation_strings_string_finances_tribute_expenditure	To others	true
random_localisation_strings_string_play_battle	Play Battle	true
random_localisation_strings_string_unit_card_lost_men_disbanded	This unit has lost too many of its men and has been disbanded.	true
random_localisation_strings_string_StratHudbutton_cannot_enlist_nocash	Cannot enlist a general||You have insufficient funds.	true
random_localisation_strings_string_weather_tooltips_fog	Fog||Severely reduced visibility.	true
random_localisation_strings_string_network_error_kicked	The host kicked you from the game.	true
random_localisation_strings_string_diplomacy_header_player_clan	text_rejected	true
random_localisation_strings_string_network_message_confirm_quit	Confirm quit?	true
random_localisation_strings_string_March	text_rejected	true
random_localisation_strings_string_settlement_spy_info_no_info	No spy information available	true
random_localisation_strings_string_character_situation_seducing	Seducing	true
random_localisation_strings_string_finance_header_tribute	Tribute	true
random_localisation_strings_string_versus	vs.	true
random_localisation_strings_string_wealth	Wealth	true
random_localisation_strings_string_player_stat_disembarks	Total disembarks	true
random_localisation_strings_string_damage	Damage	true
random_localisation_strings_string_May	text_rejected	true
random_localisation_strings_string_day	Day	true
random_localisation_strings_string_unit_upgrade_incorrect_stance	You cannot upgrade this unit as your army is not in the correct stance.	true
random_localisation_strings_string_class_middle	Middle Classes	true
random_localisation_strings_string_warning_players_without_dlc	You are about to select map containing DLC content that some players in the lobby do not own. This will result in them being kicked. Do you wish to proceed?	true
random_localisation_strings_string_player_stats_total_mp_naval_battles_completed	Total multiplayer naval battles completed	true
random_localisation_strings_string_fe_recruitment_card_tooltip_command_clash_land	You cannot recruit this unit until you have a general in your army	true
random_localisation_strings_string_ability_defend	Toggle Guard Mode||This will put your troops on the defensive. Guard mode makes your men hold position. Even if an enemy unit routs, your men will remain in position and hold the line.	true
random_localisation_strings_string_player_stat_men_killed	Total men killed or captured	true
random_localisation_strings_string_round_id_late_march	Late March	true
random_localisation_strings_string_agent_recruitment_insufficient_dev_points_expedition	[[col:red]]There is not enough surplus population here to raise a new expedition army.[[/col]]	true
random_localisation_strings_string_oppressed_by	Feels oppressed by	true
random_localisation_strings_string_ship_card_red_general_killed	The general of this ship was killed in battle.	true
random_localisation_strings_string_battle_filter_friends	Friends Battles	true
random_localisation_strings_string_manoeuverability_low	Low	true
random_localisation_strings_string_unit_concerned_projectiles_overhead	Projectiles overhead	true
random_localisation_strings_string_road	Road	true
random_localisation_strings_string_resource_exporting_percentage	Exporting:	true
random_localisation_strings_string_unit_stat_bonus_accuracy_exceptional	Exceptional accuracy	true
random_localisation_strings_string_Naval	Naval Battle	true
random_localisation_strings_string_technology_status_being_stolen	text_rejected	true
random_localisation_strings_string_agent_help_string_bribe_faction_leader	text_rejected	true
random_localisation_strings_string_defeat	Defeat	true
random_localisation_strings_string_purchase_dialog_txt	Extra downloadable content is required to join this game.	true
random_localisation_strings_string_morale_broken	Broken	true
random_localisation_strings_string_trade_agreement_tooltip_no_sea_routes	The ports in their capital are at full capacity.||A sea route from their capital cannot be established.	true
random_localisation_strings_string_cannot_recruit_general_already_full	You cannot recruit a general at this time.||You have the maximum number of units in this army already.||To recruit a general you will need to disband one of your units.	true
random_localisation_strings_string_enemy_forces	Enemy Alliance	true
random_localisation_strings_string_agent_help_string_insufficient_funds	You do not have enough funds to perform this action.	true
random_localisation_strings_string_quit_warning	If you quit now you will lose all unsaved progress	true
random_localisation_strings_string_round_id_july	July	true
random_localisation_strings_string_CARD_STAT_BEST_1V1_LADDER_PLACEMENT_NAVAL	Best ladder placement 1v1 naval	true
random_localisation_strings_string_character_situation_conversion	Province Conversion	true
random_localisation_strings_string_stats_clan_clan_leader	text_rejected	true
random_localisation_strings_string_finance_header_looting	Looting	true
random_localisation_strings_string_nations_filter_tooltip	Left-click to toggle this faction filter.	true
random_localisation_strings_string_allied	Allied	true
random_localisation_strings_string_event_log_battle_victory_close_phyrric	Pyrrhic Victory	true
random_localisation_strings_string_mission_reward	Reward:	true
random_localisation_strings_string_action_result_type_opportune_failure	Opportune Failure	true
random_localisation_strings_string_error_profile_request	text_rejected	true
random_localisation_strings_string_auto_resolve	Auto-resolve	true
random_localisation_strings_string_bribe_nonhostile_description	You are attempting to manipulate a non-hostile agent into joining your faction. This is an act of war.\\nHow will you proceed?	true
random_localisation_strings_string_load_success	Load succeeded	true
random_localisation_strings_string_range	Range	true
random_localisation_strings_string_repair_cancel	Cancel repair of selected ships. Recouping:	true
random_localisation_strings_string_character_details_panel_min	Minimum	true
random_localisation_strings_string_large	Large	true
random_localisation_strings_string_high	High	true
random_localisation_strings_string_cannot_dismantle_ruin	You must dismantle the ruin in the previous slot before this ruin can be dismantled.	true
random_localisation_strings_string_player_disconnected	has disconnected.	true
random_localisation_strings_string_character_situation_cunning_hunt_down	Apprehension	true
random_localisation_strings_string_Siege	Siege Battle	true
random_localisation_strings_string_battle_victory_minor_decisive	Decisive Victory|The enemy are dead, or fleeing to save their dishonourable lives! You have your victory!	true
random_localisation_strings_string_network_error_desync	There was a desync in the game, exiting...	true
random_localisation_strings_string_victory_conditions_tutorial	Capture the provinces listed below to win the campaign.	true
random_localisation_strings_string_gfx_aa_mlaa	MLAA	true
random_localisation_strings_string_battle_victory_major_decisive	Decisive Victory||There can be no doubt: this is a great victory! The enemy are dead, or running for their lives!	true
random_localisation_strings_string_CARD_STAT_BEST_2V2_LADDER_PLACEMENT_NAVAL	Best ladder placement 2v2 naval	true
random_localisation_strings_string_attrition_heat	This is an area of ATTRITION. Armies will suffer losses here due to the extreme heat.	true
random_localisation_strings_string_StratHudbutton_Cannot_Build2	You cannot build here while under siege	true
random_localisation_strings_string_StratHudbutton_Cannot_Build3	You must repair the first building in the chain before constructing another.	true
random_localisation_strings_string_StratHudbutton_Cannot_Build0	Cannot build	true
random_localisation_strings_string_StratHudbutton_Cannot_Build1	You cannot afford to construct this. Cost:	true
random_localisation_strings_string_yes	Yes	true
random_localisation_strings_string_mission_description	Description:	true
random_localisation_strings_string_player_stats_men_lost	Men lost	true
random_localisation_strings_string_food_percent	Production percent	true
random_localisation_strings_string_incompatible_version	Host's game version differs from yours, you will not be able to join this game	true
random_localisation_strings_string_Unit_replenishment_per_turn	Men replenished per turn: 	true
random_localisation_strings_string_battle_draw	Draw||You have fought to a standstill; the battle is a draw. Honour has been satisfied on all sides.	true
random_localisation_strings_string_trade_agreement_tooltip_no_ports_them	text_rejected	true
random_localisation_strings_string_event_log_battle_draw	Draw	true
random_localisation_strings_string_round_id_june	June	true
random_localisation_strings_string_mission_issued_end_rebellion	Crush Rebellion:	true
random_localisation_strings_string_network_message_not_responding_host	One or more players are not responding; would you like to continue waiting or drop them?	true
random_localisation_strings_string_morale_amok	Running Amok	true
random_localisation_strings_string_CARD_STAT_BEST_3V3_LADDER_PLACEMENT_NAVAL	Best ladder placement 3v3 naval	true
random_localisation_strings_string_reinforcement_tooltip	A friendly force may be reinforced from this position.	true
random_localisation_strings_string_never	Never	true
random_localisation_strings_string_queued_building_blocked_by_stance_expedition	This expedition must settle to complete this building. Left-click to remove a building from the queue, right-click for further information.	true
random_localisation_strings_string_mp_ready_error_no_opposition	You cannot declare ready as you have no opposition	true
random_localisation_strings_string_repair_cost	Repair cost:	true
random_localisation_strings_string_unit_encouraged_general_alive	General alive	true
random_localisation_strings_string_network_message_kicked_by_host	You were kicked by the host.	true
random_localisation_strings_string_stats_clan_current_clan_members_active	text_rejected	true
random_localisation_strings_string_finance_header_building_upkeep	Building Maintenance	true
random_localisation_strings_string_pre-battle_multiplayer_play_as_ai	Play as AI	true
random_localisation_strings_string_unit_encouraged_army_supported	Supporting army	true
random_localisation_strings_string_ground	Ground	true
random_localisation_strings_string_allied_forces	Your Alliance	true
random_localisation_strings_string_ping_attack	Attack here!	true
random_localisation_strings_string_technology_status_unavailable	text_rejected	true
random_localisation_strings_string_resource_not_acquired	This resource is not yet acquired.	true
random_localisation_strings_string_power_ranking	Strength ranking	true
random_localisation_strings_string_game_aborted	Game aborted	true
random_localisation_strings_string_stat_shield	Shield value	true
random_localisation_strings_string_network_error_join_failed_game_full	Failed to join game: Game full	true
random_localisation_strings_string_unit_concerned_attacked_by_artillery	Attacked by artillery	true
random_localisation_strings_string_land_combatant_losing	Unit losing	true
random_localisation_strings_string_declare_war_ally_not_requested_help	This ally has not requested your assistance in this war.	true
random_localisation_strings_string_building_under_construction_damaged	This unfinished building is damaged and all construction on it has halted. Select it and click the Repair button to fix it and continue the construction.	true
random_localisation_strings_string_wall_strength	Wall strength	true
random_localisation_strings_string_round_id_early_august	Early August	true
random_localisation_strings_string_stats_clan_steam_group_creation_date	text_rejected	true
random_localisation_strings_string_battle_victory_heroic_crushing	Heroic Victory||This is victory: glorious, heroic, magnificent victory! Your foes are utterly crushed!	true
random_localisation_strings_string_finance_header_vassals	Vassals	true
random_localisation_strings_string_gfx_on	On	true
random_localisation_strings_string_mission_issuer	Issued by:	true
random_localisation_strings_string_audio_provider_stereo_speakers	Stereo speakers	true
random_localisation_strings_string_stat_base_reload_time	Base reload time	true
random_localisation_strings_string_round_id_late_april	Late April	true
random_localisation_strings_string_fire_damage	Fire Damage	true
random_localisation_strings_string_agent_help_string_agent_cap_reached	[[col:red]]You are already fielding the current maximum number of this type of character. Increase your imperium to recruit more.[[/col]]	true
random_localisation_strings_string_StratHudbutton_cannot_repair_nocash	Cannot repair||You have insufficient funds.||Disband an unused unit or increase taxes to raise funds. 	true
random_localisation_strings_string_player_stat_battles_started	Battles started	true
random_localisation_strings_string_campaign_autoresolver_tooltip_stance_siege_balanced	When using the balanced battle stance, units will receive no bonuses or penalties.	true
random_localisation_strings_string_art_being_researched	You are currently researching this technology.	true
random_localisation_strings_string_function_building_upgrade_hud	Left-click to order upgrade, right-click for further information.	true
random_localisation_strings_string_pip_general_tooltip_loyalty_4	Loyalty: Dependable	true
random_localisation_strings_string_pip_general_tooltip_loyalty_5	Loyalty: Steadfast	true
random_localisation_strings_string_pip_general_tooltip_loyalty_6	Loyalty: Incorruptible	true
random_localisation_strings_string_pip_general_tooltip_loyalty_1	Loyalty: Treacherous	true
random_localisation_strings_string_pip_general_tooltip_loyalty_2	Loyalty: Questionable	true
random_localisation_strings_string_pip_general_tooltip_loyalty_3	Loyalty: Sufficient	true
random_localisation_strings_string_will_go_bankrupt_title	Imminent bankruptcy!	true
random_localisation_strings_string_night	Night	true
random_localisation_strings_string_unit_concerned_flank_attacked	Attacked in flank	true
random_localisation_strings_string_clear_advice_warning	You are about to clear your advice history. Are you sure?	true
random_localisation_strings_string_reinforcement_arrows	Any arrows indicate forces that can reinforce this army in battle.	true
random_localisation_strings_string_player_stats_total_campaign_battles	Total campaign battles	true
random_localisation_strings_string_multiplayer_default	mp_default	true
random_localisation_strings_string_finance_header_construction	Construction	true
random_localisation_strings_string_unit_concerned_general_recently_died	General recently died	true
random_localisation_strings_string_attrition_cold	In winter, armies will suffer losses due to attrition if they are in enemy territory. 	true
random_localisation_strings_string_overwrite_legendary_save_warning_title	Overwrite exsisting legendary save?	true
random_localisation_strings_string_replenish_some_unable	Unable to replenish some of the units in this selection, some are unavailable for recruitment locally.	true
random_localisation_strings_string_horde_icon_tooltip_expedition	Expedition\\n\\nThis faction is campaigning and has no regions.	true
random_localisation_strings_string_clan_points	text_rejected	true
random_localisation_strings_string_heir	Heir	true
random_localisation_strings_string_player_stats_alliances_made	Alliances made	true
random_localisation_strings_string_agent_recruitment_reduced_changed_bodyguard	[[col:red]]Not enough money to commission full new bodyguard - current bodyguard will be depleted.[[/col]]	true
random_localisation_strings_string_faction_not_allowed	text_rejected	true
random_localisation_strings_string_unlock_agent_action_to_embed_in_army	To act upon this army you must unlock the following action: 	true
random_localisation_strings_string_move_options_multiplayer_cannot_declare_war	You cannot declare war against your multiplayer co-op partner.	true
random_localisation_strings_string_locked_slot_requires_castle_upgrade	text_rejected	true
random_localisation_strings_string_chat_ping_msg	Ping placed	true
random_localisation_strings_string_finance_header_fleet_upkeep	Fleet Upkeep	true
random_localisation_strings_string_stat_mount_hp	Mount HP	true
random_localisation_strings_string_no_building	no building	true
random_localisation_strings_string_April	text_rejected	true
random_localisation_strings_string_player_stats_total_men_dead	Men killed in battle (friend or foe)	true
random_localisation_strings_string_trade_node_tooltip_base_supply	supplies to be gained from first trade ship	true
random_localisation_strings_string_ability_phase_mask_unbreakable	Unbreakable	true
random_localisation_strings_string_move_options_vassal_cannot_declare_war	text_rejected	true
random_localisation_strings_string_melee_attack	Melee Attack	true
random_localisation_strings_string_destroy_transported_message	Destroying these units will result in the loss of any force or characters they are currently transporting.	true
random_localisation_strings_string_low	Low	true
random_localisation_strings_string_unit_concerned_general_dead	General dead	true
random_localisation_strings_string_you	You	true
random_localisation_strings_string_mission_issued_recruit_unit	Recruit Unit:	true
random_localisation_strings_string_wako_pirates_demand	Amount demanded:	true
random_localisation_strings_string_June	text_rejected	true
random_localisation_strings_string_none	None	true
random_localisation_strings_string_stat_explosion_damage	Explosive damage	true
random_localisation_strings_string_load_campaign	Load Campaign Game	true
random_localisation_strings_string_multiplayer_turn_end	Turn complete.\\n\\nWaiting for:	true
random_localisation_strings_string_midday	Mid-day	true
random_localisation_strings_string_network_message_vac_you_kicked	You were kicked from the game due to VAC authentication failure.	true
random_localisation_strings_string_finances_vassal_income_breakdown_other	text_rejected	true
random_localisation_strings_string_round_id_late_august	Late August	true
random_localisation_strings_string_character_details_panel_max	Maximum	true
random_localisation_strings_string_campaign_autoresolver_tooltip_stance_naval_aggressive	Your units will try to rush the enemy. Usually more effective when the enemy has missile superiority. Expect higher casualties.	true
random_localisation_strings_string_campaign_autoresolver_tooltip_stance_land_aggressive	Your units will try to rush the enemy. Usually more effective when the enemy has missile superiority. Expect higher casualties.	true
random_localisation_strings_string_growth_rate	Growth rate	true
random_localisation_strings_string_leaderboard_no_response_from_server	text_rejected	true
random_localisation_strings_string_stat_bonus_elephant	Bonus vs elephant	true
random_localisation_strings_string_victory_conditions_conquest	text_rejected	true
random_localisation_strings_string_content_locked	Content Locked	true
random_localisation_strings_string_normal	Normal	true
random_localisation_strings_string_network_message_player_dropped	has been dropped from the game.	true
random_localisation_strings_string_July	text_rejected	true
random_localisation_strings_string_ally	Ally	true
random_localisation_strings_string_early	Early	true
random_localisation_strings_string_small	Small	true
random_localisation_strings_string_upload_failed	Upload failed. Please check your internet connection and try again.	true
random_localisation_strings_string_player_stats_units_recruited	Units recruited	true
random_localisation_strings_string_network_message_you_dropped	You have lost connection to the game. 	true
random_localisation_strings_string_power_ranking_tooltip	This is their faction's strength ranking, rated against all existing factions	true
random_localisation_strings_string_predicted_income_explanation	This is the amount of money you are expected to make in the next turn. It is not a prediction of your total treasury amount.	true
random_localisation_strings_string_full	Full	true
random_localisation_strings_string_self	Self	true
random_localisation_strings_string_clan_demotion	text_rejected	true
random_localisation_strings_string_finance_header_total_income	Total Income	true
random_localisation_strings_string_Economics_Bar	text_rejected	true
random_localisation_strings_string_network_message_player_left	has left the game.	true
random_localisation_strings_string_battle_defeat_heroic_crushing	Crushing Defeat||This is a shameful defeat! You've suffered a crushing loss.	true
random_localisation_strings_string_marked_for_dismantling	Marked for dismantling	true
random_localisation_strings_string_enemy	Enemy	true
random_localisation_strings_string_action_result_type_guaranteed	Guaranteed	true
random_localisation_strings_string_effect_bundle_tooltip	Current Effects||Successfully completing missions and facing certain game events will trigger short-term effects upon your clan or provinces.	true
random_localisation_strings_string_multiplayer_waiting_reconnect	Waiting for players...	true
random_localisation_strings_string_population_surplus_expedition	Population surplus||The expedition needs people if it is to grow. Population surplus enables this, as well as the launching of new expeditions. Encampment and raiding are vital to expedition growth.	true
random_localisation_strings_string_all	All	true
random_localisation_strings_string_round_id_late_january	Late January	true
random_localisation_strings_string_num_breaches	Minimum number of Breaches	true
random_localisation_strings_string_factors_governing_relationship	Factors governing relationship with %S:	true
random_localisation_strings_string_mission_reward_land_experience	Experience for all land units	true
random_localisation_strings_string_target	Target	true
random_localisation_strings_string_FACTION_PROVINCE_FOOD_FACTOR_FERTILITY	Fertility	true
random_localisation_strings_string_reliability	Trustworthiness	true
random_localisation_strings_string_battle_victory_close_phyrric	Pyrrhic Victory||You are victorious, but at what cost? Many have paid the ultimate price.	true
random_localisation_strings_string_vhard	Very Hard	true
random_localisation_strings_string_ultra	Ultra	true
random_localisation_strings_string_port	Port	true
random_localisation_strings_string_singleplayer_default	sp_default	true
random_localisation_strings_string_gfx_extreme	Extreme Quality	true
random_localisation_strings_string_player_stats_enemy_ships_sunk	Enemy ships sunk	true
random_localisation_strings_string_farm	Farm	true
random_localisation_strings_string_lists_tooltip	Double left-click to move to; right-click for further information	true
random_localisation_strings_string_hard	Hard	true
random_localisation_strings_string_technology_tooltip_researching_numeric_info	Estimated research time:	true
random_localisation_strings_string_town_factor_industry	Commerce	true
random_localisation_strings_string_cannot_begin_battle_map_downloading	You cannot start a battle whilst the map is being downloaded from the host.	true
random_localisation_strings_string_technology_status_available_to_steal	text_rejected	true
random_localisation_strings_string_upkeep_cost	Upkeep Cost	true
random_localisation_strings_string_sea_region_control_status_controlled	Controlled	true
random_localisation_strings_string_battle_regroup_position_marker	Regroup position	true
random_localisation_strings_string_CAMPAIGN_POLITICS_ACTION_TYPE_ASSASSINATE_WIFE	Assassinate Wife	true
random_localisation_strings_string_easy	Easy	true
random_localisation_strings_string_instruction_regroup_ability	Right-click on a position to set a regroup marker, click on the button cancel this ability.	true
random_localisation_strings_string_cost	Cost:	true
random_localisation_strings_string_test	test	true
random_localisation_strings_string_settlement_strength	Settlement strength	true
random_localisation_strings_string_land_combatant_even	combat even	true
random_localisation_strings_string_network_error_incompatible_map_version	Incorrect version of map	true
random_localisation_strings_string_audio_provider_windows_default	System default	true
random_localisation_strings_string_fatigue_winded	Winded	true
random_localisation_strings_string_audio_provider_directsound_3d_hardware	DirectSound 3D hardware	true
random_localisation_strings_string_reveal	Reveal	true
random_localisation_strings_string_player_stats_best_2v2_skill	Best all time skill rating 2v2 land	true
random_localisation_strings_string_player_stats_best_3v3_skill	Best all time skill rating 3v3 land	true
random_localisation_strings_string_player_stats_best_1v1_skill	Best all time skill rating 1v1 land	true
random_localisation_strings_string_player_stats_best_4v4_skill	Best all time skill rating 4v4 land	true
random_localisation_strings_string_thousand_abbreviated	k	true
random_localisation_strings_string_StratHud_Building_Card_Recruit_Queued	Left-click to remove a building from the queue, right-click for further information.	true
random_localisation_strings_string_happy	Happy	true
random_localisation_strings_string_button_advice_tooltip	Click for advice on this panel	true
random_localisation_strings_string_stat_men_hp	Men HP	true
random_localisation_strings_string_save_success	Save succeeded	true
random_localisation_strings_string_exceeds_all_budgets	Exceeds all budgets	true
random_localisation_strings_string_battle_victory_minor_heroic	Heroic Victory||The battle is done, and the heads counted! This is a notable victory!	true
random_localisation_strings_string_trade_agreement_tooltip_no_route_them	A sea route from their capital cannot be established.	true
random_localisation_strings_string_stat_bonus_infantry	Bonus vs infantry	true
random_localisation_strings_string_tile_upgrade_settlement_escalation1	Escalation level 1	true
random_localisation_strings_string_tile_upgrade_settlement_escalation2	Escalation level 2	true
random_localisation_strings_string_postbattle_town_wealth	Predicted town wealth	true
random_localisation_strings_string_FACTION_FOOD_FACTOR_CHARACTERS	Characters	true
random_localisation_strings_string_victory_conditions_prestige_additional	text_rejected	true
random_localisation_strings_string_cpu	CPU	true
random_localisation_strings_string_mission_issued_capture_city	Capture City:	true
random_localisation_strings_string_character_situation_paying_off	Paying Off	true
random_localisation_strings_string_indestructible	Indestructible	true
random_localisation_strings_string_technology_status_unavailable_building	text_rejected	true
random_localisation_strings_string_clan_members	text_rejected	true
random_localisation_strings_string_other_factors	Other factors	true
random_localisation_strings_string_morale_steady	Steady	true
random_localisation_strings_string_event_log_rebellion_peasant	text_rejected	true
random_localisation_strings_string_million_abbreviated	m	true
random_localisation_strings_string_repair_not_required	No repairs required for ships in this selection.	true
random_localisation_strings_string_invalid_replay_file	Failed to load battle replay.  Invalid file specified.	true
random_localisation_strings_string_chat_telestration_msg	Telestration message sent	true
random_localisation_strings_string_conversion_factor_osmosis_christian	text_rejected	true
random_localisation_strings_string_cannot_show_projectile_stats	\\n\\n(Cannot display projectile stats when multiple units are selected with different projectiles.)	true
random_localisation_strings_string_region_specialty_prime_forest	text_rejected	true
random_localisation_strings_string_unit_concerned_losing	Losing current combat	true
random_localisation_strings_string_network_error_join_failed_incompatible	Failed to join game: Incompatible versions	true
random_localisation_strings_string_fleet_status_transit2	En route to:	true
random_localisation_strings_string_fleet_status_transit1	In transit	true
random_localisation_strings_string_agent_help_string_bribe_vassal	text_rejected	true
random_localisation_strings_string_diplomacy_panel_hostage_held	Your hostage held:	true
random_localisation_strings_string_fe_recruitment_card_tooltip_cap_reached_sea	You are unable to add anymore units of this type as you have reached the limit of %d per fleet.	true
random_localisation_strings_string_agent_help_string_coop_action	You cannot perform this action on another player in a co-operative campaign.	true
random_localisation_strings_string_town	Town	true
random_localisation_strings_string_morale_shaken	Shaken	true
random_localisation_strings_string_player_stats_total_mp_land_battles_completed	Total multiplayer land battles completed	true
random_localisation_strings_string_network_error_incompatible_mod	Incompatible mod version	true
random_localisation_strings_string_ruined	Ruined	true
random_localisation_strings_string_art_already_researched	You have already researched this technology.	true
random_localisation_strings_string_army_recruitment_limit_reached	You have recruited the maximum number of units into this army.	true
random_localisation_strings_string_expert	Very Hard	true
random_localisation_strings_string_raided	Raided	true
random_localisation_strings_string_you_cannot_afford_to_repair_this_item	You cannot afford to repair this item. Cost:	true
random_localisation_strings_string_guerrilla_cant_deploy	text_rejected	true
random_localisation_strings_string_late	Late	true
random_localisation_strings_string_tile_upgrade_settlement_level2	Large	true
random_localisation_strings_string_tile_upgrade_settlement_level3	Large	true
random_localisation_strings_string_tile_upgrade_settlement_level1	Small	true
random_localisation_strings_string_tile_upgrade_settlement_level4	Extra Large	true
random_localisation_strings_string_rebel_faction_name_override	Rebels	true
random_localisation_strings_string_network_message_steam_connection_lost	Connection to Steam was lost.	true
random_localisation_strings_string_ping_standard	Look here!	true
random_localisation_strings_string_cancel_repair_building	This building will be repaired once your turn has ended. Left-click to cancel repair order.	true
random_localisation_strings_string_fatigue_active	Active	true
random_localisation_strings_string_seamen	text_rejected	true
random_localisation_strings_string_agent_help_string_high_loyalty	The target has a very high loyalty rating, making him harder to bribe.	true
random_localisation_strings_string_overwrite_msg	You are attempting to save over an existing file, overwrite it?	true
random_localisation_strings_string_bonus	Bonus:	true
random_localisation_strings_string_trade_status_tooltip_already_trading	Already trading	true
random_localisation_strings_string_exit_theatre_tooltip	Exit theatre here	true
random_localisation_strings_string_attrition_cold_immune	Units in your army are immune from winter attrition.	true
random_localisation_strings_string_network_message_waiting_for_response	Waiting for a response from a network player.	true
random_localisation_strings_string_win_chance_moderate	Moderate	true
random_localisation_strings_string_character_role_admiral	Admiral	true
random_localisation_strings_string_player_stats_nations_destroyed	Factions destroyed	true
random_localisation_strings_string_rally_ability	Rally troops	true
random_localisation_strings_string_quit_battle	You are about to quit this battle.  Are you sure?	true
random_localisation_strings_string_ability_fire_at_will	Toggle Fire-at-Will||Fire-at-will allows units to fire at enemies within range whenever they see fit.	true
random_localisation_strings_string_unit_concerned_general_fled_recently	General fled recently	true
random_localisation_strings_string_unit_concerned_settlement_destruction	Settlement destruction	true
random_localisation_strings_string_region_factor_industry	Commerce	true
random_localisation_strings_string_character_role_general	General	true
random_localisation_strings_string_expedition_occupy_confirmation	Occupying a settlement will lead to your declaration of independence and therefore an end to Imperial support for this expedition. All expedition objectives and rewards will become unattainable but, if your faction is successful there may be a chance to re-establish the Western Empire.	true
random_localisation_strings_string_always	Always	true
random_localisation_strings_string_win_chance_low	Low	true
random_localisation_strings_string_Unit_replenishment_complete_in	Turns until this unit is fully replenished: 	true
random_localisation_strings_string_medium	Medium	true
random_localisation_strings_string_button_cancel_slot_instruction_active	Click this button to cancel any action on the currently selected item.	true
random_localisation_strings_string_click_to_show_on_map	Click to show on map	true
random_localisation_strings_string_player_stats_num_sword_duels	Number of sword duels won	true
random_localisation_strings_string_CARD_STAT_BEST_1V1_SKILL_NAVAL	Best all-time skill rating 1v1 naval	true
random_localisation_strings_string_CARD_STAT_BEST_3V3_SKILL_NAVAL	Best all-time skill rating 3v3 naval	true
random_localisation_strings_string_CARD_STAT_BEST_2V2_SKILL_NAVAL	Best all-time skill rating 2v2 naval	true
random_localisation_strings_string_CARD_STAT_BEST_4V4_SKILL_NAVAL	Best all-time skill rating 4v4 naval	true
random_localisation_strings_string_agent_recruitment_insufficient_money_for_different_bodyguard	[[col:red]]Not enough money to commission new bodyguard.[[/col]]	true
random_localisation_strings_string_CapturePoint	Capture Point Battle	true
random_localisation_strings_string_diplomacy_button_must_be_at_peace_to_protect	text_rejected	true
random_localisation_strings_string_benchmark_dialog_body	Do you want to exit the current benchmark?	true
random_localisation_strings_string_network_error_steam_disconnect	You have been disconnected from Steam.  Please re-start Steam to continue.	true
random_localisation_strings_string_unit_concerned_night_battle_unprepared	Unprepared for night battle	true
random_localisation_strings_string_FACTION_PROVINCE_FOOD_FACTOR_BASE_FOOD	Base Food	true
random_localisation_strings_string_state_religion_change_inactive_faction_leader_already_changed	Cannot change religion - your faction leader has already changed religion once.	true
random_localisation_strings_string_agent_help_string_enemy_counter_agent	An enemy counter-agent reduces your chances of success.	true
random_localisation_strings_string_fortification	Fortification	true
random_localisation_strings_string_attrition_sea	Ships that move here will suffer attrition	true
random_localisation_strings_string_unit_concerned_fatigue_tired	Tired	true
random_localisation_strings_string_gfx_drop_low	Max. Performance	true
random_localisation_strings_string_player_stats_miles_covered_campaign	Number of miles covered by your campaign units (land and sea)	true
random_localisation_strings_string_gate_with_oil	(with oil)	true
random_localisation_strings_string_finance_header_total_upkeep	Total Upkeep	true
random_localisation_strings_string_invalid_army_setup_alliance	A player has an invalid army setup	true
random_localisation_strings_string_round_id_late_october	Late October	true
random_localisation_strings_string_error_chat_room_failed	Chat Error||Failed to create chat room.	true
random_localisation_strings_string_technology_disabled_by	Disabled by	true
random_localisation_strings_string_pre-battle_multiplayer_retreat	Retreat	true
random_localisation_strings_string_power_ranking_tooltip_player	This is your faction's strength ranking, rated against all existing factions	true
random_localisation_strings_string_mp_ready_error_no_ai_faction	AI faction not set	true
random_localisation_strings_string_no_repairs_required	No repairs required	true
random_localisation_strings_string_campaign_autoresolver_tooltip_stance_defensive	Your units will assume a defensive position. Usually more effective when you have missile superiority. Expect lower casualties on both sides.	true
random_localisation_strings_string_slaves_percent	Immigrant percent	true
random_localisation_strings_string_region_capital	Settlement	true
random_localisation_strings_string_FACTION_PROVINCE_FOOD_FACTOR_EVENTS_IN_REGIONS	Region Events	true
random_localisation_strings_string_reason	Reason:	true
random_localisation_strings_string_random	Random	true
random_localisation_strings_string_finances_other_income	Income from other sources.	true
random_localisation_strings_string_weather_tooltips_dry	Dry||No adverse effects.	true
random_localisation_strings_string_audio_provider_dolby_surround	Dolby surround	true
random_localisation_strings_string_character_situation_sea_attack	Naval Attacks	true
random_localisation_strings_string_enemy_mencount	Enemy man count	true
random_localisation_strings_string_player_stats_regions_conquered	Provinces conquered	true
random_localisation_strings_string_CAMPAIGN_POLITICS_ACTION_TYPE_MARRIAGE	Marriage	true
random_localisation_strings_string_instruction_inspire_ability	Left-click on a unit to inspire them, right-click to cancel this ability.	true
random_localisation_strings_string_diplomacy_panel_hostage_given	Their hostage given:	true
random_localisation_strings_string_under_repair	Under repair	true
random_localisation_strings_string_military_force_legacy_name_rebel_army	Rebel Army	true
random_localisation_strings_string_fe_recruitment_card_tooltip_cap_reached_land	You are unable to add anymore units of this type as you have reached the limit of %d per army.	true
random_localisation_strings_string_attrition_heat_immune	Units in your army are immune from desert attrition.	true
random_localisation_strings_string_Military_Bar	Military	true
random_localisation_strings_string_unaffordable	Unaffordable	true
random_localisation_strings_string_player_stats_enemy_men_killed	Enemy men killed	true
random_localisation_strings_string_diplomacy_button_need_peace_to_ally	text_rejected	true
random_localisation_strings_string_right_click_building_browser	Right-click to view in building browser	true
random_localisation_strings_string_wako_pirates_current_treasury	Current treasury:	true
random_localisation_strings_string_campaign_autoresolver_tooltip_stance_naval_balanced	When using the balanced battle stance, units will receive no bonuses or penalties.	true
random_localisation_strings_string_enter_contested_region_warning	There is a revolution in your home province. If you move troops in, be aware that some of them may join the rebels.\\n\\nContinue?	true
random_localisation_strings_string_replenish_not_required	No replenish required for units in this selection.	true
random_localisation_strings_string_campaign_autoresolver_tooltip_stance_siege_aggressive	Your units will try to rush the enemy. Usually more effective when the enemy has missile superiority. Expect higher casualties.	true
random_localisation_strings_string_unit_concerned_general_incapacitated	General incapacitated	true
random_localisation_strings_string_campaing_public_order_tooltip_header	Public Order Details	true
random_localisation_strings_string_conversion_factor_general_christian	text_rejected	true
random_localisation_strings_string_player_stats_ranked_battles_started	Ranked battles started	true
random_localisation_strings_string_diplomacy_button_no_trade_agreement_to_cancel	There is no trade agreement to cancel.	true
random_localisation_strings_string_network_error_incompatible_missing_map	Map not found	true
random_localisation_strings_string_unit_encouraged_on_the_hill	On high ground	true
random_localisation_strings_string_round_id_may	May	true
random_localisation_strings_string_total_numeric	Total	true
random_localisation_strings_string_multiplayer_time_up	You have run out of time and your turn is over.	true
random_localisation_strings_string_skill_current_level	Current level:	true
random_localisation_strings_string_Feature_unavailable	Unavailable in this campaign	true
random_localisation_strings_string_manoeuverability_high	High	true
random_localisation_strings_string_victory_conditions_deadline	Complete by the end of your turn in:	true
random_localisation_strings_string_StratHudbutton_cannot_demolish	You cannot demolish settlements and ports, roads, or speciality buildings at their base levels.	true
random_localisation_strings_string_reduced_unit_limit_msg	The host has reduced the maximum unit setting causing some to be removed from your setup.	true
random_localisation_strings_string_Middle	text_rejected	true
random_localisation_strings_string_controls_save_key_list	Save Key List	true
random_localisation_strings_string_character_situation_zeal_inspire_army	Inspiring Armies	true
random_localisation_strings_string_ally_attacked_ally_attacking	Your ally has declared war on another faction and calls for your help!	true
random_localisation_strings_string_unit_concerned_melee_contact	Melee contact	true
random_localisation_strings_string_sea_region_control_status_contested	Contested	true
random_localisation_strings_string_player_stats_ranked_naval_battles_won	Ranked naval battles won	true
random_localisation_strings_string_ability_phase_mask_minor_casualties	Inflict minor casualties	true
random_localisation_strings_string_morale_turn_until_rebellion	At the current rate, there will be a mutiny in %n turns.	true
random_localisation_strings_string_round_id_april	April	true
random_localisation_strings_string_controls_load_key_list	Load Keys List	true
random_localisation_strings_string_finances_vassal_income	Total from vassals	true
random_localisation_strings_string_event_log_battle_defeat_minor_close	Close Defeat	true
random_localisation_strings_string_Unit_is_suffering_attrition	In winter, units in enemy territory will suffer losses due to attrition. Move the unit outside of the enemy area to stop further attrition.	true
random_localisation_strings_string_ability_phase_mask_kill_self	Kill self	true
random_localisation_strings_string_region_specialty_gold_mining	text_rejected	true
random_localisation_strings_string_repair_no_selection	Select damaged ships to use the repair feature.	true
random_localisation_strings_string_effect_bundle_target_global	text_rejected	true
random_localisation_strings_string_network_message_if_not_wait_game_ends	If you choose not to wait, the game will end for everyone	true
random_localisation_strings_string_round_id_early_june	Early June	true
random_localisation_strings_string_esc_menu_legendary_cannot_save	You cannot save games when playing in legendary difficulty, instead the game will automatically save during the end turn process.	true
random_localisation_strings_string_round_id_early_october	Early October	true
random_localisation_strings_string_player_stats_ranked_naval_battles_lost	Ranked naval battles lost	true
random_localisation_strings_string_Failed	Failed	true
random_localisation_strings_string_ability_loose	Toggle Loose Formation||Loose formation spreads units out, making them much harder to hit with missiles, but greatly reduces their ability to resist charges.	true
random_localisation_strings_string_unit_concerned_damaged_by_artillery	Damaged by artillery	true
random_localisation_strings_string_REGION_FOOD_FACTOR_FERTILITY	Fertility	true
random_localisation_strings_string_CAMPAIGN_POLITICS_ACTION_TYPE_ADOPT	Adopt	true
random_localisation_strings_string_prestige_category_6	Feeble	true
random_localisation_strings_string_prestige_category_4	Moderate	true
random_localisation_strings_string_prestige_category_5	Weak	true
random_localisation_strings_string_prestige_category_2	Majestic	true
random_localisation_strings_string_prestige_category_3	Respected	true
random_localisation_strings_string_prestige_category_1	Sublime	true
random_localisation_strings_string_quit_game_main	You are about to quit the game.  Are you sure?	true
random_localisation_strings_string_building_insufficent_development_points_number	You need %n population surplus.||Wait until this province has grown sufficiently, or upgrade and convert local buildings to help increase local growth rate.	true
random_localisation_strings_string_town_factor_technology	text_rejected	true
random_localisation_strings_string_ability_phase_mask_cant_move	Cannot move	true
random_localisation_strings_string_round_id_early_march	Early March	true
random_localisation_strings_string_agent_help_string_low_success_chance	Your chances of success are too slight for your agent to perform this action.	true
random_localisation_strings_string_unit_concerned_enemy_numbers	Enemy numbers nearby	true
random_localisation_strings_string_uniform_editor_custom	Custom	true
random_localisation_strings_string_round_id_early_july	Early July	true
random_localisation_strings_string_audio_provider_mono	Mono	true
random_localisation_strings_string_player_stats_campaign_land_battles_won	Campaign land battles won	true
random_localisation_strings_string_gfx_shader_3	Shader Model 3 (Low)	true
random_localisation_strings_string_gfx_shader_2	Shader Model 2	true
random_localisation_strings_string_gfx_shader_5	Shader Model 5	true
random_localisation_strings_string_gfx_shader_4	Shader Model 4	true
random_localisation_strings_string_CAMPAIGN_POLITICS_ACTION_TYPE_DIVORCE	Divorce	true
random_localisation_strings_string_player_stat_battles_finished	Battles finished	true
random_localisation_strings_string_ally_attacked_ally_defending	Your ally is under attack and calls for your help!	true
random_localisation_strings_string_player_stats_most_men_killed	Most men killed in a battle	true
random_localisation_strings_string_owner_colon	Owner:	true
random_localisation_strings_string_FACTION_FOOD_FACTOR_RAIDING	Raiding	true
random_localisation_strings_string_ability_phase_mask_major_casualties	Inflict major casualties	true
random_localisation_strings_string_no_host_name	Please enter a valid game name before attempting to host game	true
random_localisation_strings_string_FACTION_PROVINCE_FOOD_FACTOR_RECENT_BATTLES	Devastation from Battles	true
random_localisation_strings_string_unit_encouraged_flanks_secure	Flanks secure	true
random_localisation_strings_string_ally_attacked_ally_attack_ally	War has broken out between your allies!	true
random_localisation_strings_string_StratHudbutton_Cannot_Recruit_Naval2	Your fleet is already full, to construct this ship you will need to scupper another.	true
random_localisation_strings_string_StratHudbutton_Cannot_Recruit_Naval3	You cannot construct a ship here while the port is blockaded.	true
random_localisation_strings_string_StratHudbutton_Cannot_Recruit_Naval0	Cannot construct ship	true
random_localisation_strings_string_StratHudbutton_Cannot_Recruit_Naval1	You cannot afford to construct this ship. Cost:	true
random_localisation_strings_string_StratHudbutton_Cannot_Recruit_Naval6	The recruitment building for this unit is damaged and will need to be repaired first.	true
random_localisation_strings_string_StratHudbutton_Cannot_Recruit_Naval4	You cannot construct a ship here while the port is damaged.	true
random_localisation_strings_string_no_valid_units	No valid units found in setup	true
random_localisation_strings_string_StratHudbutton_Cannot_Recruit_Naval5	You cannot construct a ship here while you the port is occupied by an enemy.	true
random_localisation_strings_string_Recruit_Travel_Turns	Recruitment turns||The left-hand number shows the number of turns needed to recruit this unit.||The right-hand number shows the number of turns this unit takes to reach its recruiting general.||Generals can recruit units in the field. Recruited units are transported directly to his location.	true
random_localisation_strings_string_diplomacy_button_cannot_wed	text_rejected	true
random_localisation_strings_string_tile_upgrade_settlement_no_escalation	No escalation	true
random_localisation_strings_string_left_click_view_tree	Left-click to view this building tree.	true
random_localisation_strings_string_ability_disembark_from_ship	Disembark||Disembark from your ship.	true
random_localisation_strings_string_ancillary_unlocking_next_turn	[[col:yellow]]Household member/object in transit. It will take effect as of the next turn.[[/col]]	true
random_localisation_strings_string_character_situation_zeal_incite_unrest	Inciting Unrest	true
random_localisation_strings_string_unit_stat_bonus_melee_superior	Superior melee	true
random_localisation_strings_string_unit_concerned_flanks_exposed_multiple	Flanks exposed	true
random_localisation_strings_string_settlement_under_siege	text_rejected	true
random_localisation_strings_string_hosting_error	Hosting error	true
random_localisation_strings_string_total_value	Total value	true
random_localisation_strings_string_captive_option_title_release	Ransom & Release Captives	true
random_localisation_strings_string_network_error_join_failed_no_response	Failed to join game: No response from host	true
random_localisation_strings_string_battle_defeat_minor_decisive	Decisive Defeat||There is no doubt: defeat is your fate. Your men are scattered or dead.	true
random_localisation_strings_string_diplomacy_button_must_be_at_peace_to_marriage	text_rejected	true
random_localisation_strings_string_battle_defeat_major_decisive	Decisive Defeat||Truly: shame and dishonour will stain this day's memory. This is a terrible defeat to suffer!	true
random_localisation_strings_string_StratHudbutton_Cannot_Enlist_General0	Cannot enlist general	true
random_localisation_strings_string_StratHudbutton_Cannot_Enlist_General1	You have the maximum number of generals already.	true
random_localisation_strings_string_StratHudbutton_Cannot_Enlist_General2	There are no candidates from which to pick a general.	true
random_localisation_strings_string_StratHudbutton_Cannot_Enlist_General3	Your fleet is already full, to recruit an admiral  you must scupper one of your ships.	true
random_localisation_strings_string_StratHudbutton_Cannot_Enlist_General4	Your army is already full, to recruit a general  you must disband one of your units.	true
random_localisation_strings_string_StratHudbutton_Cannot_Enlist_General5	You cannot afford to recruit a general. Cost:	true
random_localisation_strings_string_player_stats_successful_assassinations	Successful assassinations	true
random_localisation_strings_string_mission_issued_blockade_port	Blockade Port:	true
random_localisation_strings_string_Ship_is_suffering_attrition	This ship is suffering attrition as it is on the high seas. Move the ship outside of the attritional area to prevent this from happening.	true
random_localisation_strings_string_fatigue_fresh	Fresh	true
random_localisation_strings_string_character_type_title_brother	Brother	true
random_localisation_strings_string_agent_help_str_request_allegiance_no_support	Influence in this province is too low. Increase influence over 50%	true
random_localisation_strings_string_unit_encouraged_kills	Kills inflicted on enemy	true
random_localisation_strings_string_unit_encouraged_in_column_formation	In column formation	true
random_localisation_strings_string_unit_encouraged_enemy_routing	Enemy routing	true
random_localisation_strings_string_tech_category_military	text_rejected	true
random_localisation_strings_string_province_colon	Province:	true
random_localisation_strings_string_error_twitch_stream	Error while streaming to Twitch.tv. Streaming will stop.	true
random_localisation_strings_string_megabytes_formatted	%d Mb.	true
random_localisation_strings_string_invalid_units	Invalid unit type found in setup	true
random_localisation_strings_string_trade_agreement_tooltip_no_route_you	The ports in your home province are at full capacity.||A sea route from your capital cannot be established.	true
random_localisation_strings_string_finance_header_upkeep	Upkeep	true
random_localisation_strings_string_REGION_FOOD_FACTOR_BASE_FOOD	Base Food	true
random_localisation_strings_string_captive_option_title_enslave	Take On Warriors	true
random_localisation_strings_string_player_stats_ranked_land_battles_won	Ranked land battles won	true
random_localisation_strings_string_left_click_return_list	Left-click to return to the buildings list.	true
random_localisation_strings_string_network_error_no_steam	text_rejected	true
random_localisation_strings_string_military_force_legacy_name_prefix_navy	Classis	true
random_localisation_strings_string_action_result_type_critical_success	Critical Success	true
random_localisation_strings_string_round_id_early_april	Early April	true
random_localisation_strings_string_REGION_FOOD_FACTOR_BUILDINGS	Buildings	true
random_localisation_strings_string_agent_help_string_cannot_incite_kyoto	text_rejected	true
random_localisation_strings_string_diplomacy_button_cannot_trade_embargo	There are no trade routes to declare an embargo against.	true
random_localisation_strings_string_pip_daimyo_tooltip_honour_1	Honour: Unworthy	true
random_localisation_strings_string_pip_daimyo_tooltip_honour_2	Honour: Lowly	true
random_localisation_strings_string_pip_daimyo_tooltip_honour_3	Honour: Unproven	true
random_localisation_strings_string_pip_daimyo_tooltip_honour_4	Honour: Estimable	true
random_localisation_strings_string_pip_daimyo_tooltip_honour_5	Honour: Distinguished	true
random_localisation_strings_string_pip_daimyo_tooltip_honour_6	Honour: Exemplary	true
random_localisation_strings_string_battle_warning_returning_to_postbattle	Exiting battle in:	true
random_localisation_strings_string_mp_ready_error_ai_invalid_army_index	An AI player is assigned an army that is already taken. Please assign them another before declaring ready.	true
random_localisation_strings_string_morale_eager	Eager	true
random_localisation_strings_string_technology_tooltip_researching_functionality	Left-click to research, right-click for further information.	true
random_localisation_strings_string_Tutorial_Custom_Battle_Warning_Header	Custom Battle	true
random_localisation_strings_string_unit_concerned_rear_attacked	Attacked in the rear	true
random_localisation_strings_string_FACTION_PROVINCE_FOOD_FACTOR_RAIDING	Raiding	true
random_localisation_strings_string_mission_issued_public_order	Restore Public Order:	true
random_localisation_strings_string_agent_help_string_region_in_rebellion	Rebels are already active in this province.	true
random_localisation_strings_string_player_stats_total_mp_land_battles_won	Total multiplayer land battles won	true
random_localisation_strings_string_round_id_march	March	true
random_localisation_strings_string_replenish_no_selection	Select depleted units to use the replenish feature.	true
random_localisation_strings_string_round_id_late_december	Late December	true
random_localisation_strings_string_character_situation_subterfuge_spying	Spying	true
random_localisation_strings_string_fe_recruitment_card_tooltip_command_clash_sea	You cannot recruit this unit until you have a general in your army	true
random_localisation_strings_string_town_factor_ministers	text_rejected	true
random_localisation_strings_string_technology_status_available	text_rejected	true
random_localisation_strings_string_Tutorial_Custom_Battle_Warning_Content	text_rejected	true
random_localisation_strings_string_unit_stat_bonus_melee_improved	Improved melee	true
random_localisation_strings_string_StratHudbutton_Cannot_Recruit_Unit8	You cannot recruit this unit until you have studied and mastered the required art for it.	true
random_localisation_strings_string_StratHudbutton_Cannot_Recruit_Unit9	You cannot recruit this unit until you have constructed the additional building required for it.	true
random_localisation_strings_string_StratHudbutton_Cannot_Recruit_Unit2	You cannot afford to recruit this unit. Cost:	true
random_localisation_strings_string_StratHudbutton_Cannot_Recruit_Unit3	 	true
random_localisation_strings_string_StratHudbutton_Cannot_Recruit_Unit0	Cannot recruit unit	true
random_localisation_strings_string_StratHudbutton_Cannot_Recruit_Unit1	There is no path available from this unit's place of recruitment to the recruiting force.	true
random_localisation_strings_string_StratHudbutton_Cannot_Recruit_Unit6	The population number is too low to recruit from, you will have to wait until it grows.	true
random_localisation_strings_string_StratHudbutton_Cannot_Recruit_Unit7	You have already recruited the maximum number of this unit.	true
random_localisation_strings_string_StratHudbutton_Cannot_Recruit_Unit4	You cannot recruit a unit here while you are under siege	true
random_localisation_strings_string_StratHudbutton_Cannot_Recruit_Unit5	The recruitment building for this unit is damaged and must be repaired first.	true
random_localisation_strings_string_resource_value	Resource Value	true
random_localisation_strings_string_win_chance_very_high	Very High	true
random_localisation_strings_string_unit_encouraged_overwhelming_friendly_units	Superior local force	true
random_localisation_strings_string_battle_defeat_close_phyrric	Valiant Defeat||The enemy has won, but it has cost them dearly. Their dead litter the field!	true
random_localisation_strings_string_network_error_join_failed_closed_game	Failed to join game: Game in progress	true
random_localisation_strings_string_CAMPAIGN_POLITICS_ACTION_TYPE_SPREAD_RUMOURS	Spread Rumours	true
random_localisation_strings_string_ability_drop_siege_equipment	Drop Siege Equipment||Drops your current siege equipment.	true
random_localisation_strings_string_event_log_battle_defeat_close_phyrric	Valiant Defeat	true
random_localisation_strings_string_Unit_not_replenishing_09_expedition	Expedition units may only replenish when encamped or when in allied territory.	true
random_localisation_strings_string_Tutorial_Custom_Battle_Warning	text_rejected	true
random_localisation_strings_string_technology_status_unavailable_to_steal	Either this technology is already known or you are not sufficiently advanced to use it.	true
random_localisation_strings_string_town_factor_bankruptcy	Bankruptcy	true
random_localisation_strings_string_diplomacy_button_need_access_to_cancel_access	There is no military access to cancel.	true
random_localisation_strings_string_finances_tribute_expenditure_breakdown_other	text_rejected	true
random_localisation_strings_string_network_message_not_responding_client	One or more players are not responding; would you like to continue waiting or leave the game?	true
random_localisation_strings_string_religion_factor_percentage_next_turn	Percentage next turn: %d%	true
random_localisation_strings_string_fe_unit_card_tooltip_cap_land	Units of this type are capped to %d per army.	true
random_localisation_strings_string_FACTION_PROVINCE_FOOD_FACTOR_EDICTS	Edicts	true
random_localisation_strings_string_FACTION_PROVINCE_FOOD_FACTOR_EVENTS	Province Events	true
random_localisation_strings_string_stats_clan_clan_total_ranked_game_wins	text_rejected	true
random_localisation_strings_string_campaign_type_world_domination	Domination Campaign	true
random_localisation_strings_string_stat_ap_damage	Armour-piercing damage	true
random_localisation_strings_string_food_breakdown	Food Details	true
random_localisation_strings_string_resource_exporting_percentage_not_full	Increasing trade routes will increase the percentage of this resource you can export.	true
random_localisation_strings_string_unit_concerned_flanks_exposed_single	Exposed flank	true
random_localisation_strings_string_military_force_legacy_name_pirate_navy	Pirate Fleet	true
random_localisation_strings_string_gfx_drop_ultra	Max. Quality	true
random_localisation_strings_string_mission_issued_trade_agreement	Establish Trade:	true
random_localisation_strings_string_mp_ready_error_no_map_selected	No map has been selected	true
random_localisation_strings_string_finance_header_raided	Raiding	true
random_localisation_strings_string_campaign_type_co_op	Co-op	true
random_localisation_strings_string_predicted_with_units_removed	predicted, if selected units are removed from garrison	true
random_localisation_strings_string_gfx_shader_4_1	Shader Model 4.1	true
random_localisation_strings_string_trade_agreement_tooltip_existing_route_shifted	One of your current sea trade routes is eligible for diversion over land.||Another sea route from your capital may be established.	true
random_localisation_strings_string_state_religion_change_active	Change religion	true
random_localisation_strings_string_technology_status_researched	text_rejected	true
random_localisation_strings_string_StratHud_Unit_Card_Recruit_Selection	Left-click to recruit this unit, right-click for further information.	true
random_localisation_strings_string_victory_conditions_conquest_tutorial	Capture and hold %n provinces, including the following:	true
random_localisation_strings_string_FACTION_FOOD_FACTOR_RIVALRY	Rivalry	true
random_localisation_strings_string_pre_battle_siege_equipment_totals_tooltip_cap	\\nCap: %d	true
random_localisation_strings_string_CAMPAIGN_POLITICS_ACTION_TYPE_BRIBE	Bribe	true
random_localisation_strings_string_character_situation_subterfuge_assassination	Assassinations	true
random_localisation_strings_string_StratHudbutton_cannot_disembark_here	Cannot disembark||You cannot disembark here, the land is inaccessible.	true
random_localisation_strings_string_home_region_expedition	None (Expedition)	true
random_localisation_strings_string_fatigue_tired	Tired	true
random_localisation_strings_string_network_error_stats_no_steam	text_rejected	true
random_localisation_strings_string_FACTION_FOOD_FACTOR_FERTILITY	Fertility	true
random_localisation_strings_string_mission_issued_form_alliance	Form Alliance:	true
random_localisation_strings_string_FACTION_PROVINCE_FOOD_FACTOR_HORDES	Hordes in this Province	true
random_localisation_strings_string_morale_20	Questionable	true
random_localisation_strings_string_benchmark_dialog_title	Exit Benchmark	true
random_localisation_strings_string_military_force_legacy_name_prefix_army	Legio	true
random_localisation_strings_string_Tutorial_First_Battle_Warning	text_rejected	true
random_localisation_strings_string_battle_time_remaining	Time remaining:	true
random_localisation_strings_string_network_error_dropped	You have lost connection to the game. 	true
random_localisation_strings_string_overwrite_legendary_save_warning_text	Starting a new game on legendary will overwrite your current legendary save. Do you still want to continue?	true
random_localisation_strings_string_campaign_type_short	Short Campaign	true
random_localisation_strings_string_network_error_authentication_failed	You are not authorised to play	true
random_localisation_strings_string_mp_ready_error_no_commander	You must add a commander before starting the battle.	true
random_localisation_strings_string_finance_header_taxes	Taxes	true
random_localisation_strings_string_unit_concerned_attacked_by_projectile	Under missile fire	true
random_localisation_strings_string_finance_header_other	Other	true
random_localisation_strings_string_finance_header_mines	Mines	true
random_localisation_strings_string_event_log_battle_defeat_major_decisive	Decisive Defeat	true
random_localisation_strings_string_land_combatant_losing_slightly	Unit losing slightly	true
random_localisation_strings_string_weather_tooltips_storm	Sandstorm|| It takes longer to ignite ships, buildings, and deployable defences.	true
random_localisation_strings_string_August	text_rejected	true
random_localisation_strings_string_mp_ready_error_too_many_armies	You cannot declare ready as there are too many players for the selected map. \\nEither change the map, or remove some players.	true
random_localisation_strings_string_campaign_autoresolver_tooltip_stance_naval_defensive	Your units will assume a defensive position. Usually more effective when you have missile superiority. Expect lower casualties on both sides.	true
random_localisation_strings_string_agent_help_string_cannot_incite_own_religion	text_rejected	true
random_localisation_strings_string_finance_header_trade	Trade	true
random_localisation_strings_string_unit_encouraged_fortification	Inside fort	true
random_localisation_strings_string_character_type_title_general	General	true
random_localisation_strings_string_bribe_nonhostile_panel_title	Manipulation Attempt	true
random_localisation_strings_string_MILITARY_FORCE_FOOD_FACTOR_FERTILITY	Fertility	true
random_localisation_strings_string_character_role_wife	Wife	true
random_localisation_strings_string_finance_header_agent_actions	Agent Actions	true
random_localisation_strings_string_finance_header_ransom_battle_captives	Ransom from battle captives	true
random_localisation_strings_string_character_situation_land_siege_attack	Siege Attacks	true
random_localisation_strings_string_chat_help_text	HELP\\nCommand format: /command argument1 argument2 \\nYou can cycle through suggestions with the UP/DOWN keys, and press TAB to select a suggestion (for chat commands and player names).\\n\\nAvailable commands:\\n	true
random_localisation_strings_string_Empty_building_warning	\\n\\nIf you leave this site undeveloped for too long, slums will appear.	true
random_localisation_strings_string_Change_Reinforcement_Position	Drag and drop unit cards to change their position in the reinforcement queue. 	true
random_localisation_strings_string_class_lower	Lower Classes	true
random_localisation_strings_string_network_error_title	Error	true
random_localisation_strings_string_class_upper	The Nobility	true
random_localisation_strings_string_victory_conditions_one_vs_one	text_rejected	true
random_localisation_strings_string_region_colon	Region:	true
random_localisation_strings_string_diplomacy_button_need_peace_to_trade	text_rejected	true
random_localisation_strings_string_battle_filter_naval	Naval Battles	true
random_localisation_strings_string_morale_60	Reliable	true
random_localisation_strings_string_finance_header_total_expenses	Total Expenses	true
random_localisation_strings_string_StratHudbutton_Cannot_Repair_Naval2	You can only repair ships within a port	true
random_localisation_strings_string_StratHudbutton_Cannot_Repair_Naval0	Cannot repair	true
random_localisation_strings_string_StratHudbutton_Cannot_Repair_Naval1	You cannot afford to repair this item. Cost:	true
random_localisation_strings_string_trade_status_tooltip_cannot	Cannot trade	true
random_localisation_strings_string_player_stats_num_pistol_duels	text_rejected	true
random_localisation_strings_string_Unit_not_replenishing_09	Hordes may only replenish when encamped or when in allied territory.	true
random_localisation_strings_string_Unit_not_replenishing_08	- This navy is not in friendly waters.	true
random_localisation_strings_string_Unit_not_replenishing_05	- You are bankrupt.	true
random_localisation_strings_string_Unit_not_replenishing_04	- It is under siege.	true
random_localisation_strings_string_Unit_not_replenishing_07	- This army is not in friendly territory.	true
random_localisation_strings_string_Unit_not_replenishing_06	- There is a food shortage.	true
random_localisation_strings_string_Unit_not_replenishing_01	This unit cannot be replenished because:	true
random_localisation_strings_string_Unit_not_replenishing_03	- There is no general in this army.	true
random_localisation_strings_string_Unit_not_replenishing_02	- Recent events	true
random_localisation_strings_string_round_id_early_january	Early January	true
random_localisation_strings_string_StratHudbutton_Cannot_Recruit_Geisha2	You cannot afford to recruit this agent. Cost:	true
random_localisation_strings_string_character_situation_subterfuge_sabotage_army	Army Sabotage	true
random_localisation_strings_string_auto_save_filename_legendary	auto_save_legendary	true
random_localisation_strings_string_stats_clan_best_clan_map_rank	text_rejected	true
random_localisation_strings_string_gempei_religion_colon	Allegiance:	true
random_localisation_strings_string_StratHudbutton_cannot_enlist_no_cand	text_rejected	true
random_localisation_strings_string_morale_40	Obedient	true
random_localisation_strings_string_mp_ready_error_no_siege_units	You must select some infantry or artillery units capable of assaulting fortifications.	true
random_localisation_strings_string_Unit_not_replenishing_10	Enemy army in region is blocking replenishment	true
random_localisation_strings_string_tax_level_4	Extortionate	true
random_localisation_strings_string_tax_level_0	Minimal	true
random_localisation_strings_string_tax_level_1	Low	true
random_localisation_strings_string_tax_level_2	Normal	true
random_localisation_strings_string_tax_level_3	High	true
random_localisation_strings_string_ship_card_red_captured	This ship was captured by the enemy!	true
random_localisation_strings_string_fe_unit_card_tooltip_cap_naval	Units of this type are capped to %d per fleet.	true
random_localisation_strings_string_StratHudbutton_Cannot_Recruit_Metuske2	You cannot afford to recruit this agent. Cost:	true
random_localisation_strings_string_trade_route_tooltip_neutral	(others)	true
random_localisation_strings_string_cannot_merge_agent_not_enough_action_points	This agent hasn't enough action points to reach the other force.	true
random_localisation_strings_string_player_stats_successful_duels	Successful duels	true
random_localisation_strings_string_FACTION_PROVINCE_FOOD_FACTOR_ARMIES	Enemy Armies in this Province	true
random_localisation_strings_string_conversion_factor_characters_christian	text_rejected	true
random_localisation_strings_string_land_combatant_winning	Unit winning	true
random_localisation_strings_string_repair_prerequisites_not_met	You need to be in a port and have sufficient funds to repair the selected ships in this navy. Cost:	true
random_localisation_strings_string_agent_recruitment_insufficient_money	[[col:red]]You do not have enough money in your treasury to recruit this character.[[/col]]	true
random_localisation_strings_string_trade_status_tooltip_value_potential	\\nPotential value:	true
random_localisation_strings_string_weather_tooltips_snow	Snow||Units move slower in the snow and takes longer to recover from fatigue.	true
random_localisation_strings_string_Empty_building	Construction Site||You can construct new buildings here.	true
random_localisation_strings_string_unit_encouraged_general_nearby	General nearby	true
random_localisation_strings_string_unit_concerned_friends_routing	Friends routing	true
random_localisation_strings_string_public_order	Current public order	true
random_localisation_strings_string_trade_route	Trade route	true
random_localisation_strings_string_agent_recruitment_reduced_bodyguard	[[col:red]]Not enough money - current bodyguard will be depleted.[[/col]]	true
random_localisation_strings_string_FACTION_FOOD_FACTOR_BUILDINGS	Buildings	true
random_localisation_strings_string_SkillTree_Skill_Unavailable_Function_Tooltip_0	Unavailable	true
random_localisation_strings_string_character_situation_zeal_inspire_town	text_rejected	true
random_localisation_strings_string_SkillTree_Skill_Unavailable_Function_Tooltip_1	You haven't got the required skill points to purchase this.	true
random_localisation_strings_string_SkillTree_Skill_Unavailable_Function_Tooltip_2	You have not met the skill requirements for this.	true
random_localisation_strings_string_SkillTree_Skill_Unavailable_Function_Tooltip_3	This skill belongs to another branch.	true
random_localisation_strings_string_trade_node_tooltip_predicted_supply	estimated supplies to be gained	true
random_localisation_strings_string_player_stats_ranked_land_battles_lost	Ranked land battles lost	true
random_localisation_strings_string_stats_clan_current_highest_ranked_4v4_clan_team_na	text_rejected	true
random_localisation_strings_string_mission_issued_build_building	Construct Building:	true
random_localisation_strings_string_campaign_difficulty_slider_legendary	Manual saves not allowed in campaign. Orders cannot be issued when a battle is paused.	true
random_localisation_strings_string_campaign_type_prestige	Prestige Victory	true
random_localisation_strings_string_controls_empty	<Empty>	true
random_localisation_strings_string_fe_recruitment_card_tooltip_required_ancillary	Member of your character's household required to use this unit:	true
random_localisation_strings_string_town_factor_discontent	Discontent	true
random_localisation_strings_string_FACTION_FOOD_FACTOR_BASE_FOOD	Base Food	true
random_localisation_strings_string_event_log_battle_victory_minor_close	Close Victory	true
random_localisation_strings_string_diplomacy_button_cannot_military_access_war	text_rejected	true
random_localisation_strings_string_weather_storm	Sandstorm	true
random_localisation_strings_string_diplomacy_header_other_clans	text_rejected	true
random_localisation_strings_string_campaign_autoresolver_tooltip_stance_siege_defensive	Your units will assume a defensive position. Usually more effective when you have missile superiority. Expect lower casualties on both sides.	true
random_localisation_strings_string_unit_card_lost_hero_disbanded	text_rejected	true
random_localisation_strings_string_morale_80	Devoted	true
random_localisation_strings_string_player_stats_friendly_units_rallied	Most friendly units rallied	true
random_localisation_strings_string_agent_cannot_act_force_full	This force already has the maximum number of agents within it.	true
random_localisation_strings_string_front_end_unit_size_with_fleet_tooltip	Scales the number of men in each unit in land battles, and the maximum number of ships allowed in a fleet. Reducing this may improve game performance in battles considerably.	true
random_localisation_strings_string_region_specialty_stone	text_rejected	true
random_localisation_strings_string_region_specialty_iron_mining	text_rejected	true
random_localisation_strings_string_finance_header_income	Income	true
random_localisation_strings_string_action_result_type_critical_failure	Critical Failure	true
random_localisation_strings_string_stat_xp_value	XP bonus	true
random_localisation_strings_string_stats_clan_current_highest_ranked_2v2_clan_team_na	text_rejected	true
random_localisation_strings_string_town_factor_education	Education	true
random_localisation_strings_string_stats_clan_current_clan_ladder_rank	text_rejected	true
random_localisation_strings_string_unit_concerned_fear_enemy_unit	Frightened by enemy unit	true
random_localisation_strings_string_trade_route_tooltip_raid_value	Trade route raid value:	true
random_localisation_strings_string_StratHudbutton_Ruined_Building	Ruined Building||Until repaired, this building is ineffective.	true
random_localisation_strings_string_finances_tribute_expenditure_breakdown_faction	%S (turns remaining %d)	true
random_localisation_strings_string_round_id_late_february	Late February	true
random_localisation_strings_string_tech_required_for_construction	text_rejected	true
random_localisation_strings_string_diplomacy_button_no_trade_to_demand_they_break	text_rejected	true
random_localisation_strings_string_MILITARY_FORCE_FOOD_FACTOR_CHARACTERS	Characters	true
random_localisation_strings_string_building_under_construction_damaged_demolish	Click here to cancel repair of unfinished buildings.	true
random_localisation_strings_string_event_log_rebellion_christian	text_rejected	true
random_localisation_strings_string_replenish_selection	Replenish depleted units in the selection. Cost:	true
random_localisation_strings_string_stats_clan_current_highest_ranked_3v3_clan_team_na	text_rejected	true
random_localisation_strings_string_character_situation_land_siege_defence	Siege Defence	true
random_localisation_strings_string_cannot_enter_enemy_zoc	You cannot enter an enemy force’s zone of control except to make an attack.	true
random_localisation_strings_string_round_id_late_november	Late November	true
random_localisation_strings_string_Single	Single	true
random_localisation_strings_string_ability_formed_attack	Formation Attack||The unit will try to stay in formation when in melee.	true
random_localisation_strings_string_unit_card_lost_men_captured	This unit has been captured by the enemy.	true
random_localisation_strings_string_tech_building_tooltip2	text_rejected	true
random_localisation_strings_string_tech_building_tooltip1	text_rejected	true
random_localisation_strings_string_finance_header_civic	Civic	true
random_localisation_strings_string_MILITARY_FORCE_FOOD_FACTOR_BASE_FOOD	Base Food	true
random_localisation_strings_string_confirm_delete_title	Confirm Delete	true
random_localisation_strings_string_cancel_demolish_building_once_settled	This horde needs to settle in order to finish dismantling this building. Left-click to cancel demolish order.	true
random_localisation_strings_string_clan_promotion	text_rejected	true
random_localisation_strings_string_tech_category_enlightenment	text_rejected	true
random_localisation_strings_string_conversion_factor_buildings_christian	text_rejected	true
random_localisation_strings_string_MILITARY_FORCE_FOOD_FACTOR_BUILDINGS	Buildings	true
random_localisation_strings_string_weather_tooltips_rain	Rain|| It takes more to ignite ships, buildings, and deployables.	true
