key	text	tooltip
#Loc;1;text/db/regions.loc		
regions_onscreen_cha_reg_franconia_frankfurt	Франкфурт	true
regions_battle_name_cha_reg_gascony_bordeaux	Бордо	true
regions_onscreen_bel_reg_tuscia_et_umbria_faesulae	Фесули	true
regions_onscreen_att_reg_bithynia_nicomedia	Нікея	true
regions_onscreen_att_reg_gallaecia_brigantium	Сантьяґо	true
regions_onscreen_att_reg_hercynia_budorgis	Вроцлав	true
regions_battle_name_cha_reg_northumbria_york	Йорк	true
regions_onscreen_att_reg_belgica_colonia_agrippina	Антверпен	true
regions_onscreen_att_reg_belgica_durocorterum	Турне	true
regions_onscreen_cha_sea_lake	Лейк	true
regions_onscreen_bel_reg_byzacena_thysdrus	Тисдрус	true
regions_battle_name_att_reg_aethiopia_aksum	Лалібела	true
regions_battle_name_att_reg_media_atropatene_rhaga	Рей	true
regions_battle_name_cha_sea_atlantic_ocean	Атлантичний океан	true
regions_onscreen_att_sea_sinus_syracusanus	Сиракузька затока	true
regions_battle_name_att_reg_mediterraneus_orientalis_gortyna	Кандія	true
regions_battle_name_cha_reg_exarchate_ancona	Анкона	true
regions_onscreen_bel_reg_picenum_suburbicarium_ancona	Анкона	true
regions_onscreen_cha_reg_munster_cork	Корк	true
regions_onscreen_bel_reg_tuscia_et_umbria_arretium	Арреціум	true
regions_battle_name_bel_reg_sicilia_syracuse	Сиракузи	true
regions_onscreen_att_reg_tarraconensis_caesaraugusta	Сарагоса	true
regions_onscreen_att_reg_sarmatia_asiatica_samandar	Дербент	true
regions_battle_name_cha_reg_obodrites_rerik	Рерік	true
regions_battle_name_att_reg_terra_incognita	Невідома Земля	true
regions_battle_name_att_reg_pannonia_sirmium	Белград	true
regions_onscreen_bel_reg_austrasia_remorum	Реморум	true
regions_onscreen_cha_reg_rome_siena	Сієна	true
regions_onscreen_cha_reg_gascony_agen	Ажен	true
regions_onscreen_cha_reg_west_neustria_nantes	Нант	true
regions_onscreen_bel_reg_byzacena_sufetula	Суфетула	true
regions_onscreen_att_reg_mediterraneus_orientalis_constantia	Фамагуста	true
regions_battle_name_att_reg_syria_antiochia	Антіохія	true
regions_battle_name_att_sea_mare_tyrrhenum	Тірренське море	true
regions_battle_name_att_reg_sarmatia_asiatica_tanais	Тана	true
regions_battle_name_cha_reg_leon_valladoid	Вальядолід	true
regions_battle_name_bel_reg_austrasia_mettis	Меттіс	true
regions_onscreen_att_reg_caledonia_et_hibernia_tuesis	Інвернесс	true
regions_onscreen_att_reg_dacia_romula	Тирговіште	true
regions_onscreen_att_reg_sarmatia_europaea_gelonus	Шарукан	true
regions_onscreen_att_reg_aquitania_burdigala	Бордо	true
regions_battle_name_att_reg_dardania_serdica	Средець	true
regions_battle_name_att_reg_media_atropatene_ganzaga	Тебріз	true
regions_onscreen_att_reg_raetia_et_noricum_iuvavum	Відень	true
regions_battle_name_att_sea_danuvius	Дунай	true
regions_battle_name_cha_reg_marca_hispanica_tarragona	Таррагона	true
regions_onscreen_cha_reg_rome_spoleto	Сполето	true
regions_battle_name_bel_reg_cantabria_legio	Легіо	true
regions_battle_name_bel_reg_tuscia_et_umbria_pisae	Піза	true
regions_battle_name_cha_reg_alemannia_basel	Базель	true
regions_battle_name_att_reg_baetica_hispalis	Севілья	true
regions_onscreen_cha_reg_rome_roma	Рим	true
regions_onscreen_bel_reg_sardinia_et_corsica_aleria	Алерія	true
regions_onscreen_att_reg_cilicia_myra	Атталея	true
regions_onscreen_att_reg_armenia_tosp	Фургон	true
regions_onscreen_bel_sea_mare_africum	Африканське море	true
regions_onscreen_bel_reg_provence_massilia	Масілія	true
regions_onscreen_att_reg_sarmatia_asiatica_anacopia	Бата	true
regions_onscreen_cha_reg_exarchate_ravenna	Равенна	true
regions_onscreen_cha_reg_wessex_winchester	Вінчестер	true
regions_battle_name_bel_sea_mare_tyrrhenum	Тірренське море	true
regions_onscreen_cha_reg_east_neustria_amiens	Ам'єн	true
regions_onscreen_bel_reg_mauretania_tingitana_anfa	Анфа	true
regions_onscreen_att_reg_germania_lupfurdum	Бранденбург	true
regions_battle_name_att_reg_germania_uburzis	Франкфурт	true
regions_battle_name_cha_reg_wales_mathrafal	Матрафал	true
regions_battle_name_bel_sea_oceanus_gallicus	Гальський океан	true
regions_onscreen_cha_reg_wessex_canterbury	Кентербері	true
regions_battle_name_cha_reg_austrasia_aachen	Аахен	true
regions_battle_name_cha_reg_lombardy_pavia	Павія	true
regions_onscreen_cha_reg_exarchate_bologna	Болонья	true
regions_onscreen_cha_sea_ligurian_sea	Лігурійське море	true
regions_onscreen_cha_reg_gallicia_santiago	Сантьяго	true
regions_onscreen_bel_reg_burgundy_besantio	Безантіо	true
regions_battle_name_bel_reg_lucania_et_brutii_rhegium	Регіум	true
regions_onscreen_cha_sea_balearic_sea	Балеарське море	true
regions_battle_name_att_reg_venetia_aquileia	Венеція	true
regions_onscreen_att_reg_caucasia_mtskheta	Тбілісі	true
regions_onscreen_att_reg_gothiscandza_gothiscandza	Гданськ	true
regions_onscreen_bel_reg_dalmatia_tarsatica	Тарсатика	true
regions_onscreen_att_reg_gallaecia_bracara	Брага	true
regions_onscreen_bel_reg_gallaecia_bracara	Бракара	true
regions_battle_name_bel_reg_lucania_et_brutii_crotona	Кротона	true
regions_battle_name_bel_reg_praeualitana_epidaurum	Епідаурум	true
regions_onscreen_att_reg_britannia_inferior_eboracum	Йорк	true
regions_onscreen_bel_sea_lake	Лейк	true
regions_onscreen_bel_reg_byzacena_hadrumentum	Хадрументум	true
regions_battle_name_att_reg_mediterraneus_orientalis_rhodes	Родос	true
regions_battle_name_att_reg_thracia_constantinopolis	Константинополь	true
regions_battle_name_att_reg_sarmatia_europaea_chersonessus	Кафа	true
regions_onscreen_cha_reg_gharb_al_anadalus_seville	Севілья	true
regions_battle_name_att_reg_palaestinea_aila	Акаба	true
regions_battle_name_att_reg_transcaspia_kath	Ургенч	true
regions_onscreen_cha_reg_marca_media_caceres	Касерес	true
regions_onscreen_att_reg_britannia_inferior_lindum	Ноттінгем	true
regions_onscreen_cha_reg_septimania_urgell	Ургель	true
regions_onscreen_att_reg_asia_synnada	Дорилайон	true
regions_onscreen_att_reg_germania_aregelia	Віттенберг	true
regions_onscreen_att_reg_khwarasan_abarshahr	Нішапур	true
regions_battle_name_cha_reg_sicilia_syracuse	Сиракузи	true
regions_battle_name_cha_reg_sicilia_panormos	Панормос	true
regions_onscreen_cha_reg_pictland_dumbarton	Дамбартон	true
regions_onscreen_bel_reg_brittany_osismorum	Осізмів	true
regions_battle_name_cha_reg_navarre_saragossa	Сарагоса	true
regions_onscreen_att_reg_dacia_apulum	Дюлафегервар	true
regions_onscreen_cha_reg_leon_leon	Леон	true
regions_onscreen_att_reg_hercynia_nitrahwa	Естергом	true
regions_onscreen_bel_reg_terra_incognita_transalpina	Невідома Земля	true
regions_battle_name_cha_reg_bavaria_augsburg	Аугсбург	true
regions_onscreen_att_reg_macedonia_corinthus	Містра	true
regions_onscreen_cha_reg_valencia_valencia	Валенсія	true
regions_onscreen_att_reg_mauretania_tingis	Фес	true
regions_battle_name_att_sea_mare_illyricum	Іллірійське море	true
regions_onscreen_cha_sea_gulf_of_lion	Затока Лева	true
regions_onscreen_cha_reg_pannonia_kaposvar	Капошвар	true
regions_onscreen_cha_reg_benevento_benevento	Беневенто	true
regions_battle_name_cha_reg_austrasia_trier	Трір	true
regions_onscreen_att_reg_pannonia_sopianae	Печ	true
regions_onscreen_cha_reg_benevento_salerno	Салерно	true
regions_battle_name_cha_reg_leon_santander	Сантандер	true
regions_battle_name_att_reg_libya_ptolemais	Барса	true
regions_onscreen_att_reg_syria_tyrus	Акра	true
regions_battle_name_att_reg_khwarasan_harey	Герат	true
regions_battle_name_att_sea_oceanus_gallicus	Гальске море	true
regions_onscreen_att_reg_arabia_felix_zafar	Маріб	true
regions_onscreen_cha_reg_wilzi_brandenburg	Бранденбург	true
regions_onscreen_cha_sea_mediterranean_sea	Середземне море	true
regions_onscreen_att_reg_britannia_superior_corinium	Брістоль	true
regions_onscreen_att_reg_transcaspia_dahistan	Горган	true
regions_battle_name_bel_reg_terra_incognita	Невідома Земля	true
regions_battle_name_cha_reg_brittany_st_malo	Сен-Мало	true
regions_onscreen_att_reg_arabia_magna_hira	Куфа	true
regions_onscreen_bel_reg_tarraconensis_caesaraugusta	Цезараугуста	true
regions_onscreen_att_reg_lusitania_olisipo	Лісабон	true
regions_onscreen_att_reg_caledonia_et_hibernia_eblana	Дублін	true
regions_onscreen_bel_reg_apulia_et_calabria_hydruntum	Гідрунтум	true
regions_onscreen_bel_reg_brittany_riedonum	Рідонум	true
regions_battle_name_att_sea_mare_phoenicum	Фінікійське море	true
regions_onscreen_bel_reg_sardinia_et_corsica_turris	Турріс	true
regions_onscreen_att_reg_asorstan_ctesiphon	Багдад	true
regions_battle_name_att_reg_narbonensis_narbo	Монпельє	true
regions_onscreen_att_reg_caledonia_et_hibernia_eildon	Единбург	true
regions_battle_name_att_reg_sarmatia_europaea_olbia	Білгород	true
regions_onscreen_cha_reg_franconia_hallstadt	Гальштадт	true
regions_battle_name_att_reg_aethiopia_adulis	Массава	true
regions_battle_name_cha_reg_ulster_grinan_of_ailech	Ґрінан Айлеха	true
regions_battle_name_att_reg_narbonensis_aquae_sextiae	Екс-ан-Прованс	true
regions_battle_name_cha_reg_marca_hispanica_barcelona	Барселона	true
regions_onscreen_att_sea_lake	Лейк	true
regions_onscreen_cha_sea_adriatic_sea	Адріатичне море	true
regions_onscreen_att_reg_aegyptus_berenice	Айдхаб	true
regions_onscreen_bel_reg_burgundy_valentia	Валентія	true
regions_battle_name_cha_reg_gharb_al_anadalus_beja	Бежа	true
regions_onscreen_cha_reg_provence_marseille	Марсель	true
regions_battle_name_bel_reg_campania_et_samnium_beneventum	Беневент	true
regions_onscreen_att_reg_palaestinea_aelia_capitolina	Єрусалим	true
regions_onscreen_att_reg_asia_ephesus	Смірна	true
regions_onscreen_bel_reg_flaminia_et_picenum_pisaurum	Пізаурум	true
regions_onscreen_att_reg_hercynia_casurgis	Прага	true
regions_onscreen_att_reg_lusitania_emerita_augusta	Бадахос	true
regions_onscreen_bel_reg_mauretania_sitifensis_cirta	Кірта	true
regions_onscreen_cha_reg_sardinia_and_corsica_ajaccio	Аяччо	true
regions_onscreen_att_sea_mare_indicum	Арабське море	true
regions_onscreen_att_reg_libya_augila	Авджила	true
regions_battle_name_cha_reg_carinthia_lorch	Лорх	true
regions_onscreen_cha_reg_east_neustria_reims	Реймс	true
regions_onscreen_att_reg_syria_emesa	Хомс	true
regions_battle_name_att_reg_pannonia_savaria	Веспрем	true
regions_onscreen_bel_reg_lusitania_emerita	Емеріта	true
regions_onscreen_att_reg_libya_paraetonium	Мерса-Матрух	true
regions_onscreen_att_reg_germano_sarmatia_palteskja	Вільнюс	true
regions_battle_name_cha_reg_west_aquitaine_bourges	Бурж	true
regions_onscreen_att_sea_propontis	Пропонтіс	true
regions_onscreen_cha_reg_croatia_ptuj	Птуй	true
regions_battle_name_bel_reg_neustria_portus_namnetum	Портус Намнетум	true
regions_onscreen_bel_reg_apulia_et_calabria_sipontum	Сіпонт	true
regions_onscreen_bel_reg_provence_vapincum	Вапінкум	true
regions_battle_name_att_reg_dacia_petrodava	Сучава	true
regions_battle_name_cha_reg_valencia_palma	Пальма	true
regions_onscreen_cha_sea_irish_sea	Ірландське море	true
regions_onscreen_cha_reg_northumbria_bamburgh	Бамбург	true
regions_onscreen_bel_reg_gallaecia_brigantium	Бріґантій	true
regions_battle_name_bel_reg_sicilia_panormus	Панормус	true
regions_onscreen_cha_reg_burgundy_grenoble	Гренобль	true
regions_onscreen_bel_reg_aquitaine_lemonum	Лемонум	true
regions_onscreen_att_reg_raetia_et_noricum_virunum	Грац	true
regions_onscreen_att_reg_maxima_sequanorum_octodurus	Берн	true
regions_onscreen_bel_reg_campania_et_samnium_neapolis	Неаполіс	true
regions_onscreen_att_sea_mare_caspium	Каспійське море	true
regions_onscreen_cha_reg_east_neustria_troyes	Труа	true
regions_onscreen_bel_reg_apulia_et_calabria_tarentum	Тарент	true
regions_onscreen_bel_reg_cantabria_portus_victoriae	Портус Вікторія	true
regions_battle_name_cha_sea_mare_incognita	Невідоме море	true
regions_battle_name_cha_reg_brittany_quimper	Кімпер	true
regions_battle_name_att_reg_dardania_scupi	Скопіє	true
regions_onscreen_att_reg_frisia_tulifurdum	Брауншвейг	true
regions_battle_name_bel_reg_venetia_et_histria_verona	Верона	true
regions_onscreen_att_reg_lugdunensis_lugdunum	Ліон	true
regions_onscreen_att_reg_media_atropatene_ecbatana	Хамадан	true
regions_onscreen_cha_reg_wilzi_lipsk	Лейпциг	true
regions_onscreen_cha_reg_pannonia_cibakhaza	Цібахаза	true
regions_battle_name_bel_sea_mare_incognita	Невідоме море	true
regions_battle_name_att_reg_dalmatia_domavia	Рас	true
regions_battle_name_att_reg_phazania_cydamus	Гадамес	true
regions_battle_name_att_reg_mediterraneus_occidentalis_ajax	Аяччо	true
regions_onscreen_att_reg_armenia_duin	Двін	true
regions_onscreen_att_reg_asia_cyzicus	Кізик	true
regions_onscreen_cha_reg_obodrites_havelberg	Гавельберг	true
regions_battle_name_cha_reg_navarre_pamplona	Памплона	true
regions_battle_name_bel_reg_austrasia_augustobona_tricassium	Августобона Трікассіум	true
regions_battle_name_att_reg_phazania_dimmidi	Біскра	true
regions_battle_name_cha_reg_calabria_taranto	Таранто	true
regions_onscreen_cha_reg_valencia_cartagena	Картахена	true
regions_battle_name_cha_reg_provence_arles	Арль	true
regions_onscreen_att_sea_mare_aegaeum	Егейське море	true
regions_battle_name_bel_reg_baetica_hispalis	Іспаліс	true
regions_battle_name_att_reg_aquitania_elusa	Тулуза	true
regions_onscreen_att_reg_arabia_felix_omana	Бахла	true
regions_onscreen_bel_reg_neustria_turonorum	Туронорум	true
regions_onscreen_cha_reg_swabia_strasbourg	Страсбург	true
regions_onscreen_cha_reg_jutland_ribe	Рібе	true
regions_onscreen_att_sea_mare_africum	Африканське море	true
regions_battle_name_cha_reg_moravia_mosaburg	Мосабург	true
regions_battle_name_cha_reg_terra_incognita	Невідома Земля	true
regions_onscreen_cha_sea_south_sea	Південне море	true
regions_onscreen_bel_reg_gallaecia_astorga	Асторга	true
regions_onscreen_cha_reg_sardinia_and_corsica_olbia	Ольбія	true
regions_battle_name_cha_reg_pictland_scone	Сконе	true
regions_onscreen_cha_sea_north_sea	Північне море	true
regions_battle_name_bel_reg_neustria_paris	Париж	true
regions_onscreen_att_reg_scandza_hafn	Роскілле	true
regions_onscreen_cha_reg_west_neustria_bayeux	Байо	true
regions_onscreen_cha_reg_west_neustria_rennes	Ренн	true
regions_onscreen_att_reg_aegyptus_oxyrhynchus	Каїр	true
regions_onscreen_att_reg_scandza_hrefnesholt	Лодозе	true
regions_onscreen_bel_reg_lusitania_aeminium	Еміній	true
regions_onscreen_bel_reg_praeualitana_doclea	Доклея	true
regions_battle_name_cha_reg_al_andalus_jaen	Хаен	true
regions_onscreen_att_reg_dardania_viminacium	Ніш	true
regions_onscreen_att_reg_africa_constantina	Кусантина	true
regions_onscreen_att_reg_britannia_inferior_segontium	Кернарвон	true
regions_onscreen_cha_reg_france_tours	Тур	true
regions_battle_name_att_reg_bithynia_amasea	Синопе	true
regions_onscreen_cha_reg_alemannia_konstanz	Констанц	true
regions_onscreen_cha_reg_marca_media_merida	Меріда	true
regions_battle_name_att_reg_venetia_ravenna	Болонья	true
regions_onscreen_bel_reg_lusitania_olissipo	Олісіпо	true
regions_battle_name_cha_reg_frisia_utrecht	Утрехт	true
regions_battle_name_att_reg_britannia_inferior_lindum	Ноттінгем	true
regions_battle_name_cha_reg_septimania_urgell	Ургель	true
regions_onscreen_att_reg_arabia_magna_yathrib	Мекка	true
regions_battle_name_cha_reg_gharb_al_anadalus_seville	Севілья	true
regions_onscreen_att_reg_aquitania_avaricum	Орлеан	true
regions_battle_name_bel_reg_brittany_gwened	Гвенед	true
regions_battle_name_cha_reg_angria_paderborn	Падерборн	true
regions_onscreen_cha_reg_navarre_saragossa	Сарагоса	true
regions_battle_name_att_reg_germania_aregelia	Віттенберг	true
regions_onscreen_bel_reg_cantabria_pompaelo	Помпаело	true
regions_battle_name_att_reg_mauretania_tingis	Фес	true
regions_battle_name_cha_reg_valencia_valencia	Валенсія	true
regions_battle_name_att_reg_hercynia_nitrahwa	Естергом	true
regions_battle_name_cha_reg_leon_leon	Леон	true
regions_battle_name_att_sea_mare_sarmaticum	Балтійське море	true
regions_onscreen_att_sea_mare_rubrum	Червоне море	true
regions_battle_name_bel_sea_mare_balearicum	Балеарське море	true
regions_onscreen_cha_reg_franconia_wurzburg	Вюрцбург	true
regions_onscreen_att_reg_cappadocia_melitene	Малатья	true
regions_battle_name_cha_reg_mercia_lichfield	Лічфілд	true
regions_battle_name_bel_reg_mauretania_caesariensis_pomaria	Помарія	true
regions_battle_name_att_reg_frisia_angulus	Гамбург	true
regions_battle_name_bel_reg_mauretania_tingitana_anfa	Анфа	true
regions_onscreen_att_reg_mediterraneus_occidentalis_caralis	Кальярі	true
regions_onscreen_bel_reg_venetia_et_histria_aquileia	Аквілея	true
regions_onscreen_bel_reg_aquitaine_avaricum	Аварікум	true
regions_battle_name_att_sea_sinus_arabicus	Червоне море	true
regions_onscreen_bel_reg_epirus_nova_photiki	Фотікі	true
regions_onscreen_bel_reg_liguria_augusta_taurinorum	Августа Таурінорум	true
regions_onscreen_att_reg_hyperborea_kariskos	Чернігів	true
regions_battle_name_cha_reg_exarchate_bologna	Болонья	true
regions_battle_name_cha_reg_wessex_canterbury	Кентербері	true
regions_onscreen_cha_reg_east_aquitaine_autun	Отен	true
regions_battle_name_cha_reg_wales_degannwy	Деганнві	true
regions_battle_name_att_reg_scythia_bolghar	Біляр	true
regions_onscreen_bel_reg_zeugitana_thagaste	Тагасте	true
regions_battle_name_cha_reg_alemannia_chur	Кур	true
regions_onscreen_att_reg_transcaspia_siahkuh	Кізіл Кала	true
regions_battle_name_att_reg_magna_graecia_syracusae	Сиракузи	true
regions_battle_name_bel_reg_dalmatia_narona	Нарона	true
regions_battle_name_att_reg_carthaginensis_toletum	Толедо	true
regions_battle_name_cha_reg_munster_dublin	Дублін	true
regions_onscreen_bel_reg_lucania_et_brutii_rhegium	Регіум	true
regions_onscreen_bel_reg_septimania_narbonne	Нарбонна	true
regions_battle_name_cha_reg_gallicia_santiago	Сантьяго	true
regions_battle_name_bel_reg_burgundy_besantio	Бесантіо	true
regions_onscreen_bel_reg_carthaginensis_ilici	Ілічі	true
regions_onscreen_att_reg_tripolitana_sabrata	Меднін	true
regions_battle_name_cha_reg_pannonia_szeged	Сегед	true
regions_battle_name_att_reg_gothiscandza_ascaucalis	Познань	true
regions_battle_name_bel_sea_mare_adriaticum	Адріатичне море	true
regions_onscreen_att_reg_gothiscandza_rugion	Штральзунд	true
regions_onscreen_bel_reg_flaminia_et_picenum_ravenna	Равенна	true
regions_onscreen_bel_reg_lucania_et_brutii_crotona	Кротона	true
regions_battle_name_bel_reg_gallaecia_bracara	Бракара	true
regions_battle_name_att_reg_gallaecia_bracara	Брага	true
regions_battle_name_att_reg_caucasia_mtskheta	Тбілісі	true
regions_battle_name_att_reg_gothiscandza_gothiscandza	Гданськ	true
regions_onscreen_bel_sea_mare_syrtis	Сиртське море	true
regions_battle_name_bel_reg_provence_nikaia	Нікея	true
regions_battle_name_att_reg_asorstan_arbela	Ербіль	true
regions_onscreen_bel_reg_liguria_mediolanum	Медіолан	true
regions_battle_name_cha_reg_saxony_osnabruck	Оснабрюк	true
regions_onscreen_att_reg_narbonensis_vienna	В'єнна	true
regions_onscreen_bel_reg_carthaginensis_carthago_nova	Нова Карфаген	true
regions_battle_name_bel_reg_byzacena_sufetula	Суфетула	true
regions_battle_name_att_reg_asorstan_meshan	Басра	true
regions_battle_name_cha_reg_calabria_kroton	Кротон	true
regions_onscreen_att_reg_aethiopia_pachoras	Донгола	true
regions_battle_name_cha_reg_toledo_calatrava	Калатрава	true
regions_onscreen_cha_reg_marca_hispanica_tarragona	Таррагона	true
regions_battle_name_att_reg_raetia_et_noricum_iuvavum	Відень	true
regions_battle_name_att_reg_sarmatia_europaea_gelonus	Шарукан	true
regions_battle_name_att_reg_dalmatia_salona	Спліт	true
regions_battle_name_cha_reg_marca_inferior_coimbra	Коїмбра	true
regions_battle_name_att_reg_venetia_verona	Верона	true
regions_battle_name_cha_reg_rome_roma	Рим	true
regions_battle_name_att_reg_maxima_sequanorum_argentoratum	Ненсі	true
regions_onscreen_bel_reg_italia_roma	Рим	true
regions_onscreen_att_reg_scythia_ra	Сувар	true
regions_battle_name_cha_sea_tyrrhenian_sea	Тірренське море	true
regions_battle_name_bel_reg_septimania_nimes	Нім	true
regions_onscreen_cha_reg_septimania_narbonne	Нарбонна	true
regions_onscreen_att_reg_liguria_mediolanum	Мілан	true
regions_battle_name_cha_reg_wessex_winchester	Вінчестер	true
regions_battle_name_cha_reg_exarchate_ravenna	Равенна	true
regions_onscreen_bel_reg_italia_reate	Реате	true
regions_battle_name_bel_reg_provence_massilia	Массілія	true
regions_battle_name_att_reg_britannia_superior_camulodunon	Колчестер	true
regions_battle_name_att_sea_mare_hibernicum	Ірландське море	true
regions_battle_name_att_reg_osroene_edessa	Алеппо	true
regions_onscreen_cha_sea_ionian_sea	Іонічне море	true
regions_onscreen_bel_reg_celtiberia_tolentum	Толентум	true
regions_battle_name_bel_reg_tuscia_et_umbria_faesulae	Фесули	true
regions_battle_name_cha_reg_marca_hispanica_girona	Жирона	true
regions_battle_name_att_reg_dalmatia_siscia	Загреб	true
regions_battle_name_cha_reg_pictland_rhynie	Райні	true
regions_battle_name_att_reg_baetica_corduba	Кордова	true
regions_onscreen_bel_reg_sicilia_agrigentum	Агріджентум	true
regions_battle_name_cha_reg_jutland_aarhus	Орхус	true
regions_battle_name_cha_reg_munster_cashel	Кашел	true
regions_battle_name_att_reg_belgica_colonia_agrippina	Антверпен	true
regions_battle_name_att_reg_hercynia_budorgis	Вроцлав	true
regions_onscreen_bel_reg_flaminia_et_picenum_bononia	Бононія	true
regions_battle_name_bel_reg_mauretania_caesariensis_caesarea	Кесарія	true
regions_battle_name_att_reg_phazania_garama	Герма	true
regions_battle_name_att_reg_liguria_segusio	Турин	true
regions_onscreen_bel_sea_mare_ionium	Іонічне море	true
regions_onscreen_bel_reg_aquitaine_arvernis	Арверніс	true
regions_onscreen_cha_sea_celtic_sea	Кельтське море	true
regions_onscreen_bel_reg_celtiberia_segovia	Сеговія	true
regions_battle_name_att_sea_sinus_syracusanus	Сиракузька затока	true
regions_battle_name_bel_reg_byzacena_thysdrus	Тисдрус	true
regions_battle_name_cha_reg_bohemia_dresden	Дрезден	true
regions_onscreen_cha_sea_baltic_sea	Балтійське море	true
regions_battle_name_bel_reg_novempopulania_burdigala	Бурдігала	true
regions_onscreen_att_reg_spahan_susa	Ахваз	true
regions_battle_name_bel_reg_austrasia_remorum	Реморум	true
regions_battle_name_bel_reg_tuscia_et_umbria_arretium	Арреціум	true
regions_battle_name_bel_reg_burgundy_vienne	В'єнна	true
regions_onscreen_att_reg_lugdunensis_turonum	Париж	true
regions_battle_name_cha_reg_moravia_savaria	Саварія	true
regions_battle_name_cha_reg_calabria_region	Регіон	true
regions_battle_name_cha_reg_west_aquitaine_poitiers	Пуатьє	true
regions_battle_name_att_reg_africa_carthago	Туніс	true
regions_battle_name_cha_reg_east_aquitaine_arvernis	Арверніс	true
regions_onscreen_att_reg_carthaginensis_carthago_nova	Мурсія	true
regions_battle_name_att_reg_cilicia_tarsus	Сіс	true
regions_battle_name_cha_reg_angria_buraburg	Бурабург	true
regions_battle_name_att_reg_hyperborea_sylis	Курськ	true
regions_onscreen_cha_reg_septimania_toulouse	Тулуза	true
regions_onscreen_att_sea_oceanus_germanicus	Германське море	true
regions_onscreen_att_reg_britannia_superior_londinium	Лондон	true
regions_battle_name_att_reg_caucasia_kotais	Кутаїсі	true
regions_battle_name_bel_reg_mauretania_caesariensis_cartenna	Картенна	true
regions_onscreen_cha_reg_carinthia_salzburg	Зальцбург	true
regions_onscreen_att_reg_gallaecia_asturica	Леон	true
regions_battle_name_att_reg_macedonia_thessalonica	Салоніки	true
regions_battle_name_att_reg_tarraconensis_pompaelo	Памплона	true
regions_battle_name_cha_reg_lombardy_genova	Генуя	true
regions_onscreen_att_reg_cappadocia_trapezus	Трапезунд	true
regions_battle_name_cha_reg_swabia_strasbourg	Страсбург	true
regions_onscreen_bel_reg_celtiberia_complutum	Комплутум	true
regions_onscreen_att_reg_hyperborea_moramar	Рязань	true
regions_battle_name_cha_reg_jutland_hedeby	Хедебю	true
regions_battle_name_cha_reg_mercia_lincoln	Лінкольн	true
regions_battle_name_cha_reg_west_aquitaine_angouleme	Ангулем	true
regions_battle_name_att_reg_mediterraneus_occidentalis_palma	Пальма	true
regions_battle_name_cha_reg_bavaria_passau	Пассау	true
regions_battle_name_cha_sea_north_sea	Північне море	true
regions_battle_name_cha_sea_south_sea	Південне море	true
regions_battle_name_bel_reg_gallaecia_astorga	Асторга	true
regions_battle_name_cha_reg_burgundy_geneve	Женева	true
regions_battle_name_bel_reg_lucania_et_brutii_thurii	Турії	true
regions_battle_name_att_reg_cilicia_iconium	Іконій	true
regions_battle_name_att_reg_raetia_et_noricum_augusta_vindelicorum	Мюнхен	true
regions_battle_name_cha_reg_sicilia_akragas	Акрагас	true
regions_battle_name_cha_reg_austrasia_metz	Мец	true
regions_battle_name_att_reg_carthaginensis_segobriga	Валенсія	true
regions_battle_name_cha_reg_swabia_bescanon	Бесканон	true
regions_battle_name_att_sea_pontus_euxinus	Понт Евксінський	true
regions_battle_name_cha_reg_friuli_venezia	Венеція	true
regions_battle_name_bel_reg_septimania_elne	Ельн	true
regions_battle_name_bel_reg_carthaginensis_libisosa	Лібісоса	true
regions_battle_name_cha_reg_ulster_cruachan	Круахан	true
regions_battle_name_cha_sea_irish_sea	Ірландське море	true
regions_battle_name_bel_reg_provence_vapincum	Вапінкум	true
regions_onscreen_att_reg_arabia_magna_dumatha	Аль-Джауф	true
regions_onscreen_cha_reg_frisia_ghent	Гент	true
regions_battle_name_att_sea_mare_balearicum	Іберійське море	true
regions_battle_name_att_reg_khwarasan_merv	Мерв	true
regions_battle_name_bel_reg_tarraconensis_valentia	Валентія	true
regions_onscreen_bel_reg_mauretania_tingitana_tingis	Тінгіс	true
regions_onscreen_bel_reg_italia_cosa	Коса	true
regions_battle_name_att_reg_transcarpathia_leopolis	Галич	true
regions_battle_name_att_reg_baetica_malaca	Гранада	true
regions_battle_name_att_reg_raetia_et_noricum_virunum	Грац	true
regions_battle_name_bel_reg_aquitaine_lemonum	Лемонум	true
regions_battle_name_cha_reg_burgundy_grenoble	Гренобль	true
regions_onscreen_att_reg_persis_siraf	Бушер	true
regions_onscreen_cha_reg_east_aquitaine_rodez	Родез	true
regions_battle_name_att_sea_mare_adriaticum	Адріатичне море	true
regions_battle_name_att_sea_sinus_persicus	Перська затока	true
regions_battle_name_att_reg_bithynia_ancyra	Анкіра	true
regions_onscreen_cha_sea_alboran_sea	Альборанське море	true
regions_battle_name_att_sea_rhenus	Рейн	true
regions_battle_name_cha_reg_navarre_tudela	Тудела	true
regions_battle_name_bel_reg_baetica_malaca	Малака	true
regions_battle_name_cha_reg_frisia_boulogne	Булонь	true
regions_battle_name_att_reg_makran_harmosia	Ормуз	true
regions_onscreen_att_reg_mauretania_caesarea	Алжир	true
regions_onscreen_bel_reg_venetia_et_histria_verona	Верона	true
regions_battle_name_att_reg_frisia_tulifurdum	Брауншвейг	true
regions_battle_name_cha_reg_gallicia_oviedo	Ов'єдо	true
regions_battle_name_bel_reg_novempopulania_aquensium	Аквансій	true
regions_onscreen_cha_reg_al_andalus_cordoba	Кордова	true
regions_battle_name_att_sea_pontus_cimmerius	Скіфське море	true
regions_onscreen_cha_reg_eastphalia_magdeburg	Магдебург	true
regions_battle_name_att_reg_media_atropatene_ecbatana	Хамадан	true
regions_onscreen_bel_reg_mauretania_sitifensis_tipasa	Типаса	true
regions_onscreen_bel_reg_praeualitana_lissus	Ліссус	true
regions_onscreen_bel_reg_venetia_et_histria_patavium	Патавіум	true
regions_onscreen_att_reg_armenia_payttakaran	Ардабіль	true
regions_battle_name_att_reg_tripolitana_leptis_magna	Тріполі	true
regions_battle_name_att_reg_spahan_issatis	Язд	true
regions_onscreen_cha_reg_marca_hispanica_barcelona	Барселона	true
regions_onscreen_att_reg_narbonensis_aquae_sextiae	Екс-ан-Прованс	true
regions_battle_name_att_reg_persis_behdeshir	Керман	true
regions_onscreen_att_sea_oceanus_atlanticus	Атлантичний океан	true
regions_battle_name_att_sea_pontus_thracius	Понт Фракійський	true
regions_battle_name_cha_reg_eastphalia_halberstadt	Хальберштадт	true
regions_battle_name_cha_reg_friuli_aquileia	Аквілея	true
regions_onscreen_att_reg_africa_hadrumentum	Аль-Махдія	true
regions_battle_name_att_reg_aegyptus_berenice	Айдхаб	true
regions_battle_name_bel_reg_burgundy_valentia	Валентія	true
regions_battle_name_bel_reg_picenum_suburbicarium_spoletum	Сполетум	true
regions_onscreen_att_reg_aegyptus_alexandria	Олександрія	true
regions_onscreen_att_reg_cappadocia_caesarea_eusebia	Кайсері	true
regions_battle_name_cha_reg_france_chatres	Шартр	true
regions_battle_name_att_reg_transcarpathia_arheimar	Київ	true
regions_onscreen_att_reg_italia_roma	Рим	true
regions_battle_name_att_reg_lusitania_emerita_augusta	Бадахос	true
regions_battle_name_att_reg_hercynia_casurgis	Прага	true
regions_onscreen_att_reg_mauretania_tamousiga	Марракеш	true
regions_battle_name_cha_reg_carinthia_wien	Відень	true
regions_battle_name_cha_reg_northumbria_streonshalh	Стреоншалх	true
regions_battle_name_cha_reg_benevento_bari	Барі	true
regions_battle_name_att_reg_caucasia_gabala	Баку	true
regions_battle_name_bel_reg_dalmatia_salona	Салона	true
regions_onscreen_cha_reg_toledo_guadalajara	Гвадалахара	true
regions_onscreen_att_reg_thracia_trimontium	Філіппополь	true
regions_onscreen_bel_sea_oceanus_atlanticus	Атлантичний океан	true
regions_battle_name_cha_reg_mercia_chester	Честер	true
regions_battle_name_att_reg_magna_graecia_tarentum	Таранто	true
regions_battle_name_att_sea_propontis	Пропонтіс	true
regions_battle_name_att_reg_libya_paraetonium	Мерса Матрух	true
regions_battle_name_bel_reg_lusitania_emerita	Емеріта	true
regions_onscreen_cha_reg_france_paris	Париж	true
regions_battle_name_bel_reg_epirus_nova_dyrrachium	Діррахіум	true
regions_battle_name_cha_reg_saxony_hamburg	Гамбург	true
regions_battle_name_cha_reg_benevento_salerno	Салерно	true
regions_battle_name_att_reg_pannonia_sopianae	Печ	true
regions_battle_name_cha_reg_pannonia_kaposvar	Капошвар	true
regions_onscreen_bel_reg_sardinia_et_corsica_caralis	Караліс	true
regions_onscreen_cha_reg_obodrites_stargard	Старгард	true
regions_onscreen_att_sea_oceanus_britannicus	Британський океан	true
regions_battle_name_cha_reg_wales_caerwent	Каєрвент	true
regions_onscreen_cha_reg_ulster_downpatrick	Даунпатрік	true
regions_battle_name_att_reg_italia_fiorentia	Піза	true
regions_battle_name_cha_reg_wilzi_brandenburg	Бранденбург	true
regions_battle_name_cha_sea_mediterranean_sea	Середземне море	true
regions_onscreen_cha_reg_marca_inferior_braga	Брага	true
regions_onscreen_att_sea_syrtis_major	Лівійське море	true
regions_onscreen_att_sea_syrtis_minor	Лівійське море	true
regions_battle_name_cha_reg_brittany_vannes	Ванн	true
regions_battle_name_cha_reg_gascony_bayonne	Байонна	true
regions_onscreen_att_reg_maxima_sequanorum_vesontio	Діжон	true
regions_onscreen_cha_reg_bavaria_regensburg	Регенсбург	true
regions_battle_name_att_reg_lusitania_olisipo	Лісабон	true
regions_battle_name_att_reg_arabia_magna_hira	Куфа	true
regions_battle_name_cha_reg_gharb_al_anadalus_cadiz	Кадіс	true
regions_battle_name_att_reg_osroene_nisibis	Мосул	true
regions_onscreen_att_sea_mare_ionium	Іонічне море	true
regions_battle_name_att_reg_palaestinea_nova_trajana_bostra	Дамаск	true
regions_onscreen_att_reg_narbonensis_narbo	Монпельє	true
regions_onscreen_att_reg_belgica_augusta_treverorum	Трір	true
regions_onscreen_att_reg_transcarpathia_belz	Краків	true
regions_onscreen_cha_reg_al_andalus_almeria	Альмерія	true
regions_onscreen_att_reg_makran_phra	Зарандж	true
regions_onscreen_att_reg_makran_pura	Пахра	true
regions_battle_name_att_reg_italia_neapolis	Неаполь	true
regions_battle_name_bel_reg_brittany_riedonum	Рідон	true
regions_battle_name_att_reg_arabia_magna_yathrib	Мекка	true
regions_onscreen_bel_reg_baetica_gades	Гадес	true
regions_battle_name_att_reg_scandza_hrefnesholt	Лодозе	true
regions_battle_name_cha_reg_carinthia_salzburg	Зальцбург	true
regions_battle_name_att_reg_gallaecia_asturica	Леон	true
regions_battle_name_bel_reg_praeualitana_doclea	Доклея	true
regions_onscreen_att_reg_macedonia_thessalonica	Салоніки	true
regions_onscreen_att_reg_tarraconensis_pompaelo	Памплона	true
regions_onscreen_cha_reg_al_andalus_jaen	Хаен	true
regions_battle_name_att_reg_dardania_viminacium	Ніш	true
regions_battle_name_att_reg_hyperborea_moramar	Рязань	true
regions_onscreen_cha_reg_jutland_hedeby	Хедебю	true
regions_onscreen_cha_reg_mercia_lincoln	Лінкольн	true
regions_battle_name_att_reg_britannia_inferior_segontium	Кернарвон	true
regions_battle_name_cha_reg_france_tours	Тур	true
regions_onscreen_cha_reg_bavaria_passau	Пассау	true
regions_onscreen_att_reg_lugdunensis_rotomagus	Руан	true
regions_onscreen_att_reg_bithynia_amasea	Синопа	true
regions_onscreen_att_reg_venetia_ravenna	Болонья	true
regions_battle_name_att_reg_frisia_flevum	Гронінген	true
regions_battle_name_att_reg_lusitania_pax_augusta	Евора	true
regions_battle_name_bel_reg_mauretania_sitifensis_sitifis	Сітіфіс	true
regions_battle_name_cha_reg_wilzi_cottbus	Котбус	true
regions_onscreen_cha_reg_croatia_jadra	Ядра	true
regions_onscreen_cha_reg_moravia_nitra	Нітра	true
regions_onscreen_bel_reg_brittany_gwened	Гвенед	true
regions_onscreen_cha_reg_angria_paderborn	Падерборн	true
regions_battle_name_att_reg_macedonia_dyrrhachium	Діррахіум	true
regions_onscreen_att_reg_cilicia_tarsus	Сіс	true
regions_battle_name_att_sea_oceanus_germanicus	Германське море	true
regions_onscreen_att_sea_rhenus	Рейн	true
regions_onscreen_cha_reg_navarre_tudela	Тудела	true
regions_onscreen_bel_reg_baetica_malaca	Малака	true
regions_battle_name_att_reg_cappadocia_melitene	Малатья	true
regions_onscreen_bel_reg_zeugitana_bulla_regia	Булла Регія	true
regions_onscreen_att_reg_scythia_sarai	Саксін	true
regions_onscreen_bel_reg_mauretania_caesariensis_pomaria	Помарія	true
regions_battle_name_cha_reg_east_aquitaine_autun	Отен	true
regions_battle_name_att_sea_mare_rubrum	Червоне море	true
regions_onscreen_att_sea_sinus_persicus	Перська затока	true
regions_onscreen_att_sea_mare_sarmaticum	Балтійське море	true
regions_onscreen_bel_sea_mare_balearicum	Балеарське море	true
regions_battle_name_cha_reg_sardinia_and_corsica_cagliari	Кальярі	true
regions_onscreen_cha_reg_mercia_lichfield	Лічфілд	true
regions_battle_name_cha_reg_marca_inferior_lisbon	Лісабон	true
regions_battle_name_bel_reg_epirus_nova_photiki	Фотікі	true
regions_battle_name_cha_reg_al_andalus_cordoba	Кордова	true
regions_battle_name_att_reg_hyperborea_kariskos	Чернігів	true
regions_battle_name_bel_reg_venetia_et_histria_aquileia	Аквілея	true
regions_onscreen_att_reg_germano_sarmatia_oium	Гардінас	true
regions_battle_name_bel_sea_mare_internum	Внутрішнє море	true
regions_battle_name_att_sea_mare_internum	Середземне море	true
regions_onscreen_att_sea_pontus_euxinus	Понт Евксинський	true
regions_battle_name_bel_reg_septimania_narbonne	Нарбонна	true
regions_onscreen_cha_reg_friuli_venezia	Венеція	true
regions_onscreen_att_reg_scythia_bolghar	Біляр	true
regions_battle_name_att_reg_transcaspia_siahkuh	Кизил-Кала	true
regions_onscreen_att_reg_raetia_et_noricum_augusta_vindelicorum	Мюнхен	true
regions_onscreen_att_reg_magna_graecia_syracusae	Сиракузи	true
regions_onscreen_cha_reg_austrasia_metz	Мец	true
regions_onscreen_bel_reg_dalmatia_narona	Нарона	true
regions_battle_name_cha_reg_angria_erfurt	Ерфурт	true
regions_battle_name_bel_reg_carthaginensis_ilici	Ілічі	true
regions_onscreen_att_reg_baetica_malaca	Гранада	true
regions_battle_name_att_reg_tripolitana_sabrata	Меднін	true
regions_onscreen_cha_reg_pannonia_szeged	Сегед	true
regions_onscreen_att_reg_gothiscandza_ascaucalis	Познань	true
regions_onscreen_bel_sea_mare_adriaticum	Адріатичне море	true
regions_battle_name_att_reg_gothiscandza_rugion	Штральзунд	true
regions_onscreen_att_reg_khwarasan_merv	Мерв	true
regions_onscreen_bel_reg_tarraconensis_valentia	Валентія	true
regions_battle_name_bel_reg_flaminia_et_picenum_ravenna	Равенна	true
regions_onscreen_cha_reg_toledo_calatrava	Калатрава	true
regions_battle_name_cha_reg_gallicia_lugo	Луго	true
regions_onscreen_cha_reg_france_chatres	Шартр	true
regions_battle_name_bel_sea_mare_syrtis	Маре Сиртіс	true
regions_onscreen_bel_reg_picenum_suburbicarium_spoletum	Сполетій	true
regions_onscreen_att_reg_asorstan_arbela	Ербіль	true
regions_onscreen_bel_reg_provence_nikaia	Нікея	true
regions_onscreen_cha_reg_saxony_osnabruck	Оснабрюк	true
regions_battle_name_cha_reg_toledo_guadalajara	Гвадалахара	true
regions_battle_name_att_reg_thracia_trimontium	Філіппополь	true
regions_battle_name_bel_sea_oceanus_atlanticus	Атлантичний океан	true
regions_onscreen_cha_reg_mercia_chester	Честер	true
regions_onscreen_att_reg_magna_graecia_tarentum	Таранто	true
regions_battle_name_bel_reg_carthaginensis_carthago_nova	Карфаген Нова	true
regions_onscreen_cha_reg_carinthia_wien	Відень	true
regions_onscreen_att_reg_asorstan_meshan	Басра	true
regions_onscreen_cha_reg_calabria_kroton	Кротон	true
regions_onscreen_cha_reg_benevento_bari	Барі	true
regions_onscreen_bel_reg_septimania_nimes	Нім	true
regions_battle_name_cha_reg_lombardy_pisa	Піза	true
regions_battle_name_cha_reg_saxony_bremen	Бремен	true
regions_battle_name_att_reg_magna_graecia_rhegium	Реджо	true
regions_battle_name_att_reg_persis_stakhr	Шираз	true
regions_battle_name_bel_reg_italia_reate	Реате	true
regions_onscreen_att_reg_spahan_issatis	Язд	true
regions_battle_name_att_sea_oceanus_atlanticus	Атлантичний океан	true
regions_onscreen_att_reg_dalmatia_salona	Спліт	true
regions_onscreen_cha_reg_eastphalia_halberstadt	Хальберштадт	true
regions_battle_name_bel_reg_italia_roma	Рим	true
regions_onscreen_bel_reg_epirus_nova_nicopolis	Нікополь	true
regions_battle_name_att_reg_africa_hadrumentum	Аль-Махдія	true
regions_battle_name_cha_reg_septimania_narbonne	Нарбонна	true
regions_battle_name_bel_reg_celtiberia_tolentum	Толентум	true
regions_battle_name_cha_reg_bavaria_regensburg	Регенсбург	true
regions_battle_name_att_reg_maxima_sequanorum_vesontio	Діжон	true
regions_onscreen_att_sea_mare_hibernicum	Ірландське море	true
regions_battle_name_att_sea_nilos	Ніл	true
regions_battle_name_att_sea_sinus_codanus	Затока Коданус	true
regions_battle_name_att_reg_belgica_augusta_treverorum	Трір	true
regions_battle_name_cha_reg_al_andalus_almeria	Альмерія	true
regions_onscreen_att_reg_dalmatia_siscia	Загреб	true
regions_onscreen_cha_reg_pictland_rhynie	Райні	true
regions_onscreen_att_reg_baetica_corduba	Кордова	true
regions_onscreen_bel_reg_novempopulania_burdigala	Бурдігала	true
regions_battle_name_bel_reg_campania_et_samnium_corfinium	Корфінум	true
regions_onscreen_bel_reg_epirus_nova_dyrrachium	Діррахіум	true
regions_onscreen_cha_reg_saxony_hamburg	Гамбург	true
regions_battle_name_bel_reg_flaminia_et_picenum_bononia	Бононія	true
regions_onscreen_att_reg_phazania_garama	Герма	true
regions_battle_name_bel_sea_mare_ionium	Іонічне море	true
regions_onscreen_att_reg_liguria_segusio	Турин	true
regions_battle_name_cha_reg_friuli_verona	Верона	true
regions_onscreen_bel_reg_mauretania_caesariensis_caesarea	Кесарія	true
regions_battle_name_cha_reg_ulster_downpatrick	Даунпатрик	true
regions_battle_name_att_reg_spahan_susa	Ахваз	true
regions_battle_name_cha_reg_obodrites_stargard	Старгард	true
regions_onscreen_cha_reg_bohemia_dresden	Дрезден	true
regions_onscreen_cha_reg_wales_caerwent	Каєрвент	true
regions_onscreen_att_reg_hyperborea_sylis	Курськ	true
regions_onscreen_cha_reg_west_aquitaine_poitiers	Пуатьє	true
regions_battle_name_att_reg_britannia_superior_londinium	Лондон	true
regions_onscreen_att_reg_africa_carthago	Туніс	true
regions_onscreen_cha_reg_east_aquitaine_arvernis	Арверн	true
regions_onscreen_bel_reg_burgundy_vienne	В'єнна	true
regions_battle_name_att_reg_aquitania_avaricum	Орлеан	true
regions_battle_name_att_reg_lugdunensis_turonum	Париж	true
regions_onscreen_cha_reg_moravia_savaria	Саварія	true
regions_onscreen_cha_reg_calabria_region	Регіон	true
regions_onscreen_bel_reg_liguria_genua	Генуя	true
regions_onscreen_att_reg_liguria_genua	Генуя	true
regions_onscreen_bel_reg_picenum_suburbicarium_asculum	Аскулум	true
regions_onscreen_cha_reg_angria_buraburg	Бурабург	true
regions_battle_name_cha_reg_septimania_toulouse	Тулуза	true
regions_onscreen_cha_reg_croatia_sisak	Сісак	true
regions_battle_name_att_reg_carthaginensis_carthago_nova	Мурсія	true
regions_battle_name_bel_reg_cantabria_pompaelo	Помпаело	true
regions_onscreen_att_reg_mediterraneus_occidentalis_palma	Пальма	true
regions_battle_name_cha_reg_provence_nice	Ніцца	true
regions_onscreen_cha_reg_west_aquitaine_angouleme	Ангулем	true
regions_battle_name_cha_reg_wessex_london	Лондон	true
regions_battle_name_att_reg_cappadocia_trapezus	Трапезунд	true
regions_onscreen_cha_sea_bay_of_biscay	Біскайська затока	true
regions_battle_name_att_reg_africa_constantina	Кусантина	true
regions_onscreen_att_reg_caucasia_kotais	Кутаїсі	true
regions_battle_name_bel_reg_lusitania_aeminium	Еміній	true
regions_onscreen_cha_reg_lombardy_genova	Генуя	true
regions_battle_name_cha_reg_burgundy_lyon	Ліон	true
regions_onscreen_bel_reg_mauretania_caesariensis_cartenna	Картенна	true
regions_onscreen_cha_reg_frisia_utrecht	Утрехт	true
regions_battle_name_bel_reg_celtiberia_complutum	Комплутум	true
regions_battle_name_cha_reg_alemannia_konstanz	Констанц	true
regions_battle_name_cha_reg_marca_media_merida	Меріда	true
regions_battle_name_bel_reg_lusitania_olissipo	Олісіпо	true
regions_onscreen_cha_reg_swabia_bescanon	Бесканон	true
regions_onscreen_att_reg_carthaginensis_toletum	Толедо	true
regions_onscreen_cha_reg_munster_dublin	Дублін	true
regions_onscreen_bel_reg_septimania_elne	Ельн	true
regions_onscreen_bel_reg_carthaginensis_libisosa	Лібісоса	true
regions_onscreen_cha_reg_ulster_cruachan	Круахан	true
regions_battle_name_cha_reg_east_aquitaine_rodez	Родез	true
regions_battle_name_att_reg_persis_siraf	Бушер	true
regions_onscreen_cha_reg_wales_degannwy	Деганнві	true
regions_onscreen_cha_reg_burgundy_geneve	Женева	true
regions_battle_name_bel_reg_zeugitana_thagaste	Тагасте	true
regions_onscreen_cha_reg_alemannia_chur	Кур	true
regions_onscreen_att_reg_cilicia_iconium	Іконій	true
regions_onscreen_cha_reg_sicilia_akragas	Акрагас	true
regions_onscreen_att_reg_carthaginensis_segobriga	Валенсія	true
regions_battle_name_att_sea_mare_aegyptum	Єгипетське море	true
regions_battle_name_att_reg_arabia_felix_eudaemon	Аден	true
regions_onscreen_bel_reg_lucania_et_brutii_thurii	Турій	true
regions_battle_name_att_reg_tarraconensis_tarraco	Барселона	true
regions_battle_name_bel_reg_mauretania_tingitana_tingis	Тінгіс	true
regions_battle_name_bel_reg_italia_cosa	Коса	true
regions_onscreen_att_reg_transcarpathia_leopolis	Галич	true
regions_onscreen_att_reg_thracia_marcianopolis	Тирново	true
regions_onscreen_cha_reg_bohemia_iglau	Іглау	true
regions_onscreen_cha_reg_marca_media_salamanca	Саламанка	true
regions_battle_name_att_reg_arabia_magna_dumatha	Аль-Джауф	true
regions_battle_name_cha_reg_frisia_ghent	Гент	true
regions_onscreen_att_sea_mare_balearicum	Іберійське море	true
regions_onscreen_bel_reg_novempopulania_aquensium	Аквензіум	true
regions_onscreen_att_sea_pontus_cimmerius	Скіфське море	true
regions_battle_name_cha_reg_swabia_speyer	Шпейєр	true
regions_onscreen_cha_reg_frisia_boulogne	Булонь	true
regions_battle_name_cha_reg_eastphalia_magdeburg	Магдебург	true
regions_battle_name_bel_reg_mauretania_sitifensis_tipasa	Тіпаса	true
regions_battle_name_att_reg_mauretania_caesarea	Алжир	true
regions_onscreen_att_reg_makran_harmosia	Ормуз	true
regions_onscreen_att_reg_frisia_angulus	Гамбург	true
regions_onscreen_att_sea_mare_adriaticum	Адріатичне море	true
regions_onscreen_att_reg_bithynia_ancyra	Анкіра	true
regions_battle_name_cha_reg_franconia_wurzburg	Вюрцбург	true
regions_battle_name_cha_sea_alboran_sea	Альборанське море	true
regions_battle_name_att_sea_mare_ibericum	Гадітанське море	true
regions_battle_name_bel_sea_mare_ibericum	Іберійське море	true
regions_battle_name_att_sea_mare_suebicum	Коданська затока	true
regions_battle_name_cha_reg_toledo_toledo	Толедо	true
regions_battle_name_bel_reg_liguria_augusta_taurinorum	Августа Таурінорум	true
regions_battle_name_att_reg_mediterraneus_occidentalis_caralis	Кальярі	true
regions_onscreen_cha_reg_gallicia_oviedo	Ов'єдо	true
regions_onscreen_cha_sea_straight_of_gibraltar	Гібралтарська протока	true
regions_battle_name_bel_reg_aquitaine_avaricum	Аварікум	true
regions_onscreen_att_sea_sinus_arabicus	Червоне море	true
regions_battle_name_bel_reg_africa_proconsularis_hippo_diarrhytus	Гіппон Діарит	true
regions_battle_name_bel_reg_mauretania_tingitana_rusaddir	Русаддір	true
regions_battle_name_att_reg_spahan_spahan	Ісфахан	true
regions_battle_name_bel_reg_tarraconensis_barcino	Барсіно	true
regions_onscreen_att_reg_venetia_verona	Верона	true
regions_onscreen_bel_reg_zeugitana_hippo_regis	Гіппон Регіс	true
regions_battle_name_bel_reg_praeualitana_lissus	Ліссус	true
regions_onscreen_cha_reg_marca_inferior_coimbra	Коїмбра	true
regions_battle_name_bel_reg_venetia_et_histria_patavium	Патавіум	true
regions_battle_name_att_reg_armenia_payttakaran	Ардабіль	true
regions_onscreen_att_reg_persis_behdeshir	Керман	true
regions_onscreen_att_reg_tripolitana_leptis_magna	Тріполі	true
regions_onscreen_att_sea_pontus_thracius	Понт Фракійський	true
regions_onscreen_cha_reg_friuli_aquileia	Аквілея	true
regions_battle_name_att_reg_scythia_ra	Сувар	true
regions_onscreen_cha_sea_tyrrhenian_sea	Тірренське море	true
regions_battle_name_att_reg_liguria_mediolanum	Мілан	true
regions_onscreen_att_reg_maxima_sequanorum_argentoratum	Нансі	true
regions_battle_name_att_reg_cappadocia_caesarea_eusebia	Кайсері	true
regions_battle_name_bel_reg_liguria_mediolanum	Медіоланум	true
regions_onscreen_att_reg_osroene_amida	Діярбакир	true
regions_battle_name_att_reg_narbonensis_vienna	В'єнна	true
regions_battle_name_cha_reg_france_paris	Париж	true
regions_onscreen_att_reg_transcarpathia_arheimar	Київ	true
regions_battle_name_att_reg_italia_roma	Рим	true
regions_battle_name_att_reg_aegyptus_alexandria	Олександрія	true
regions_battle_name_att_reg_mauretania_tamousiga	Марракеш	true
regions_onscreen_cha_reg_northumbria_streonshalh	Стреоншалх	true
regions_battle_name_att_reg_aethiopia_pachoras	Донгола	true
regions_onscreen_bel_reg_dalmatia_salona	Салона	true
regions_onscreen_att_reg_caucasia_gabala	Баку	true
regions_battle_name_bel_reg_africa_proconsularis_thuburbo	Тубурбо	true
regions_onscreen_att_reg_italia_fiorentia	Піза	true
regions_battle_name_cha_sea_celtic_sea	Кельтське море	true
regions_onscreen_cha_reg_bohemia_praha	Прага	true
regions_battle_name_bel_reg_celtiberia_segovia	Сеговія	true
regions_battle_name_att_sea_syrtis_major	Лівійське море	true
regions_battle_name_att_sea_syrtis_minor	Лівійське море	true
regions_battle_name_cha_reg_marca_inferior_braga	Брага	true
regions_battle_name_bel_reg_aquitaine_arvernis	Арверніс	true
regions_battle_name_cha_sea_baltic_sea	Балтійське море	true
regions_onscreen_att_reg_scandza_alabu	Орхус	true
regions_battle_name_att_sea_oceanus_britannicus	Британський океан	true
regions_battle_name_bel_reg_sardinia_et_corsica_caralis	Караліс	true
regions_battle_name_bel_reg_africa_proconsularis_carthago	Карфаген	true
regions_battle_name_bel_sea_mare_gallicum	Гальске море	true
regions_battle_name_att_sea_mare_gallicum	Гальска затока	true
regions_battle_name_att_sea_mare_cilicium	Левантійське море	true
regions_battle_name_cha_reg_eastphalia_hildesheim	Гільдесгайм	true
regions_battle_name_bel_reg_novempopulania_tolosa	Толоса	true
regions_onscreen_att_reg_osroene_edessa	Алеппо	true
regions_battle_name_cha_sea_ionian_sea	Іонічне море	true
regions_onscreen_cha_reg_brittany_vannes	Ванн	true
regions_onscreen_cha_reg_gascony_bayonne	Байонна	true
regions_onscreen_att_reg_britannia_superior_camulodunon	Колчестер	true
regions_onscreen_att_reg_germano_sarmatia_duna	Рига	true
regions_battle_name_bel_reg_sicilia_agrigentum	Агріґент	true
regions_onscreen_cha_reg_jutland_aarhus	Орхус	true
regions_battle_name_att_reg_transcarpathia_belz	Краків	true
regions_onscreen_att_reg_tripolitana_macomades	Сурт	true
regions_battle_name_att_reg_makran_phra	Зарандж	true
regions_battle_name_att_reg_makran_pura	Пахра	true
regions_onscreen_cha_reg_munster_cashel	Кашел	true
regions_onscreen_att_reg_italia_neapolis	Неаполь	true
regions_onscreen_cha_reg_marca_hispanica_girona	Жирона	true
regions_onscreen_cha_reg_gharb_al_anadalus_cadiz	Кадіс	true
regions_battle_name_att_sea_mare_ionium	Іонічне море	true
regions_onscreen_att_reg_osroene_nisibis	Мосул	true
regions_onscreen_att_reg_palaestinea_nova_trajana_bostra	Дамаск	true
regions_onscreen_cha_reg_northumbria_york	Йорк	true
regions_battle_name_cha_sea_lake	Лейк	true
regions_battle_name_cha_reg_franconia_frankfurt	Франкфурт	true
regions_battle_name_att_reg_belgica_durocorterum	Турне	true
regions_onscreen_cha_reg_gascony_bordeaux	Бордо	true
regions_onscreen_att_sea_nilos	Ніл	true
regions_onscreen_att_sea_mare_phoenicum	Фінікійське море	true
regions_battle_name_bel_reg_sardinia_et_corsica_turris	Турріс	true
regions_onscreen_att_sea_sinus_codanus	Коданська затока	true
regions_battle_name_att_reg_gallaecia_brigantium	Сантьяго	true
regions_battle_name_att_reg_asorstan_ctesiphon	Багдад	true
regions_onscreen_att_reg_pannonia_sirmium	Белград	true
regions_onscreen_bel_reg_sicilia_syracuse	Сиракузи	true
regions_battle_name_cha_reg_west_neustria_nantes	Нант	true
regions_onscreen_cha_reg_leon_santander	Сантандер	true
regions_battle_name_cha_reg_gascony_agen	Ажен	true
regions_onscreen_att_reg_aethiopia_aksum	Лалібела	true
regions_onscreen_bel_reg_campania_et_samnium_corfinium	Корфінум	true
regions_onscreen_att_reg_mediterraneus_orientalis_gortyna	Кандія	true
regions_onscreen_cha_reg_exarchate_ancona	Анкона	true
regions_battle_name_att_reg_arabia_felix_zafar	Маріб	true
regions_onscreen_cha_reg_friuli_verona	Верона	true
regions_battle_name_att_reg_tarraconensis_caesaraugusta	Сарагоса	true
regions_battle_name_bel_reg_picenum_suburbicarium_ancona	Анкона	true
regions_onscreen_cha_reg_obodrites_rerik	Рерік	true
regions_onscreen_att_reg_terra_incognita	Невідома земля	true
regions_battle_name_cha_reg_munster_cork	Корк	true
regions_onscreen_att_reg_dardania_serdica	Средець	true
regions_onscreen_att_reg_media_atropatene_ganzaga	Тебріз	true
regions_onscreen_att_sea_danuvius	Дунай	true
regions_battle_name_cha_reg_rome_spoleto	Сполето	true
regions_onscreen_cha_reg_gallicia_lugo	Луго	true
regions_battle_name_att_reg_mediterraneus_orientalis_constantia	Фамагуста	true
regions_onscreen_att_reg_syria_antiochia	Антіохія	true
regions_onscreen_att_reg_sarmatia_asiatica_tanais	Тана	true
regions_onscreen_bel_reg_austrasia_mettis	Меттіс	true
regions_battle_name_att_reg_caledonia_et_hibernia_tuesis	Інвернесс	true
regions_battle_name_att_reg_germano_sarmatia_palteskja	Вільнюс	true
regions_onscreen_cha_reg_west_aquitaine_bourges	Бурж	true
regions_battle_name_att_reg_dacia_romula	Тирговіште	true
regions_battle_name_att_reg_aquitania_burdigala	Бордо	true
regions_onscreen_att_reg_persis_stakhr	Шираз	true
regions_battle_name_cha_reg_east_neustria_amiens	Ам'єн	true
regions_onscreen_cha_reg_saxony_bremen	Бремен	true
regions_onscreen_att_reg_magna_graecia_rhegium	Реджо	true
regions_onscreen_bel_reg_cantabria_legio	Легіо	true
regions_onscreen_cha_reg_lombardy_pisa	Піза	true
regions_onscreen_cha_reg_alemannia_basel	Базель	true
regions_battle_name_bel_reg_epirus_nova_nicopolis	Нікополь	true
regions_onscreen_att_reg_baetica_hispalis	Севілья	true
regions_battle_name_bel_sea_mare_africum	Африканське море	true
regions_onscreen_cha_reg_gharb_al_anadalus_beja	Бежа	true
regions_battle_name_cha_reg_provence_marseille	Марсель	true
regions_onscreen_bel_reg_campania_et_samnium_beneventum	Беневентум	true
regions_battle_name_att_reg_cilicia_myra	Атталея	true
regions_battle_name_att_reg_armenia_tosp	Ван	true
regions_onscreen_cha_reg_austrasia_aachen	Аахен	true
regions_battle_name_bel_reg_zeugitana_bulla_regia	Булла Регія	true
regions_battle_name_att_reg_scythia_sarai	Саксін	true
regions_onscreen_bel_sea_oceanus_gallicus	Гальський океан	true
regions_battle_name_cha_sea_ligurian_sea	Лігурійське море	true
regions_onscreen_cha_sea_mare_incognita	Невідоме море	true
regions_onscreen_att_reg_dardania_scupi	Скоп'є	true
regions_battle_name_bel_reg_cantabria_portus_victoriae	Портус Вікторія	true
regions_battle_name_att_reg_germano_sarmatia_oium	Гардінас	true
regions_onscreen_att_reg_germania_uburzis	Франкфурт	true
regions_battle_name_cha_reg_pannonia_cibakhaza	Цібахаза	true
regions_onscreen_bel_sea_mare_incognita	Невідоме море	true
regions_onscreen_cha_reg_marca_inferior_lisbon	Лісабон	true
regions_onscreen_cha_reg_sardinia_and_corsica_cagliari	Кальярі	true
regions_onscreen_cha_reg_wales_mathrafal	Матрафал	true
regions_onscreen_att_reg_venetia_aquileia	Венеція	true
regions_onscreen_cha_reg_valencia_palma	Пальма	true
regions_onscreen_att_sea_mare_internum	Середземне море	true
regions_onscreen_bel_sea_mare_internum	Внутрішнє море	true
regions_onscreen_cha_reg_angria_erfurt	Ерфурт	true
regions_battle_name_cha_sea_balearic_sea	Балеарське море	true
regions_onscreen_att_reg_palaestinea_aila	Акаба	true
regions_onscreen_att_reg_thracia_constantinopolis	Константинополь	true
regions_battle_name_bel_reg_baetica_gades	Гадес	true
regions_onscreen_att_reg_transcaspia_kath	Ургенч	true
regions_battle_name_att_reg_arabia_felix_omana	Бахла	true
regions_battle_name_bel_reg_neustria_turonorum	Туронорум	true
regions_battle_name_att_reg_asia_synnada	Дорилайон	true
regions_battle_name_att_reg_britannia_inferior_eboracum	Йорк	true
regions_battle_name_att_reg_lugdunensis_rotomagus	Руан	true
regions_battle_name_cha_reg_sardinia_and_corsica_olbia	Ольбія	true
regions_battle_name_bel_reg_byzacena_hadrumentum	Хадрументум	true
regions_onscreen_cha_reg_pictland_scone	Сконе	true
regions_battle_name_bel_sea_lake	Лейк	true
regions_onscreen_bel_reg_neustria_paris	Париж	true
regions_onscreen_att_reg_mediterraneus_orientalis_rhodes	Родос	true
regions_battle_name_cha_reg_marca_media_caceres	Касерес	true
regions_battle_name_cha_reg_croatia_jadra	Ядра	true
regions_onscreen_cha_reg_bavaria_augsburg	Аугсбург	true
regions_battle_name_cha_reg_moravia_nitra	Нітра	true
regions_onscreen_bel_reg_mauretania_sitifensis_sitifis	Сітіфіс	true
regions_onscreen_cha_reg_wilzi_cottbus	Котбус	true
regions_onscreen_att_reg_frisia_flevum	Гронінген	true
regions_onscreen_att_reg_lusitania_pax_augusta	Евора	true
regions_battle_name_att_reg_khwarasan_abarshahr	Нішапур	true
regions_battle_name_cha_sea_gulf_of_lion	Затока Лева	true
regions_onscreen_cha_reg_sicilia_syracuse	Сиракузи	true
regions_onscreen_cha_reg_sicilia_panormos	Панормос	true
regions_battle_name_cha_reg_valencia_cartagena	Картахена	true
regions_onscreen_cha_reg_provence_arles	Арль	true
regions_battle_name_att_reg_dacia_apulum	Дюлафегервар	true
regions_onscreen_att_reg_macedonia_dyrrhachium	Діррахіум	true
regions_battle_name_bel_reg_terra_incognita_transalpina	Невідома земля	true
regions_battle_name_att_reg_macedonia_corinthus	Містра	true
regions_battle_name_cha_reg_bohemia_praha	Прага	true
regions_onscreen_att_sea_oceanus_gallicus	Гальське море	true
regions_onscreen_cha_sea_atlantic_ocean	Атлантичний океан	true
regions_battle_name_cha_reg_benevento_benevento	Беневенто	true
regions_onscreen_cha_reg_austrasia_trier	Трір	true
regions_onscreen_bel_reg_africa_proconsularis_thuburbo	Тубурбо	true
regions_onscreen_att_reg_media_atropatene_rhaga	Рей	true
regions_battle_name_att_reg_transcaspia_dahistan	Горган	true
regions_battle_name_att_reg_scandza_alabu	Орхус	true
regions_battle_name_cha_reg_rome_siena	Сієна	true
regions_battle_name_att_reg_britannia_superior_corinium	Брістоль	true
regions_onscreen_att_reg_libya_ptolemais	Барса	true
regions_onscreen_att_reg_khwarasan_harey	Герат	true
regions_battle_name_att_reg_syria_tyrus	Акр	true
regions_battle_name_att_reg_sarmatia_asiatica_samandar	Дербент	true
regions_battle_name_att_reg_germano_sarmatia_duna	Рига	true
regions_onscreen_bel_reg_novempopulania_tolosa	Толоса	true
regions_battle_name_att_reg_caledonia_et_hibernia_eildon	Единбург	true
regions_onscreen_cha_reg_eastphalia_hildesheim	Гільдесгайм	true
regions_battle_name_att_reg_bithynia_nicomedia	Нікея	true
regions_onscreen_bel_reg_africa_proconsularis_carthago	Карфаген	true
regions_onscreen_bel_reg_terra_incognita	Невідома земля	true
regions_onscreen_att_sea_mare_gallicum	Гальська затока	true
regions_onscreen_bel_sea_mare_gallicum	Гальське море	true
regions_onscreen_att_sea_mare_cilicium	Левантійське море	true
regions_battle_name_bel_reg_tarraconensis_caesaraugusta	Цезараугуста	true
regions_battle_name_att_reg_tripolitana_macomades	Сурт	true
regions_onscreen_cha_reg_brittany_st_malo	Сен-Мало	true
regions_battle_name_att_reg_caledonia_et_hibernia_eblana	Дублін	true
regions_battle_name_bel_reg_apulia_et_calabria_hydruntum	Гідрунтум	true
regions_battle_name_bel_reg_zeugitana_hippo_regis	Гіппон Регіс	true
regions_battle_name_att_reg_asia_ephesus	Смірна	true
regions_battle_name_bel_reg_sardinia_et_corsica_aleria	Алерія	true
regions_onscreen_bel_reg_tarraconensis_barcino	Барсіно	true
regions_onscreen_att_reg_spahan_spahan	Ісфахан	true
regions_onscreen_cha_reg_ulster_grinan_of_ailech	Ґрінан Айлеха	true
regions_battle_name_bel_reg_flaminia_et_picenum_pisaurum	Пізаурум	true
regions_onscreen_att_reg_sarmatia_europaea_olbia	Білгород	true
regions_onscreen_bel_reg_tuscia_et_umbria_pisae	Піза	true
regions_onscreen_bel_reg_mauretania_tingitana_rusaddir	Русаддір	true
regions_battle_name_att_reg_palaestinea_aelia_capitolina	Єрусалим	true
regions_battle_name_cha_reg_franconia_hallstadt	Гальштадт	true
regions_onscreen_bel_reg_africa_proconsularis_hippo_diarrhytus	Гіппон Діарит	true
regions_onscreen_att_reg_aethiopia_adulis	Массава	true
regions_battle_name_cha_sea_adriatic_sea	Адріатичне море	true
regions_onscreen_bel_sea_mare_tyrrhenum	Тірренське море	true
regions_battle_name_att_sea_lake	Лейк	true
regions_battle_name_att_reg_sarmatia_asiatica_anacopia	Бата	true
regions_onscreen_att_reg_pannonia_savaria	Веспрем	true
regions_battle_name_att_reg_osroene_amida	Діярбакир	true
regions_onscreen_att_sea_mare_tyrrhenum	Тірренське море	true
regions_battle_name_bel_reg_mauretania_sitifensis_cirta	Кірта	true
regions_onscreen_cha_reg_leon_valladoid	Вальядолід	true
regions_battle_name_cha_reg_croatia_ptuj	Птуй	true
regions_battle_name_cha_reg_sardinia_and_corsica_ajaccio	Аяччо	true
regions_battle_name_att_sea_mare_indicum	Арабське море	true
regions_battle_name_att_reg_libya_augila	Ауджіла	true
regions_onscreen_cha_reg_carinthia_lorch	Лорх	true
regions_battle_name_cha_reg_east_neustria_reims	Реймс	true
regions_battle_name_att_reg_syria_emesa	Хомс	true
regions_onscreen_bel_reg_sicilia_panormus	Панормус	true
regions_battle_name_att_sea_mare_caspium	Каспійське море	true
regions_battle_name_bel_reg_campania_et_samnium_neapolis	Неаполь	true
regions_battle_name_cha_reg_east_neustria_troyes	Труа	true
regions_battle_name_bel_reg_apulia_et_calabria_sipontum	Сіпонт	true
regions_onscreen_att_reg_dacia_petrodava	Сучава	true
regions_onscreen_bel_reg_neustria_portus_namnetum	Портус Намнетум	true
regions_battle_name_att_reg_thracia_marcianopolis	Тирново	true
regions_battle_name_cha_reg_bohemia_iglau	Іглау	true
regions_battle_name_cha_reg_marca_media_salamanca	Саламанка	true
regions_onscreen_att_reg_tarraconensis_tarraco	Барселона	true
regions_battle_name_bel_reg_dalmatia_tarsatica	Тарсатика	true
regions_battle_name_bel_reg_gallaecia_brigantium	Бріґантій	true
regions_battle_name_att_reg_maxima_sequanorum_octodurus	Берн	true
regions_onscreen_att_reg_arabia_felix_eudaemon	Аден	true
regions_battle_name_cha_reg_northumbria_bamburgh	Бамбург	true
regions_onscreen_att_sea_mare_aegyptum	Єгипетське море	true
regions_onscreen_att_reg_dalmatia_domavia	Рас	true
regions_onscreen_cha_reg_swabia_speyer	Шпейєр	true
regions_battle_name_att_reg_germania_lupfurdum	Бранденбург	true
regions_battle_name_bel_reg_apulia_et_calabria_tarentum	Тарент	true
regions_onscreen_cha_reg_brittany_quimper	Кімпер	true
regions_battle_name_cha_sea_straight_of_gibraltar	Гібралтарська протока	true
regions_onscreen_cha_reg_toledo_toledo	Толедо	true
regions_onscreen_cha_reg_lombardy_pavia	Павія	true
regions_battle_name_att_reg_lugdunensis_lugdunum	Ліон	true
regions_onscreen_att_sea_mare_suebicum	Коданська затока	true
regions_onscreen_bel_sea_mare_ibericum	Іберійське море	true
regions_onscreen_att_sea_mare_ibericum	Гадітанське море	true
regions_battle_name_cha_reg_wilzi_lipsk	Липськ	true
regions_onscreen_bel_reg_austrasia_augustobona_tricassium	Авґустобона Трікассів	true
regions_onscreen_att_reg_phazania_dimmidi	Біскра	true
regions_onscreen_cha_reg_calabria_taranto	Таранто	true
regions_onscreen_cha_reg_navarre_pamplona	Памплона	true
regions_battle_name_cha_reg_pictland_dumbarton	Дамбартон	true
regions_battle_name_att_sea_mare_aegaeum	Егейське море	true
regions_battle_name_bel_reg_brittany_osismorum	Осізмів	true
regions_onscreen_att_reg_mediterraneus_occidentalis_ajax	Аяччо	true
regions_onscreen_att_reg_phazania_cydamus	Гадамес	true
regions_battle_name_cha_reg_croatia_sisak	Сісак	true
regions_battle_name_att_reg_liguria_genua	Генуя	true
regions_battle_name_bel_reg_liguria_genua	Генуя	true
regions_battle_name_bel_reg_picenum_suburbicarium_asculum	Аскулум	true
regions_onscreen_att_sea_mare_illyricum	Іллірійське море	true
regions_battle_name_att_reg_asia_cyzicus	Кізик	true
regions_battle_name_cha_reg_obodrites_havelberg	Гавельберг	true
regions_battle_name_att_reg_armenia_duin	Двін	true
regions_onscreen_cha_reg_moravia_mosaburg	Мосабург	true
regions_battle_name_cha_sea_bay_of_biscay	Біскайська затока	true
regions_battle_name_cha_reg_west_neustria_rennes	Ренн	true
regions_battle_name_cha_reg_west_neustria_bayeux	Байо	true
regions_onscreen_cha_reg_wessex_london	Лондон	true
regions_onscreen_bel_reg_praeualitana_epidaurum	Епідавр	true
regions_battle_name_att_reg_aegyptus_oxyrhynchus	Каїр	true
regions_battle_name_att_reg_scandza_hafn	Роскілле	true
regions_onscreen_cha_reg_provence_nice	Ніцца	true
regions_onscreen_att_reg_aquitania_elusa	Тулуза	true
regions_onscreen_bel_reg_baetica_hispalis	Гіспаліс	true
regions_battle_name_att_sea_mare_africum	Африканське море	true
regions_onscreen_att_reg_sarmatia_europaea_chersonessus	Кафа	true
regions_onscreen_cha_reg_terra_incognita	Невідома земля	true
regions_battle_name_cha_reg_jutland_ribe	Рібе	true
regions_onscreen_cha_reg_burgundy_lyon	Ліон	true
